rank_number,actor,contributions,percent,cumulative_sum,cumulative_percent,all_contributions
1,atlantisbot,37576,52.28984,37576,52.28984,71861
2,nitrocode,4631,6.44439,42207,58.73422,71861
3,jamengual,3156,4.39181,45363,63.12603,71861
4,GenPage,1139,1.58500,46502,64.71104,71861
5,nishkrishnan,691,0.96158,47193,65.67262,71861
6,lukemassa,552,0.76815,47745,66.44077,71861
7,X-Guardian,459,0.63873,48204,67.07950,71861
8,msarvar,204,0.28388,48408,67.36338,71861
9,bschaatsbergen,172,0.23935,48580,67.60273,71861
10,lilincmu,161,0.22404,48741,67.82678,71861
11,pseudomorph,160,0.22265,48901,68.04943,71861
12,jippi,156,0.21709,49057,68.26651,71861
13,Fabianoshz,144,0.20039,49201,68.46690,71861
14,ghaiszaher,127,0.17673,49328,68.64363,71861
15,kvanzuijlen,107,0.14890,49435,68.79253,71861
16,jandersen-plaid,106,0.14751,49541,68.94004,71861
17,nekketsuuu,106,0.14751,49647,69.08754,71861
18,grimm26,104,0.14472,49751,69.23227,71861
19,majormoses,104,0.14472,49855,69.37699,71861
20,inkel,90,0.12524,49945,69.50223,71861
21,finnag,78,0.10854,50023,69.61078,71861
22,albertorm95,76,0.10576,50099,69.71654,71861
23,gezb,76,0.10576,50175,69.82230,71861
24,mcdafydd,76,0.10576,50251,69.92806,71861
25,tapaszto,71,0.09880,50322,70.02686,71861
26,stasostrovskyi,69,0.09602,50391,70.12288,71861
27,jskrill,61,0.08489,50452,70.20776,71861
28,dimisjim,59,0.08210,50511,70.28987,71861
29,kipkoan,57,0.07932,50568,70.36918,71861
30,SSKLCP,57,0.07932,50625,70.44850,71861
31,bgalkows,54,0.07515,50679,70.52365,71861
32,Dilergore,53,0.07375,50732,70.59740,71861
33,ribejara-te,53,0.07375,50785,70.67116,71861
34,michelmzs,51,0.07097,50836,70.74213,71861
35,Teko012,51,0.07097,50887,70.81310,71861
36,AndreZiviani,50,0.06958,50937,70.88268,71861
37,adam-verigin,49,0.06819,50986,70.95086,71861
38,remilapeyre,48,0.06680,51034,71.01766,71861
39,cket,47,0.06540,51081,71.08306,71861
40,Aayyush,45,0.06262,51126,71.14568,71861
41,gmaghera,45,0.06262,51171,71.20830,71861
42,marceloboeira,45,0.06262,51216,71.27093,71861
43,brndnmtthws,44,0.06123,51260,71.33216,71861
44,marcusramberg,44,0.06123,51304,71.39338,71861
45,red8888,43,0.05984,51347,71.45322,71861
46,infame-io,41,0.05705,51388,71.51028,71861
47,parmouraly,41,0.05705,51429,71.56733,71861
48,Tenzer,41,0.05705,51470,71.62439,71861
49,kangaechu,39,0.05427,51509,71.67866,71861
50,edbighead,38,0.05288,51547,71.73154,71861
51,tufitko,38,0.05288,51585,71.78442,71861
52,vincentgna,38,0.05288,51623,71.83730,71861
53,Fauzyy,37,0.05149,51660,71.88879,71861
54,jolexa,36,0.05010,51696,71.93888,71861
55,brandon-fryslie,35,0.04871,51731,71.98759,71861
56,d-costa,35,0.04871,51766,72.03629,71861
57,giuli007,35,0.04871,51801,72.08500,71861
58,minamijoyo,35,0.04871,51836,72.13370,71861
59,ysoldak,35,0.04871,51871,72.18241,71861
60,ImperialXT,34,0.04731,51905,72.22972,71861
61,syphernl,32,0.04453,51937,72.27425,71861
62,ascandella,31,0.04314,51968,72.31739,71861
63,dedamico,31,0.04314,51999,72.36053,71861
64,ginski47,31,0.04314,52030,72.40367,71861
65,peikk0,31,0.04314,52061,72.44681,71861
66,snorlaX-sleeps,31,0.04314,52092,72.48995,71861
67,Almenon,30,0.04175,52122,72.53169,71861
68,pauloconnor,30,0.04175,52152,72.57344,71861
69,shouichi,30,0.04175,52182,72.61519,71861
70,tpolekhin,30,0.04175,52212,72.65693,71861
71,Dawnflash,29,0.04036,52241,72.69729,71861
72,mathcantin,28,0.03896,52269,72.73625,71861
73,james0209,26,0.03618,52295,72.77244,71861
74,unRob,26,0.03618,52321,72.80862,71861
75,jocelynthode,25,0.03479,52346,72.84341,71861
76,Luay-Sol,25,0.03479,52371,72.87820,71861
77,ryan-dyer-sp,25,0.03479,52396,72.91298,71861
78,SudoSpartanDan,25,0.03479,52421,72.94777,71861
79,camillsir,24,0.03340,52445,72.98117,71861
80,dupuy26,24,0.03340,52469,73.01457,71861
81,anryko,23,0.03201,52492,73.04658,71861
82,DazWorrall,23,0.03201,52515,73.07858,71861
83,chrisob,22,0.03061,52537,73.10920,71861
84,jason-huling,22,0.03061,52559,73.13981,71861
85,jasonrberk,22,0.03061,52581,73.17043,71861
86,ltmleo,22,0.03061,52603,73.20104,71861
87,mechastorm,22,0.03061,52625,73.23166,71861
88,goobysnack,21,0.02922,52646,73.26088,71861
89,netguino,21,0.02922,52667,73.29010,71861
90,robmonct,21,0.02922,52688,73.31932,71861
91,zepeng811,21,0.02922,52709,73.34855,71861
92,fblgit,20,0.02783,52729,73.37638,71861
93,jsw1993,20,0.02783,52749,73.40421,71861
94,mhennecke,20,0.02783,52769,73.43204,71861
95,mtavaresmedeiros,20,0.02783,52789,73.45987,71861
96,csainty,19,0.02644,52808,73.48631,71861
97,darrylb-github,19,0.02644,52827,73.51275,71861
98,genfemme,19,0.02644,52846,73.53919,71861
99,hafedh1978,19,0.02644,52865,73.56563,71861
100,nikovirtala,19,0.02644,52884,73.59207,71861
101,paulerickson,19,0.02644,52903,73.61851,71861
102,RulerOf,19,0.02644,52922,73.64495,71861
103,dmattia,18,0.02505,52940,73.67000,71861
104,jonathanwiemers,18,0.02505,52958,73.69505,71861
105,monikma,18,0.02505,52976,73.72010,71861
106,MRinalducci,18,0.02505,52994,73.74515,71861
107,Pardeep009,18,0.02505,53012,73.77020,71861
108,roytev,18,0.02505,53030,73.79524,71861
109,veverkap,18,0.02505,53048,73.82029,71861
110,zarelit,18,0.02505,53066,73.84534,71861
111,Balsir,17,0.02366,53083,73.86900,71861
112,eventh,17,0.02366,53100,73.89265,71861
113,JackaDu,17,0.02366,53117,73.91631,71861
114,kulkarnidk,17,0.02366,53134,73.93997,71861
115,rngtng,17,0.02366,53151,73.96362,71861
116,tlorreyte,17,0.02366,53168,73.98728,71861
117,wpbeckwith,17,0.02366,53185,74.01094,71861
118,ahasna,16,0.02227,53201,74.03320,71861
119,angeloskaltsikis,16,0.02227,53217,74.05547,71861
120,arthurio,16,0.02227,53233,74.07773,71861
121,dandcg,16,0.02227,53249,74.10000,71861
122,dgteixeira,16,0.02227,53265,74.12226,71861
123,endriu0,16,0.02227,53281,74.14453,71861
124,jhaumont,16,0.02227,53297,74.16679,71861
125,JoshiiSinfield,16,0.02227,53313,74.18906,71861
126,k4k,16,0.02227,53329,74.21132,71861
127,krzysztof-magosa,16,0.02227,53345,74.23359,71861
128,Nuru,16,0.02227,53361,74.25586,71861
129,Omicron7,16,0.02227,53377,74.27812,71861
130,raymondchen625,16,0.02227,53393,74.30039,71861
131,sza12,16,0.02227,53409,74.32265,71861
132,tekumara,16,0.02227,53425,74.34492,71861
133,timoguin,16,0.02227,53441,74.36718,71861
134,virgofx,16,0.02227,53457,74.38945,71861
135,estensen,15,0.02087,53472,74.41032,71861
136,judika03,15,0.02087,53487,74.43119,71861
137,lazzurs,15,0.02087,53502,74.45207,71861
138,maximede,15,0.02087,53517,74.47294,71861
139,nwsparks,15,0.02087,53532,74.49381,71861
140,oysteingraendsen,15,0.02087,53547,74.51469,71861
141,vmdude,15,0.02087,53562,74.53556,71861
142,esn89,14,0.01948,53576,74.55504,71861
143,goodspark,14,0.01948,53590,74.57453,71861
144,ldormoy,14,0.01948,53604,74.59401,71861
145,lmbleandro,14,0.01948,53618,74.61349,71861
146,m00lecule,14,0.01948,53632,74.63297,71861
147,malnick,14,0.01948,53646,74.65245,71861
148,marcb1,14,0.01948,53660,74.67194,71861
149,megakid,14,0.01948,53674,74.69142,71861
150,nokernel,14,0.01948,53688,74.71090,71861
151,ronaldmiranda,14,0.01948,53702,74.73038,71861
152,samuelbailey123,14,0.01948,53716,74.74986,71861
153,shurkus,14,0.01948,53730,74.76935,71861
154,sourava01,14,0.01948,53744,74.78883,71861
155,arohter,13,0.01809,53757,74.80692,71861
156,bewie,13,0.01809,53770,74.82501,71861
157,evanstachowiak,13,0.01809,53783,74.84310,71861
158,gurpalw,13,0.01809,53796,74.86119,71861
159,jlestrada,13,0.01809,53809,74.87928,71861
160,paul-civitas,13,0.01809,53822,74.89737,71861
161,Pradeepgk1,13,0.01809,53835,74.91546,71861
162,sarveshhh,13,0.01809,53848,74.93355,71861
163,Yasmine92,13,0.01809,53861,74.95164,71861
164,younus2019,13,0.01809,53874,74.96973,71861
165,casperbiering,12,0.01670,53886,74.98643,71861
166,davidh-unmind,12,0.01670,53898,75.00313,71861
167,guyscher2,12,0.01670,53910,75.01983,71861
168,iamnoah,12,0.01670,53922,75.03653,71861
169,mustdiechik,12,0.01670,53934,75.05323,71861
170,PertsevRoman,12,0.01670,53946,75.06993,71861
171,sachougule,12,0.01670,53958,75.08663,71861
172,tweeks-reify,12,0.01670,53970,75.10332,71861
173,waeltken,12,0.01670,53982,75.12002,71861
174,zxpower,12,0.01670,53994,75.13672,71861
175,amasover,11,0.01531,54005,75.15203,71861
176,austinsherron,11,0.01531,54016,75.16734,71861
177,bml1g12,11,0.01531,54027,75.18264,71861
178,bparoli,11,0.01531,54038,75.19795,71861
179,crainte,11,0.01531,54049,75.21326,71861
180,djoksimo,11,0.01531,54060,75.22857,71861
181,ean,11,0.01531,54071,75.24387,71861
182,Jaff,11,0.01531,54082,75.25918,71861
183,mattbmidigator,11,0.01531,54093,75.27449,71861
184,philnielsen,11,0.01531,54104,75.28980,71861
185,rsdelhi91,11,0.01531,54115,75.30510,71861
186,tpickett66,11,0.01531,54126,75.32041,71861
187,xafardero,11,0.01531,54137,75.33572,71861
188,atlantis333,10,0.01392,54147,75.34963,71861
189,BenoitLF,10,0.01392,54157,75.36355,71861
190,benoittoulme,10,0.01392,54167,75.37746,71861
191,chadasapp,10,0.01392,54177,75.39138,71861
192,colltrixmavenwave,10,0.01392,54187,75.40530,71861
193,DaveHewy,10,0.01392,54197,75.41921,71861
194,dbmurphy,10,0.01392,54207,75.43313,71861
195,devlucasc,10,0.01392,54217,75.44704,71861
196,devopsewb,10,0.01392,54227,75.46096,71861
197,elft3r,10,0.01392,54237,75.47488,71861
198,george-zubrienko,10,0.01392,54247,75.48879,71861
199,HFCoelho,10,0.01392,54257,75.50271,71861
200,jacob-jameson,10,0.01392,54267,75.51662,71861
201,jghal,10,0.01392,54277,75.53054,71861
202,kpurdon,10,0.01392,54287,75.54445,71861
203,lorenzoaiello,10,0.01392,54297,75.55837,71861
204,mmokijewski,10,0.01392,54307,75.57229,71861
205,monitrue,10,0.01392,54317,75.58620,71861
206,munibftl,10,0.01392,54327,75.60012,71861
207,pinkavaj,10,0.01392,54337,75.61403,71861
208,snuggie12,10,0.01392,54347,75.62795,71861
209,tomer-1,10,0.01392,54357,75.64186,71861
210,tyler-allen-tango,10,0.01392,54367,75.65578,71861
211,zhuoyang,10,0.01392,54377,75.66970,71861
212,Zophar78,10,0.01392,54387,75.68361,71861
213,benoit74,9,0.01252,54396,75.69614,71861
214,breizh5729,9,0.01252,54405,75.70866,71861
215,chriskuchin,9,0.01252,54414,75.72118,71861
216,cyrus-mc,9,0.01252,54423,75.73371,71861
217,dgokcin,9,0.01252,54432,75.74623,71861
218,dhaven,9,0.01252,54441,75.75876,71861
219,erpel,9,0.01252,54450,75.77128,71861
220,fleroux514,9,0.01252,54459,75.78380,71861
221,keidarcy,9,0.01252,54468,75.79633,71861
222,MarkIannucci,9,0.01252,54477,75.80885,71861
223,milpog,9,0.01252,54486,75.82138,71861
224,mollypi,9,0.01252,54495,75.83390,71861
225,pomcho555,9,0.01252,54504,75.84643,71861
226,pragathithangaraju,9,0.01252,54513,75.85895,71861
227,tobbbles,9,0.01252,54522,75.87147,71861
228,VladimirSt-XP,9,0.01252,54531,75.88400,71861
229,3bbbeau,8,0.01113,54539,75.89513,71861
230,Abhilash-sandupatla,8,0.01113,54547,75.90626,71861
231,akshayatplivo,8,0.01113,54555,75.91740,71861
232,alex-bezek,8,0.01113,54563,75.92853,71861
233,bhavith,8,0.01113,54571,75.93966,71861
234,CaioAugustoo,8,0.01113,54579,75.95079,71861
235,candidson,8,0.01113,54587,75.96193,71861
236,DeanDean12,8,0.01113,54595,75.97306,71861
237,DragosDumitrache,8,0.01113,54603,75.98419,71861
238,dyurovskykh-tivo,8,0.01113,54611,75.99532,71861
239,fishpen0,8,0.01113,54619,76.00646,71861
240,fzipi,8,0.01113,54627,76.01759,71861
241,ganesh-katakam-T18451,8,0.01113,54635,76.02872,71861
242,homerakshay,8,0.01113,54643,76.03985,71861
243,Jeinhaus,8,0.01113,54651,76.05099,71861
244,john-tipper,8,0.01113,54659,76.06212,71861
245,joncolby,8,0.01113,54667,76.07325,71861
246,kf-rammanokar,8,0.01113,54675,76.08439,71861
247,mattjamesaus,8,0.01113,54683,76.09552,71861
248,MichaelKora,8,0.01113,54691,76.10665,71861
249,mo-hit,8,0.01113,54699,76.11778,71861
250,moquintanilha,8,0.01113,54707,76.12892,71861
251,mprokopov,8,0.01113,54715,76.14005,71861
252,mustafa89,8,0.01113,54723,76.15118,71861
253,pcalley,8,0.01113,54731,76.16231,71861
254,philslab-ninja,8,0.01113,54739,76.17345,71861
255,rawlbot,8,0.01113,54747,76.18458,71861
256,sam-mundle,8,0.01113,54755,76.19571,71861
257,tinder-tder,8,0.01113,54763,76.20684,71861
258,tomasbackman,8,0.01113,54771,76.21798,71861
259,vaxinate,8,0.01113,54779,76.22911,71861
260,wlonkly,8,0.01113,54787,76.24024,71861
261,yohanb,8,0.01113,54795,76.25137,71861
262,yyseik,8,0.01113,54803,76.26251,71861
263,0x416e746f6e,7,0.00974,54810,76.27225,71861
264,aaleksandrov,7,0.00974,54817,76.28199,71861
265,ahartma1,7,0.00974,54824,76.29173,71861
266,andrewring,7,0.00974,54831,76.30147,71861
267,anujclari,7,0.00974,54838,76.31121,71861
268,armen90-07,7,0.00974,54845,76.32095,71861
269,bbrunod,7,0.00974,54852,76.33069,71861
270,benjaminchan,7,0.00974,54859,76.34044,71861
271,ByWefox,7,0.00974,54866,76.35018,71861
272,dad264,7,0.00974,54873,76.35992,71861
273,demetriusmoro,7,0.00974,54880,76.36966,71861
274,florianbeisel,7,0.00974,54887,76.37940,71861
275,gek0,7,0.00974,54894,76.38914,71861
276,h3lo,7,0.00974,54901,76.39888,71861
277,Hareeshyadavn,7,0.00974,54908,76.40862,71861
278,javajawa,7,0.00974,54915,76.41836,71861
279,jawed-K,7,0.00974,54922,76.42810,71861
280,jilyaluk,7,0.00974,54929,76.43785,71861
281,jmateusousa,7,0.00974,54936,76.44759,71861
282,joe-boyce,7,0.00974,54943,76.45733,71861
283,linuxdict,7,0.00974,54950,76.46707,71861
284,lpossamai,7,0.00974,54957,76.47681,71861
285,lvthao,7,0.00974,54964,76.48655,71861
286,lyoung-confluent,7,0.00974,54971,76.49629,71861
287,marcencov,7,0.00974,54978,76.50603,71861
288,markleary,7,0.00974,54985,76.51577,71861
289,MattiasAng,7,0.00974,54992,76.52551,71861
290,mbamber,7,0.00974,54999,76.53526,71861
291,mignaulo,7,0.00974,55006,76.54500,71861
292,mjagielka,7,0.00974,55013,76.55474,71861
293,nchicong,7,0.00974,55020,76.56448,71861
294,Phylu,7,0.00974,55027,76.57422,71861
295,pkchuyen,7,0.00974,55034,76.58396,71861
296,powellchristoph,7,0.00974,55041,76.59370,71861
297,pqtri1,7,0.00974,55048,76.60344,71861
298,rasmus,7,0.00974,55055,76.61318,71861
299,raynigon,7,0.00974,55062,76.62292,71861
300,rgooler,7,0.00974,55069,76.63267,71861
301,rissson,7,0.00974,55076,76.64241,71861
302,sangkyu-korbit,7,0.00974,55083,76.65215,71861
303,shettypriy,7,0.00974,55090,76.66189,71861
304,SrikanthSoma,7,0.00974,55097,76.67163,71861
305,ted-sigsci,7,0.00974,55104,76.68137,71861
306,thorkilds,7,0.00974,55111,76.69111,71861
307,tobaker,7,0.00974,55118,76.70085,71861
308,tom-mckay,7,0.00974,55125,76.71059,71861
309,tonejito,7,0.00974,55132,76.72034,71861
310,tszym,7,0.00974,55139,76.73008,71861
311,tweiss-mdm,7,0.00974,55146,76.73982,71861
312,victor-chan-groundswell,7,0.00974,55153,76.74956,71861
313,weyderfs,7,0.00974,55160,76.75930,71861
314,william-richard,7,0.00974,55167,76.76904,71861
315,yoonsio,7,0.00974,55174,76.77878,71861
316,acidflash,6,0.00835,55180,76.78713,71861
317,akostrikov,6,0.00835,55186,76.79548,71861
318,alistar79,6,0.00835,55192,76.80383,71861
319,aristocrates,6,0.00835,55198,76.81218,71861
320,avanthibez,6,0.00835,55204,76.82053,71861
321,ayushkr04,6,0.00835,55210,76.82888,71861
322,becjon,6,0.00835,55216,76.83723,71861
323,Bencyril,6,0.00835,55222,76.84558,71861
324,Bonala208,6,0.00835,55228,76.85393,71861
325,cbfield,6,0.00835,55234,76.86228,71861
326,cblkwell,6,0.00835,55240,76.87063,71861
327,cheethoe,6,0.00835,55246,76.87897,71861
328,d-cryptic,6,0.00835,55252,76.88732,71861
329,devinslick,6,0.00835,55258,76.89567,71861
330,DevSusu,6,0.00835,55264,76.90402,71861
331,dmalko-airslate,6,0.00835,55270,76.91237,71861
332,dpedu,6,0.00835,55276,76.92072,71861
333,dylanhitt,6,0.00835,55282,76.92907,71861
334,eXeDK,6,0.00835,55288,76.93742,71861
335,FernandoMiguel,6,0.00835,55294,76.94577,71861
336,fitz7,6,0.00835,55300,76.95412,71861
337,floyola,6,0.00835,55306,76.96247,71861
338,gdidok,6,0.00835,55312,76.97082,71861
339,gezza-b,6,0.00835,55318,76.97917,71861
340,gister9000,6,0.00835,55324,76.98752,71861
341,guilatrova,6,0.00835,55330,76.99587,71861
342,henriklundstrom,6,0.00835,55336,77.00422,71861
343,IchordeDionysos,6,0.00835,55342,77.01257,71861
344,isatasan,6,0.00835,55348,77.02092,71861
345,jackmonty,6,0.00835,55354,77.02926,71861
346,jimmyjamesbaldwin,6,0.00835,55360,77.03761,71861
347,joerx,6,0.00835,55366,77.04596,71861
348,JSNortal,6,0.00835,55372,77.05431,71861
349,kent-b,6,0.00835,55378,77.06266,71861
350,kumaresh0,6,0.00835,55384,77.07101,71861
351,lcruz-coursera,6,0.00835,55390,77.07936,71861
352,lengochieu1604,6,0.00835,55396,77.08771,71861
353,Leooo,6,0.00835,55402,77.09606,71861
354,leylmordor,6,0.00835,55408,77.10441,71861
355,maximov-m,6,0.00835,55414,77.11276,71861
356,mcaulifn,6,0.00835,55420,77.12111,71861
357,mcrivar,6,0.00835,55426,77.12946,71861
358,michyliao,6,0.00835,55432,77.13781,71861
359,mihneastaub,6,0.00835,55438,77.14616,71861
360,neilashbysenior,6,0.00835,55444,77.15451,71861
361,NitriKx,6,0.00835,55450,77.16286,71861
362,ntindall,6,0.00835,55456,77.17121,71861
363,omahonyb,6,0.00835,55462,77.17955,71861
364,oponomarov-tu,6,0.00835,55468,77.18790,71861
365,ovceev,6,0.00835,55474,77.19625,71861
366,Pin-Cheng,6,0.00835,55480,77.20460,71861
367,pszypowicz,6,0.00835,55486,77.21295,71861
368,rblank96,6,0.00835,55492,77.22130,71861
369,renescheepers,6,0.00835,55498,77.22965,71861
370,rkubik-hostersi,6,0.00835,55504,77.23800,71861
371,romelBen,6,0.00835,55510,77.24635,71861
372,ryanfarisco,6,0.00835,55516,77.25470,71861
373,sidlakhani94,6,0.00835,55522,77.26305,71861
374,songhanpoo,6,0.00835,55528,77.27140,71861
375,s-pace,6,0.00835,55534,77.27975,71861
376,Sreerag74031,6,0.00835,55540,77.28810,71861
377,srlightbody,6,0.00835,55546,77.29645,71861
378,sshann07,6,0.00835,55552,77.30480,71861
379,tbenst,6,0.00835,55558,77.31315,71861
380,teknaut,6,0.00835,55564,77.32150,71861
381,thomaschaplin,6,0.00835,55570,77.32985,71861
382,tieum,6,0.00835,55576,77.33819,71861
383,tjskanth,6,0.00835,55582,77.34654,71861
384,tomharrisonjr,6,0.00835,55588,77.35489,71861
385,tvarade,6,0.00835,55594,77.36324,71861
386,Ulminator,6,0.00835,55600,77.37159,71861
387,valentindeaconu,6,0.00835,55606,77.37994,71861
388,wendtek,6,0.00835,55612,77.38829,71861
389,WJay-tec,6,0.00835,55618,77.39664,71861
390,zerog2k,6,0.00835,55624,77.40499,71861
391,ahmaddanni,5,0.00696,55629,77.41195,71861
392,alekseyvinni,5,0.00696,55634,77.41891,71861
393,AlessioCasco,5,0.00696,55639,77.42586,71861
394,alex-mozejko,5,0.00696,55644,77.43282,71861
395,alikhajeh1,5,0.00696,55649,77.43978,71861
396,amir-elgayed,5,0.00696,55654,77.44674,71861
397,antonbabenko,5,0.00696,55659,77.45370,71861
398,asksmruti,5,0.00696,55664,77.46065,71861
399,atikhono,5,0.00696,55669,77.46761,71861
400,aubsynth,5,0.00696,55674,77.47457,71861
401,billabongrob,5,0.00696,55679,77.48153,71861
402,bpastiu,5,0.00696,55684,77.48848,71861
403,cchrist1967,5,0.00696,55689,77.49544,71861
404,champs,5,0.00696,55694,77.50240,71861
405,chaseconey,5,0.00696,55699,77.50936,71861
406,chavacava,5,0.00696,55704,77.51632,71861
407,cloudmatt,5,0.00696,55709,77.52327,71861
408,courteouselk,5,0.00696,55714,77.53023,71861
409,crashtestbrandt,5,0.00696,55719,77.53719,71861
410,DavidGereb,5,0.00696,55724,77.54415,71861
411,dimitardimovjebbit,5,0.00696,55729,77.55111,71861
412,dmalicia,5,0.00696,55734,77.55806,71861
413,dmunoz06,5,0.00696,55739,77.56502,71861
414,dobby-dobster,5,0.00696,55744,77.57198,71861
415,dominicbarnes,5,0.00696,55749,77.57894,71861
416,DrFaust92,5,0.00696,55754,77.58589,71861
417,duncanfbell,5,0.00696,55759,77.59285,71861
418,dversoza,5,0.00696,55764,77.59981,71861
419,dwrusse,5,0.00696,55769,77.60677,71861
420,enochlo,5,0.00696,55774,77.61373,71861
421,EvgeniNeosec,5,0.00696,55779,77.62068,71861
422,exe-r,5,0.00696,55784,77.62764,71861
423,fii,5,0.00696,55789,77.63460,71861
424,frank-bee,5,0.00696,55794,77.64156,71861
425,fredlemieux,5,0.00696,55799,77.64852,71861
426,geekette86,5,0.00696,55804,77.65547,71861
427,georgedriver,5,0.00696,55809,77.66243,71861
428,ghostinthewires,5,0.00696,55814,77.66939,71861
429,Gianluca755,5,0.00696,55819,77.67635,71861
430,gpgabriel,5,0.00696,55824,77.68331,71861
431,hatmarch,5,0.00696,55829,77.69026,71861
432,hungran,5,0.00696,55834,77.69722,71861
433,jacobfoard,5,0.00696,55839,77.70418,71861
434,jcarlson,5,0.00696,55844,77.71114,71861
435,jeff-caylent,5,0.00696,55849,77.71809,71861
436,jmediald-te,5,0.00696,55854,77.72505,71861
437,joshmyers,5,0.00696,55859,77.73201,71861
438,jreslock,5,0.00696,55864,77.73897,71861
439,jvperrin,5,0.00696,55869,77.74593,71861
440,kdubmartins,5,0.00696,55874,77.75288,71861
441,LAKostis,5,0.00696,55879,77.75984,71861
442,litepl,5,0.00696,55884,77.76680,71861
443,lrhazi,5,0.00696,55889,77.77376,71861
444,LuigiClemente-Awin,5,0.00696,55894,77.78072,71861
445,maxblaze,5,0.00696,55899,77.78767,71861
446,mdcurran,5,0.00696,55904,77.79463,71861
447,medwards1771,5,0.00696,55909,77.80159,71861
448,micborens,5,0.00696,55914,77.80855,71861
449,mliljedahl,5,0.00696,55919,77.81550,71861
450,Moncky,5,0.00696,55924,77.82246,71861
451,motatoes,5,0.00696,55929,77.82942,71861
452,mpmsimo,5,0.00696,55934,77.83638,71861
453,MrLuje,5,0.00696,55939,77.84334,71861
454,Naoki-A-Ichihara,5,0.00696,55944,77.85029,71861
455,nbasila,5,0.00696,55949,77.85725,71861
456,nguyend91,5,0.00696,55954,77.86421,71861
457,nickperkins,5,0.00696,55959,77.87117,71861
458,ollliegits,5,0.00696,55964,77.87813,71861
459,phzietsman,5,0.00696,55969,77.88508,71861
460,pietrodellamore,5,0.00696,55974,77.89204,71861
461,res0nat0r,5,0.00696,55979,77.89900,71861
462,rhalyc,5,0.00696,55984,77.90596,71861
463,rmccarthy-ellevation,5,0.00696,55989,77.91292,71861
464,robbie-cahill,5,0.00696,55994,77.91987,71861
465,rocpatel,5,0.00696,55999,77.92683,71861
466,rwd5213,5,0.00696,56004,77.93379,71861
467,ryan-cpi,5,0.00696,56009,77.94075,71861
468,sa1-ch,5,0.00696,56014,77.94770,71861
469,schultzor,5,0.00696,56019,77.95466,71861
470,sethfloydjr,5,0.00696,56024,77.96162,71861
471,shikai93,5,0.00696,56029,77.96858,71861
472,smstone,5,0.00696,56034,77.97554,71861
473,spaszek,5,0.00696,56039,77.98249,71861
474,te-ak,5,0.00696,56044,77.98945,71861
475,tedwardd,5,0.00696,56049,77.99641,71861
476,teknofile,5,0.00696,56054,78.00337,71861
477,tewing-riffyn,5,0.00696,56059,78.01033,71861
478,tfheen,5,0.00696,56064,78.01728,71861
479,thlacroix,5,0.00696,56069,78.02424,71861
480,Tomesco,5,0.00696,56074,78.03120,71861
481,TZdybel,5,0.00696,56079,78.03816,71861
482,ValdirGuerra,5,0.00696,56084,78.04511,71861
483,vanetix,5,0.00696,56089,78.05207,71861
484,Vlaaaaaaad,5,0.00696,56094,78.05903,71861
485,wkrysmann,5,0.00696,56099,78.06599,71861
486,27-28,4,0.00557,56103,78.07155,71861
487,aalvarezaph,4,0.00557,56107,78.07712,71861
488,acostaedg,4,0.00557,56111,78.08269,71861
489,a-devops-guy,4,0.00557,56115,78.08825,71861
490,adriantr,4,0.00557,56119,78.09382,71861
491,akaiypova,4,0.00557,56123,78.09939,71861
492,alexandreags,4,0.00557,56127,78.10495,71861
493,alsyia,4,0.00557,56131,78.11052,71861
494,andrassy,4,0.00557,56135,78.11609,71861
495,andrewjamesbrown,4,0.00557,56139,78.12165,71861
496,andyanfieldroad,4,0.00557,56143,78.12722,71861
497,arvindamirtaa,4,0.00557,56147,78.13278,71861
498,Asiya-Yunusa,4,0.00557,56151,78.13835,71861
499,attriabhishek,4,0.00557,56155,78.14392,71861
500,axcosta,4,0.00557,56159,78.14948,71861
501,ayk33,4,0.00557,56163,78.15505,71861
502,bakeemawaytoys,4,0.00557,56167,78.16062,71861
503,biker2o,4,0.00557,56171,78.16618,71861
504,bob-rohan,4,0.00557,56175,78.17175,71861
505,BoraxTheClean,4,0.00557,56179,78.17731,71861
506,carlitos081,4,0.00557,56183,78.18288,71861
507,Charg,4,0.00557,56187,78.18845,71861
508,cjbehm,4,0.00557,56191,78.19401,71861
509,coretemp,4,0.00557,56195,78.19958,71861
510,cypres,4,0.00557,56199,78.20515,71861
511,czuares,4,0.00557,56203,78.21071,71861
512,DanielRieske,4,0.00557,56207,78.21628,71861
513,dbg-raghulkrishna,4,0.00557,56211,78.22184,71861
514,dcatalano-figure,4,0.00557,56215,78.22741,71861
515,debu99,4,0.00557,56219,78.23298,71861
516,derekheld,4,0.00557,56223,78.23854,71861
517,dianfishekqi,4,0.00557,56227,78.24411,71861
518,Djiit,4,0.00557,56231,78.24968,71861
519,donaldpiret,4,0.00557,56235,78.25524,71861
520,douglascayers,4,0.00557,56239,78.26081,71861
521,dpiddock,4,0.00557,56243,78.26638,71861
522,dtelaroli,4,0.00557,56247,78.27194,71861
523,dtjldamien,4,0.00557,56251,78.27751,71861
524,dwilliams782,4,0.00557,56255,78.28307,71861
525,dzinek,4,0.00557,56259,78.28864,71861
526,entscheidungsproblem,4,0.00557,56263,78.29421,71861
527,ericodell,4,0.00557,56267,78.29977,71861
528,flixx,4,0.00557,56271,78.30534,71861
529,franklad,4,0.00557,56275,78.31091,71861
530,fyqtian,4,0.00557,56279,78.31647,71861
531,gaom25,4,0.00557,56283,78.32204,71861
532,gfoligna-nyshex,4,0.00557,56287,78.32760,71861
533,gparton,4,0.00557,56291,78.33317,71861
534,hack2learn,4,0.00557,56295,78.33874,71861
535,ifteehussa1n,4,0.00557,56299,78.34430,71861
536,ivanaguilario,4,0.00557,56303,78.34987,71861
537,ivankisic,4,0.00557,56307,78.35544,71861
538,jauyzed,4,0.00557,56311,78.36100,71861
539,jcoelho93,4,0.00557,56315,78.36657,71861
540,jescholl,4,0.00557,56319,78.37214,71861
541,jesseneal,4,0.00557,56323,78.37770,71861
542,jmbravo,4,0.00557,56327,78.38327,71861
543,johncblandii,4,0.00557,56331,78.38883,71861
544,johnlinvc,4,0.00557,56335,78.39440,71861
545,jrobison-sb,4,0.00557,56339,78.39997,71861
546,justinneilson,4,0.00557,56343,78.40553,71861
547,karl-tpio,4,0.00557,56347,78.41110,71861
548,kbaldyga,4,0.00557,56351,78.41667,71861
549,kennedy,4,0.00557,56355,78.42223,71861
550,kerin,4,0.00557,56359,78.42780,71861
551,kevcube,4,0.00557,56363,78.43336,71861
552,kkhs-thirai,4,0.00557,56367,78.43893,71861
553,kneufeld-pbp,4,0.00557,56371,78.44450,71861
554,LanceSandino,4,0.00557,56375,78.45006,71861
555,ldunkum,4,0.00557,56379,78.45563,71861
556,leandromoreirati,4,0.00557,56383,78.46120,71861
557,lhenn-au,4,0.00557,56387,78.46676,71861
558,lorenz-scalable,4,0.00557,56391,78.47233,71861
559,lvyaoting,4,0.00557,56395,78.47789,71861
560,malachantrio,4,0.00557,56399,78.48346,71861
561,Marcvd316,4,0.00557,56403,78.48903,71861
562,masert,4,0.00557,56407,78.49459,71861
563,MattPumphrey,4,0.00557,56411,78.50016,71861
564,Mazorius,4,0.00557,56415,78.50573,71861
565,mbarr-hrp,4,0.00557,56419,78.51129,71861
566,mcandio,4,0.00557,56423,78.51686,71861
567,Mcrivar,4,0.00557,56427,78.52243,71861
568,mihstaub,4,0.00557,56431,78.52799,71861
569,mikeblum,4,0.00557,56435,78.53356,71861
570,mlehner616,4,0.00557,56439,78.53912,71861
571,mosaic-atlantis,4,0.00557,56443,78.54469,71861
572,mpatel-aops,4,0.00557,56447,78.55026,71861
573,mpopoola,4,0.00557,56451,78.55582,71861
574,mprince,4,0.00557,56455,78.56139,71861
575,mralanlee,4,0.00557,56459,78.56696,71861
576,mukul3646,4,0.00557,56463,78.57252,71861
577,NathanielWroblewski,4,0.00557,56467,78.57809,71861
578,NeckBeardPrince,4,0.00557,56471,78.58365,71861
579,nhamcloudlab,4,0.00557,56475,78.58922,71861
580,nickwu241,4,0.00557,56479,78.59479,71861
581,npwolf,4,0.00557,56483,78.60035,71861
582,omar-yassin,4,0.00557,56487,78.60592,71861
583,patradinesh,4,0.00557,56491,78.61149,71861
584,patrick-merchant,4,0.00557,56495,78.61705,71861
585,paulozava,4,0.00557,56499,78.62262,71861
586,pedro3692,4,0.00557,56503,78.62818,71861
587,peterzcc,4,0.00557,56507,78.63375,71861
588,pgroudas,4,0.00557,56511,78.63932,71861
589,poflynn,4,0.00557,56515,78.64488,71861
590,pryorda,4,0.00557,56519,78.65045,71861
591,rhysm,4,0.00557,56523,78.65602,71861
592,Richard-Payne,4,0.00557,56527,78.66158,71861
593,RickyHolland,4,0.00557,56531,78.66715,71861
594,rkferreira,4,0.00557,56535,78.67272,71861
595,rkstrickland,4,0.00557,56539,78.67828,71861
596,rmalakar8x8,4,0.00557,56543,78.68385,71861
597,RobWC,4,0.00557,56547,78.68941,71861
598,rodrigoreva,4,0.00557,56551,78.69498,71861
599,RyPeck,4,0.00557,56555,78.70055,71861
600,SamuelMolling,4,0.00557,56559,78.70611,71861
601,sapslaj,4,0.00557,56563,78.71168,71861
602,sarcasticadmin,4,0.00557,56567,78.71725,71861
603,sdwerwed,4,0.00557,56571,78.72281,71861
604,seifrajhi,4,0.00557,56575,78.72838,71861
605,ShaneNalezyty-sf,4,0.00557,56579,78.73394,71861
606,shencan,4,0.00557,56583,78.73951,71861
607,shredsonata,4,0.00557,56587,78.74508,71861
608,sirvantedbrl,4,0.00557,56591,78.75064,71861
609,sophhu,4,0.00557,56595,78.75621,71861
610,srinivasaluka,4,0.00557,56599,78.76178,71861
611,stephencoe,4,0.00557,56603,78.76734,71861
612,stokkie90,4,0.00557,56607,78.77291,71861
613,SubNader,4,0.00557,56611,78.77848,71861
614,sujeets-toast,4,0.00557,56615,78.78404,71861
615,tampakrap,4,0.00557,56619,78.78961,71861
616,tchelovilar,4,0.00557,56623,78.79517,71861
617,teerakarna,4,0.00557,56627,78.80074,71861
618,teosoft123,4,0.00557,56631,78.80631,71861
619,tiago-cesar,4,0.00557,56635,78.81187,71861
620,tianoboy,4,0.00557,56639,78.81744,71861
621,tkishore1192,4,0.00557,56643,78.82301,71861
622,tmcevoy14,4,0.00557,56647,78.82857,71861
623,tokle,4,0.00557,56651,78.83414,71861
624,toyssan1,4,0.00557,56655,78.83970,71861
625,usmonster,4,0.00557,56659,78.84527,71861
626,vanjur,4,0.00557,56663,78.85084,71861
627,vegarberget,4,0.00557,56667,78.85640,71861
628,vic614,4,0.00557,56671,78.86197,71861
629,vinhlh,4,0.00557,56675,78.86754,71861
630,Vladyslav-Miletskyi,4,0.00557,56679,78.87310,71861
631,vsvijaysalvi,4,0.00557,56683,78.87867,71861
632,wang415,4,0.00557,56687,78.88423,71861
633,wmariuss,4,0.00557,56691,78.88980,71861
634,wolfulve,4,0.00557,56695,78.89537,71861
635,wsams,4,0.00557,56699,78.90093,71861
636,wsoula,4,0.00557,56703,78.90650,71861
637,y2abba,4,0.00557,56707,78.91207,71861
638,yashaswee,4,0.00557,56711,78.91763,71861
639,yutaka0m,4,0.00557,56715,78.92320,71861
640,zer0beat,4,0.00557,56719,78.92877,71861
641,1995-Kiran,3,0.00417,56722,78.93294,71861
642,80kk,3,0.00417,56725,78.93711,71861
643,85matthew,3,0.00417,56728,78.94129,71861
644,A30004028,3,0.00417,56731,78.94546,71861
645,aairey,3,0.00417,56734,78.94964,71861
646,adampie,3,0.00417,56737,78.95381,71861
647,adamstrawson,3,0.00417,56740,78.95799,71861
648,ahsan-n,3,0.00417,56743,78.96216,71861
649,akhilesh0,3,0.00417,56746,78.96634,71861
650,alaa-ledger,3,0.00417,56749,78.97051,71861
651,alexrocco,3,0.00417,56752,78.97469,71861
652,alfredo-gil,3,0.00417,56755,78.97886,71861
653,ambar-cap,3,0.00417,56758,78.98304,71861
654,anderssoder,3,0.00417,56761,78.98721,71861
655,andrewjeffree,3,0.00417,56764,78.99139,71861
656,andrusha,3,0.00417,56767,78.99556,71861
657,andy-paine-numan,3,0.00417,56770,78.99974,71861
658,anselmenumbisia,3,0.00417,56773,79.00391,71861
659,anthakingston,3,0.00417,56776,79.00809,71861
660,AntonUspehov,3,0.00417,56779,79.01226,71861
661,asantos-fuze,3,0.00417,56782,79.01643,71861
662,aschi1,3,0.00417,56785,79.02061,71861
663,ashi009,3,0.00417,56788,79.02478,71861
664,askmike1,3,0.00417,56791,79.02896,71861
665,asmontas-i,3,0.00417,56794,79.03313,71861
666,ausfestivus,3,0.00417,56797,79.03731,71861
667,azend,3,0.00417,56800,79.04148,71861
668,benfielden-onx,3,0.00417,56803,79.04566,71861
669,beyondbill,3,0.00417,56806,79.04983,71861
670,blbradley,3,0.00417,56809,79.05401,71861
671,blowfishpro,3,0.00417,56812,79.05818,71861
672,blytheaw,3,0.00417,56815,79.06236,71861
673,bnu0,3,0.00417,56818,79.06653,71861
674,bongardino,3,0.00417,56821,79.07071,71861
675,boxrick,3,0.00417,56824,79.07488,71861
676,bsvartz,3,0.00417,56827,79.07906,71861
677,bzamecnik,3,0.00417,56830,79.08323,71861
678,camaeel,3,0.00417,56833,79.08740,71861
679,c-ameron,3,0.00417,56836,79.09158,71861
680,cap-atlantis,3,0.00417,56839,79.09575,71861
681,carmennavarreteh,3,0.00417,56842,79.09993,71861
682,changli3,3,0.00417,56845,79.10410,71861
683,chenggl007,3,0.00417,56848,79.10828,71861
684,chinskiy,3,0.00417,56851,79.11245,71861
685,chirag-bhesaniya,3,0.00417,56854,79.11663,71861
686,christophercorn,3,0.00417,56857,79.12080,71861
687,codecommer,3,0.00417,56860,79.12498,71861
688,coderigo,3,0.00417,56863,79.12915,71861
689,ColDog,3,0.00417,56866,79.13333,71861
690,contil,3,0.00417,56869,79.13750,71861
691,conuigwe,3,0.00417,56872,79.14168,71861
692,d4n13lbc,3,0.00417,56875,79.14585,71861
693,danielkza,3,0.00417,56878,79.15003,71861
694,danpilch,3,0.00417,56881,79.15420,71861
695,davidasync,3,0.00417,56884,79.15838,71861
696,dbayendor-cb,3,0.00417,56887,79.16255,71861
697,deejayblee,3,0.00417,56890,79.16672,71861
698,DeepakRao121,3,0.00417,56893,79.17090,71861
699,delu2011,3,0.00417,56896,79.17507,71861
700,DenislavTsonev,3,0.00417,56899,79.17925,71861
701,devinturner,3,0.00417,56902,79.18342,71861
702,DiegoRBaquero,3,0.00417,56905,79.18760,71861
703,digiisoft,3,0.00417,56908,79.19177,71861
704,Dirrk,3,0.00417,56911,79.19595,71861
705,Dogers,3,0.00417,56914,79.20012,71861
706,dreid,3,0.00417,56917,79.20430,71861
707,dshapiro-david,3,0.00417,56920,79.20847,71861
708,Dumberdore,3,0.00417,56923,79.21265,71861
709,dyson,3,0.00417,56926,79.21682,71861
710,ebeltramo96,3,0.00417,56929,79.22100,71861
711,eblaauw,3,0.00417,56932,79.22517,71861
712,EFG-TheDevopsGuy,3,0.00417,56935,79.22935,71861
713,ehaselwanter,3,0.00417,56938,79.23352,71861
714,emre141,3,0.00417,56941,79.23769,71861
715,enarmontas,3,0.00417,56944,79.24187,71861
716,enummela,3,0.00417,56947,79.24604,71861
717,ericsonrumuy7,3,0.00417,56950,79.25022,71861
718,eugenetaranov,3,0.00417,56953,79.25439,71861
719,evkuzin,3,0.00417,56956,79.25857,71861
720,felixfriedrich,3,0.00417,56959,79.26274,71861
721,fernando-bosso,3,0.00417,56962,79.26692,71861
722,Fitz7,3,0.00417,56965,79.27109,71861
723,gabuzo-scw,3,0.00417,56968,79.27527,71861
724,gartemiev,3,0.00417,56971,79.27944,71861
725,GCCree,3,0.00417,56974,79.28362,71861
726,gdelgado,3,0.00417,56977,79.28779,71861
727,gepolquevedo,3,0.00417,56980,79.29197,71861
728,gerardsegarra,3,0.00417,56983,79.29614,71861
729,Gersh13,3,0.00417,56986,79.30032,71861
730,gespinal,3,0.00417,56989,79.30449,71861
731,glitchcrab,3,0.00417,56992,79.30867,71861
732,gmontanola,3,0.00417,56995,79.31284,71861
733,grglzrv,3,0.00417,56998,79.31701,71861
734,gtg3vv,3,0.00417,57001,79.32119,71861
735,GwonsooLee,3,0.00417,57004,79.32536,71861
736,h0rv,3,0.00417,57007,79.32954,71861
737,hkuchibhotla,3,0.00417,57010,79.33371,71861
738,hossein-rasi,3,0.00417,57013,79.33789,71861
739,iainlane,3,0.00417,57016,79.34206,71861
740,IamGabrielWu,3,0.00417,57019,79.34624,71861
741,ibbadhafeez,3,0.00417,57022,79.35041,71861
742,ichasco-heytrade,3,0.00417,57025,79.35459,71861
743,IngussNeilands,3,0.00417,57028,79.35876,71861
744,isurusiri,3,0.00417,57031,79.36294,71861
745,jayceebernardino,3,0.00417,57034,79.36711,71861
746,JaymoKang,3,0.00417,57037,79.37129,71861
747,jeff-clearcover,3,0.00417,57040,79.37546,71861
748,Jenishk56,3,0.00417,57043,79.37964,71861
749,jhcolville,3,0.00417,57046,79.38381,71861
750,jiba21,3,0.00417,57049,79.38799,71861
751,jinhong-,3,0.00417,57052,79.39216,71861
752,JohnDittmar,3,0.00417,57055,79.39633,71861
753,JoseLArantes,3,0.00417,57058,79.40051,71861
754,Josephred999,3,0.00417,57061,79.40468,71861
755,josepplaltg,3,0.00417,57064,79.40886,71861
756,jottr,3,0.00417,57067,79.41303,71861
757,JParisR,3,0.00417,57070,79.41721,71861
758,Jrc356,3,0.00417,57073,79.42138,71861
759,js-timbirkett,3,0.00417,57076,79.42556,71861
760,justhys,3,0.00417,57079,79.42973,71861
761,Ka1wa,3,0.00417,57082,79.43391,71861
762,KamranAzeem,3,0.00417,57085,79.43808,71861
763,karthick1808,3,0.00417,57088,79.44226,71861
764,kevin-fitlg,3,0.00417,57091,79.44643,71861
765,kevinwsin,3,0.00417,57094,79.45061,71861
766,kneemaa,3,0.00417,57097,79.45478,71861
767,learoyklinginsmith,3,0.00417,57100,79.45896,71861
768,levkk,3,0.00417,57103,79.46313,71861
769,liliwangthescore,3,0.00417,57106,79.46730,71861
770,ma44in,3,0.00417,57109,79.47148,71861
771,maartenvanderhoef,3,0.00417,57112,79.47565,71861
772,maati55,3,0.00417,57115,79.47983,71861
773,madsonic,3,0.00417,57118,79.48400,71861
774,magne,3,0.00417,57121,79.48818,71861
775,mahichodhary,3,0.00417,57124,79.49235,71861
776,MarkDPierce,3,0.00417,57127,79.49653,71861
777,masert2,3,0.00417,57130,79.50070,71861
778,matt-matt-tmatt,3,0.00417,57133,79.50488,71861
779,miked0004,3,0.00417,57136,79.50905,71861
780,Mitsuwa,3,0.00417,57139,79.51323,71861
781,mivok,3,0.00417,57142,79.51740,71861
782,mm-inagaki,3,0.00417,57145,79.52158,71861
783,mnhat3896,3,0.00417,57148,79.52575,71861
784,MOHD-MS,3,0.00417,57151,79.52993,71861
785,monkeymantra,3,0.00417,57154,79.53410,71861
786,moogly81,3,0.00417,57157,79.53828,71861
787,muffy,3,0.00417,57160,79.54245,71861
788,MysterioO,3,0.00417,57163,79.54662,71861
789,narenjcs,3,0.00417,57166,79.55080,71861
790,naru014,3,0.00417,57169,79.55497,71861
791,Nathan-Yorio,3,0.00417,57172,79.55915,71861
792,neeltom92,3,0.00417,57175,79.56332,71861
793,neilscallywag,3,0.00417,57178,79.56750,71861
794,neinkob15,3,0.00417,57181,79.57167,71861
795,nhatfield,3,0.00417,57184,79.57585,71861
796,nicethomaslearngit,3,0.00417,57187,79.58002,71861
797,nilaymalpekar,3,0.00417,57190,79.58420,71861
798,NK74,3,0.00417,57193,79.58837,71861
799,nlaguirre,3,0.00417,57196,79.59255,71861
800,nnovaeshc,3,0.00417,57199,79.59672,71861
801,Nothing4You,3,0.00417,57202,79.60090,71861
802,nsmartspring,3,0.00417,57205,79.60507,71861
803,obscurerichard,3,0.00417,57208,79.60925,71861
804,omotoso78,3,0.00417,57211,79.61342,71861
805,one1zero1one,3,0.00417,57214,79.61760,71861
806,pablocoberly,3,0.00417,57217,79.62177,71861
807,paduartesre,3,0.00417,57220,79.62594,71861
808,paranoidd,3,0.00417,57223,79.63012,71861
809,paulbailey,3,0.00417,57226,79.63429,71861
810,Paulius0112,3,0.00417,57229,79.63847,71861
811,philchristensen,3,0.00417,57232,79.64264,71861
812,pippitt,3,0.00417,57235,79.64682,71861
813,pjsier,3,0.00417,57238,79.65099,71861
814,Platou,3,0.00417,57241,79.65517,71861
815,plutino,3,0.00417,57244,79.65934,71861
816,powerok,3,0.00417,57247,79.66352,71861
817,prastamaha,3,0.00417,57250,79.66769,71861
818,pserranoa,3,0.00417,57253,79.67187,71861
819,RaphaelNeumann,3,0.00417,57256,79.67604,71861
820,rayanebel,3,0.00417,57259,79.68022,71861
821,rcclemente,3,0.00417,57262,79.68439,71861
822,rhughes1,3,0.00417,57265,79.68857,71861
823,ricardosilva86,3,0.00417,57268,79.69274,71861
824,RichieRogers,3,0.00417,57271,79.69691,71861
825,ri-roee,3,0.00417,57274,79.70109,71861
826,rjmsilveira,3,0.00417,57277,79.70526,71861
827,rmakram-ims,3,0.00417,57280,79.70944,71861
828,robertomoutinho,3,0.00417,57283,79.71361,71861
829,rogbert6,3,0.00417,57286,79.71779,71861
830,roy-urbint,3,0.00417,57289,79.72196,71861
831,rpdelaney,3,0.00417,57292,79.72614,71861
832,ryansmithcooper,3,0.00417,57295,79.73031,71861
833,s33dunda,3,0.00417,57298,79.73449,71861
834,sahaqaa,3,0.00417,57301,79.73866,71861
835,Sakib37,3,0.00417,57304,79.74284,71861
836,SamHummerstoneFlux,3,0.00417,57307,79.74701,71861
837,sam-som,3,0.00417,57310,79.75119,71861
838,santelos,3,0.00417,57313,79.75536,71861
839,saraangelmurphy,3,0.00417,57316,79.75954,71861
840,scarecrow111,3,0.00417,57319,79.76371,71861
841,Schtolc,3,0.00417,57322,79.76789,71861
842,Sebor,3,0.00417,57325,79.77206,71861
843,SennurC,3,0.00417,57328,79.77623,71861
844,sereth,3,0.00417,57331,79.78041,71861
845,shawnferry,3,0.00417,57334,79.78458,71861
846,shkamensky,3,0.00417,57337,79.78876,71861
847,ShpilerX,3,0.00417,57340,79.79293,71861
848,shubhdev79,3,0.00417,57343,79.79711,71861
849,shyamjos,3,0.00417,57346,79.80128,71861
850,Sickafant,3,0.00417,57349,79.80546,71861
851,singhswg,3,0.00417,57352,79.80963,71861
852,sinkr,3,0.00417,57355,79.81381,71861
853,sirpalmeirao,3,0.00417,57358,79.81798,71861
854,snehalsn,3,0.00417,57361,79.82216,71861
855,stacknowledge,3,0.00417,57364,79.82633,71861
856,starkpister,3,0.00417,57367,79.83051,71861
857,stark-tech25,3,0.00417,57370,79.83468,71861
858,starwill,3,0.00417,57373,79.83886,71861
859,stran,3,0.00417,57376,79.84303,71861
860,streetmapp,3,0.00417,57379,79.84721,71861
861,supergrilo-cw,3,0.00417,57382,79.85138,71861
862,sviatlo,3,0.00417,57385,79.85555,71861
863,swod00,3,0.00417,57388,79.85973,71861
864,szomelioza,3,0.00417,57391,79.86390,71861
865,taavitani,3,0.00417,57394,79.86808,71861
866,Tchoupinax,3,0.00417,57397,79.87225,71861
867,tibuntu,3,0.00417,57400,79.87643,71861
868,tjterris,3,0.00417,57403,79.88060,71861
869,tomvardasca,3,0.00417,57406,79.88478,71861
870,tomwj,3,0.00417,57409,79.88895,71861
871,Trozz,3,0.00417,57412,79.89313,71861
872,twendt,3,0.00417,57415,79.89730,71861
873,uLan08,3,0.00417,57418,79.90148,71861
874,userhas404d,3,0.00417,57421,79.90565,71861
875,utamas,3,0.00417,57424,79.90983,71861
876,vadim-yangunaev-md,3,0.00417,57427,79.91400,71861
877,Vaygh,3,0.00417,57430,79.91818,71861
878,vietlinh51,3,0.00417,57433,79.92235,71861
879,vimalvillavan,3,0.00417,57436,79.92652,71861
880,vitaly-dt,3,0.00417,57439,79.93070,71861
881,vladwfs,3,0.00417,57442,79.93487,71861
882,vlandemaine-orange,3,0.00417,57445,79.93905,71861
883,vnhirenko,3,0.00417,57448,79.94322,71861
884,vpletea,3,0.00417,57451,79.94740,71861
885,WarpRat,3,0.00417,57454,79.95157,71861
886,willswinson,3,0.00417,57457,79.95575,71861
887,wlin-jin,3,0.00417,57460,79.95992,71861
888,xavipanda,3,0.00417,57463,79.96410,71861
889,xiao-pp,3,0.00417,57466,79.96827,71861
890,yatanasov,3,0.00417,57469,79.97245,71861
891,yohei1126,3,0.00417,57472,79.97662,71861
892,zraider7,3,0.00417,57475,79.98080,71861
893,zshen-figma,3,0.00417,57478,79.98497,71861
894,0xFFFFtheTokens,2,0.00278,57480,79.98775,71861
895,ace03uec,2,0.00278,57482,79.99054,71861
896,a-chartier,2,0.00278,57484,79.99332,71861
897,adrianocanofre,2,0.00278,57486,79.99610,71861
898,adutchak,2,0.00278,57488,79.99889,71861
899,ahmedbadawy4,2,0.00278,57490,80.00167,71861
900,ahotwanisos,2,0.00278,57492,80.00445,71861
901,akhilkmref,2,0.00278,57494,80.00724,71861
902,akobir-mp,2,0.00278,57496,80.01002,71861
903,AlecBruns,2,0.00278,57498,80.01280,71861
904,Alegrowin,2,0.00278,57500,80.01559,71861
905,alfespa17,2,0.00278,57502,80.01837,71861
906,alk-jozog,2,0.00278,57504,80.02115,71861
907,AlliotTech,2,0.00278,57506,80.02394,71861
908,almightyfoon,2,0.00278,57508,80.02672,71861
909,amitrana93,2,0.00278,57510,80.02950,71861
910,amna-ali,2,0.00278,57512,80.03228,71861
911,andrei-marinache,2,0.00278,57514,80.03507,71861
912,AndrewChubatiuk,2,0.00278,57516,80.03785,71861
913,andrewelkins,2,0.00278,57518,80.04063,71861
914,andrew-halbert,2,0.00278,57520,80.04342,71861
915,andrewmackett,2,0.00278,57522,80.04620,71861
916,anrub,2,0.00278,57524,80.04898,71861
917,anthonyhaussman,2,0.00278,57526,80.05177,71861
918,ap78rus,2,0.00278,57528,80.05455,71861
919,Apoorva-Murde,2,0.00278,57530,80.05733,71861
920,ar-ds,2,0.00278,57532,80.06012,71861
921,argenthunder,2,0.00278,57534,80.06290,71861
922,ariz-kargo,2,0.00278,57536,80.06568,71861
923,armanzhol,2,0.00278,57538,80.06847,71861
924,arnzchen,2,0.00278,57540,80.07125,71861
925,arthur-leclerc,2,0.00278,57542,80.07403,71861
926,arthur-tsvettsih-cko,2,0.00278,57544,80.07681,71861
927,asantos82,2,0.00278,57546,80.07960,71861
928,atakacs90,2,0.00278,57548,80.08238,71861
929,atlantis-user,2,0.00278,57550,80.08516,71861
930,austin-engle,2,0.00278,57552,80.08795,71861
931,avinashkumar6,2,0.00278,57554,80.09073,71861
932,awilkins,2,0.00278,57556,80.09351,71861
933,bam0382,2,0.00278,57558,80.09630,71861
934,Banders2,2,0.00278,57560,80.09908,71861
935,bburt,2,0.00278,57562,80.10186,71861
936,BenLeibig,2,0.00278,57564,80.10465,71861
937,bezarsnba,2,0.00278,57566,80.10743,71861
938,bheemvennapureddy,2,0.00278,57568,80.11021,71861
939,bigjew92,2,0.00278,57570,80.11300,71861
940,blastik,2,0.00278,57572,80.11578,71861
941,bljordan,2,0.00278,57574,80.11856,71861
942,bobziuchkovski,2,0.00278,57576,80.12135,71861
943,bpgould,2,0.00278,57578,80.12413,71861
944,brettpalmberg,2,0.00278,57580,80.12691,71861
945,brianleegit,2,0.00278,57582,80.12969,71861
946,caiodelgadonew,2,0.00278,57584,80.13248,71861
947,camados,2,0.00278,57586,80.13526,71861
948,CapybaraOne,2,0.00278,57588,80.13804,71861
949,carlbordum,2,0.00278,57590,80.14083,71861
950,carlosaml,2,0.00278,57592,80.14361,71861
951,cblaindnsf,2,0.00278,57594,80.14639,71861
952,Cellane,2,0.00278,57596,80.14918,71861
953,charif45,2,0.00278,57598,80.15196,71861
954,cheesimp,2,0.00278,57600,80.15474,71861
955,ChrisFraun,2,0.00278,57602,80.15753,71861
956,christopher-dG,2,0.00278,57604,80.16031,71861
957,cjbischoff,2,0.00278,57606,80.16309,71861
958,cj-harries-bnet,2,0.00278,57608,80.16588,71861
959,cjsrkd3321,2,0.00278,57610,80.16866,71861
960,ckav370,2,0.00278,57612,80.17144,71861
961,ckhelifi,2,0.00278,57614,80.17423,71861
962,claydanford,2,0.00278,57616,80.17701,71861
963,cmnzs,2,0.00278,57618,80.17979,71861
964,colin-carro,2,0.00278,57620,80.18257,71861
965,comjf,2,0.00278,57622,80.18536,71861
966,CommanderTso,2,0.00278,57624,80.18814,71861
967,cookytime,2,0.00278,57626,80.19092,71861
968,cvirtucio,2,0.00278,57628,80.19371,71861
969,cvittorialsq,2,0.00278,57630,80.19649,71861
970,cwstrommer,2,0.00278,57632,80.19927,71861
971,Dakshjain1,2,0.00278,57634,80.20206,71861
972,damlub,2,0.00278,57636,80.20484,71861
973,DaniBet,2,0.00278,57638,80.20762,71861
974,dasusrinivas,2,0.00278,57640,80.21041,71861
975,davehewy,2,0.00278,57642,80.21319,71861
976,davidsielert,2,0.00278,57644,80.21597,71861
977,dbaboy,2,0.00278,57646,80.21876,71861
978,dbeattie71,2,0.00278,57648,80.22154,71861
979,dbolack,2,0.00278,57650,80.22432,71861
980,dcloud9,2,0.00278,57652,80.22711,71861
981,ddaws,2,0.00278,57654,80.22989,71861
982,deadanon,2,0.00278,57656,80.23267,71861
983,devesh-bedrock,2,0.00278,57658,80.23545,71861
984,devlincashman,2,0.00278,57660,80.23824,71861
985,dexterleng,2,0.00278,57662,80.24102,71861
986,dgilev,2,0.00278,57664,80.24380,71861
987,dhlaluku,2,0.00278,57666,80.24659,71861
988,dimitar-hristov,2,0.00278,57668,80.24937,71861
989,djordje-petrovic,2,0.00278,57670,80.25215,71861
990,dmeadows,2,0.00278,57672,80.25494,71861
991,dmitrime,2,0.00278,57674,80.25772,71861
992,dominik-dezordo-vc,2,0.00278,57676,80.26050,71861
993,Donnie,2,0.00278,57678,80.26329,71861
994,DovnarAlexander,2,0.00278,57680,80.26607,71861
995,echohack,2,0.00278,57682,80.26885,71861
996,edanc,2,0.00278,57684,80.27164,71861
997,Eddie4Frost,2,0.00278,57686,80.27442,71861
998,elementalvoid,2,0.00278,57688,80.27720,71861
999,eltonpadilha,2,0.00278,57690,80.27998,71861
1000,emulanob,2,0.00278,57692,80.28277,71861
1001,ericnorris,2,0.00278,57694,80.28555,71861
1002,ers81239,2,0.00278,57696,80.28833,71861
1003,etherops,2,0.00278,57698,80.29112,71861
1004,ethicalmohit,2,0.00278,57700,80.29390,71861
1005,evanstoddard23,2,0.00278,57702,80.29668,71861
1006,fanfoni,2,0.00278,57704,80.29947,71861
1007,fazith27,2,0.00278,57706,80.30225,71861
1008,ferpizza,2,0.00278,57708,80.30503,71861
1009,fin09pcap,2,0.00278,57710,80.30782,71861
1010,firastahir,2,0.00278,57712,80.31060,71861
1011,forestoden,2,0.00278,57714,80.31338,71861
1012,franklines,2,0.00278,57716,80.31617,71861
1013,fredcooke,2,0.00278,57718,80.31895,71861
1014,Gabryel8818,2,0.00278,57720,80.32173,71861
1015,GaloGlober,2,0.00278,57722,80.32452,71861
1016,ganeshk1928,2,0.00278,57724,80.32730,71861
1017,gilzellner,2,0.00278,57726,80.33008,71861
1018,gotchasriracha,2,0.00278,57728,80.33286,71861
1019,greghensley,2,0.00278,57730,80.33565,71861
1020,GregUK,2,0.00278,57732,80.33843,71861
1021,gszurek,2,0.00278,57734,80.34121,71861
1022,gunnertwin,2,0.00278,57736,80.34400,71861
1023,hacktoon,2,0.00278,57738,80.34678,71861
1024,hanskhe,2,0.00278,57740,80.34956,71861
1025,Harishkumar-Subramanian,2,0.00278,57742,80.35235,71861
1026,Harpreet434,2,0.00278,57744,80.35513,71861
1027,hedlund,2,0.00278,57746,80.35791,71861
1028,henrycpainter,2,0.00278,57748,80.36070,71861
1029,heretse,2,0.00278,57750,80.36348,71861
1030,herrsergio,2,0.00278,57752,80.36626,71861
1031,heruscoder,2,0.00278,57754,80.36905,71861
1032,hhsnow,2,0.00278,57756,80.37183,71861
1033,hrishinan,2,0.00278,57758,80.37461,71861
1034,hroapye,2,0.00278,57760,80.37740,71861
1035,hsharma81,2,0.00278,57762,80.38018,71861
1036,huylinh1997,2,0.00278,57764,80.38296,71861
1037,iehrenwald-linode,2,0.00278,57766,80.38574,71861
1038,ijames-gc,2,0.00278,57768,80.38853,71861
1039,ilamtap,2,0.00278,57770,80.39131,71861
1040,Isan-Rivkin,2,0.00278,57772,80.39409,71861
1041,ishioni,2,0.00278,57774,80.39688,71861
1042,IslamAzab,2,0.00278,57776,80.39966,71861
1043,ivanmartos,2,0.00278,57778,80.40244,71861
1044,IVBakker,2,0.00278,57780,80.40523,71861
1045,izo-kshanahan,2,0.00278,57782,80.40801,71861
1046,Jack64,2,0.00278,57784,80.41079,71861
1047,jacobnguyenn,2,0.00278,57786,80.41358,71861
1048,jamesmaidment,2,0.00278,57788,80.41636,71861
1049,javierbeaumont,2,0.00278,57790,80.41914,71861
1050,jcookfastrobot,2,0.00278,57792,80.42193,71861
1051,Jdsleppy,2,0.00278,57794,80.42471,71861
1052,jeffdawes-mec,2,0.00278,57796,80.42749,71861
1053,jekhokie,2,0.00278,57798,80.43028,71861
1054,jffrose,2,0.00278,57800,80.43306,71861
1055,jhoff909,2,0.00278,57802,80.43584,71861
1056,jhosteny,2,0.00278,57804,80.43862,71861
1057,jianyuan,2,0.00278,57806,80.44141,71861
1058,jinopl,2,0.00278,57808,80.44419,71861
1059,jluque0101,2,0.00278,57810,80.44697,71861
1060,jmahowald,2,0.00278,57812,80.44976,71861
1061,Jno21,2,0.00278,57814,80.45254,71861
1062,joedenniss,2,0.00278,57816,80.45532,71861
1063,joshuawscott,2,0.00278,57818,80.45811,71861
1064,juliusdanielherreraglomm,2,0.00278,57820,80.46089,71861
1065,jullianow,2,0.00278,57822,80.46367,71861
1066,jun06t,2,0.00278,57824,80.46646,71861
1067,kalyaniZapi,2,0.00278,57826,80.46924,71861
1068,kamilkrampa,2,0.00278,57828,80.47202,71861
1069,kangman,2,0.00278,57830,80.47481,71861
1070,kawa-marcin,2,0.00278,57832,80.47759,71861
1071,keepclean,2,0.00278,57834,80.48037,71861
1072,kemalgoklenlentify,2,0.00278,57836,80.48315,71861
1073,KivraChristoffer,2,0.00278,57838,80.48594,71861
1074,klub,2,0.00278,57840,80.48872,71861
1075,kopax-polyconseil,2,0.00278,57842,80.49150,71861
1076,korjanvos,2,0.00278,57844,80.49429,71861
1077,kubotake5105,2,0.00278,57846,80.49707,71861
1078,kumarsen26,2,0.00278,57848,80.49985,71861
1079,kyrian666,2,0.00278,57850,80.50264,71861
1080,kzap,2,0.00278,57852,80.50542,71861
1081,lacebal,2,0.00278,57854,80.50820,71861
1082,lahenn,2,0.00278,57856,80.51099,71861
1083,LBates2000,2,0.00278,57858,80.51377,71861
1084,lexarflash8g,2,0.00278,57860,80.51655,71861
1085,libfitz,2,0.00278,57862,80.51934,71861
1086,liquidtdc,2,0.00278,57864,80.52212,71861
1087,lucetre,2,0.00278,57866,80.52490,71861
1088,lukassup,2,0.00278,57868,80.52769,71861
1089,m-adawi,2,0.00278,57870,80.53047,71861
1090,magistersart,2,0.00278,57872,80.53325,71861
1091,magusd,2,0.00278,57874,80.53603,71861
1092,makarek,2,0.00278,57876,80.53882,71861
1093,Manan-Kothari,2,0.00278,57878,80.54160,71861
1094,Manny334,2,0.00278,57880,80.54438,71861
1095,marcinswigon,2,0.00278,57882,80.54717,71861
1096,margueritepd,2,0.00278,57884,80.54995,71861
1097,markbrennan,2,0.00278,57886,80.55273,71861
1098,markitoxs,2,0.00278,57888,80.55552,71861
1099,markliederbach,2,0.00278,57890,80.55830,71861
1100,markweaver697,2,0.00278,57892,80.56108,71861
1101,martinhanzik,2,0.00278,57894,80.56387,71861
1102,mathewtapilatu,2,0.00278,57896,80.56665,71861
1103,matthewellis-pp,2,0.00278,57898,80.56943,71861
1104,matthieudelaro,2,0.00278,57900,80.57222,71861
1105,mattkeeler,2,0.00278,57902,80.57500,71861
1106,MattMencel,2,0.00278,57904,80.57778,71861
1107,Mattsky,2,0.00278,57906,80.58057,71861
1108,maximgrigorov,2,0.00278,57908,80.58335,71861
1109,mbeacom,2,0.00278,57910,80.58613,71861
1110,mburgess-attune,2,0.00278,57912,80.58891,71861
1111,md-magenta,2,0.00278,57914,80.59170,71861
1112,mgrapiniak,2,0.00278,57916,80.59448,71861
1113,mhmmdtskr,2,0.00278,57918,80.59726,71861
1114,michael132,2,0.00278,57920,80.60005,71861
1115,Michael-Coetzee,2,0.00278,57922,80.60283,71861
1116,mijdavis2,2,0.00278,57924,80.60561,71861
1117,mingfang,2,0.00278,57926,80.60840,71861
1118,mlalam,2,0.00278,57928,80.61118,71861
1119,mmsyano,2,0.00278,57930,80.61396,71861
1120,mredulorfiaz,2,0.00278,57932,80.61675,71861
1121,mrmcgrew,2,0.00278,57934,80.61953,71861
1122,m-ronchi,2,0.00278,57936,80.62231,71861
1123,mvazconsuelo,2,0.00278,57938,80.62510,71861
1124,mwos-sl,2,0.00278,57940,80.62788,71861
1125,nathanmonteleone,2,0.00278,57942,80.63066,71861
1126,navesimchi,2,0.00278,57944,80.63345,71861
1127,ncaunt-sr,2,0.00278,57946,80.63623,71861
1128,ndavies-om1,2,0.00278,57948,80.63901,71861
1129,nicarnold-toast,2,0.00278,57950,80.64179,71861
1130,NicholasGWK,2,0.00278,57952,80.64458,71861
1131,nicolst,2,0.00278,57954,80.64736,71861
1132,ninjahck,2,0.00278,57956,80.65014,71861
1133,nocode99,2,0.00278,57958,80.65293,71861
1134,norman-zon,2,0.00278,57960,80.65571,71861
1135,nronnei,2,0.00278,57962,80.65849,71861
1136,nvx,2,0.00278,57964,80.66128,71861
1137,nw-code,2,0.00278,57966,80.66406,71861
1138,ocaisa,2,0.00278,57968,80.66684,71861
1139,ojacobson,2,0.00278,57970,80.66963,71861
1140,OleKirs,2,0.00278,57972,80.67241,71861
1141,olia-dev,2,0.00278,57974,80.67519,71861
1142,oliver-vini,2,0.00278,57976,80.67798,71861
1143,pafable,2,0.00278,57978,80.68076,71861
1144,pasvel,2,0.00278,57980,80.68354,71861
1145,pavanm-huma,2,0.00278,57982,80.68632,71861
1146,PavanRaga,2,0.00278,57984,80.68911,71861
1147,pavanyejare,2,0.00278,57986,80.69189,71861
1148,pavlokudrynskyi,2,0.00278,57988,80.69467,71861
1149,pavlopavlichenko-cs,2,0.00278,57990,80.69746,71861
1150,pcb737,2,0.00278,57992,80.70024,71861
1151,PePoDev,2,0.00278,57994,80.70302,71861
1152,peterkulik,2,0.00278,57996,80.70581,71861
1153,PhilippWitzmann,2,0.00278,57998,80.70859,71861
1154,PiyushBhatewara,2,0.00278,58000,80.71137,71861
1155,plieberg,2,0.00278,58002,80.71416,71861
1156,pp-davy,2,0.00278,58004,80.71694,71861
1157,Prajithp,2,0.00278,58006,80.71972,71861
1158,pryshchepovvvp,2,0.00278,58008,80.72251,71861
1159,psura,2,0.00278,58010,80.72529,71861
1160,pysysops,2,0.00278,58012,80.72807,71861
1161,qodirovshohijahon,2,0.00278,58014,80.73086,71861
1162,qugu,2,0.00278,58016,80.73364,71861
1163,quidio,2,0.00278,58018,80.73642,71861
1164,rafaelonline,2,0.00278,58020,80.73920,71861
1165,RafaelParisi,2,0.00278,58022,80.74199,71861
1166,ragne,2,0.00278,58024,80.74477,71861
1167,RahmanBadru,2,0.00278,58026,80.74755,71861
1168,ran-styr-sage,2,0.00278,58028,80.75034,71861
1169,rarkebauer,2,0.00278,58030,80.75312,71861
1170,RelativeSure,2,0.00278,58032,80.75590,71861
1171,rhclaudio,2,0.00278,58034,80.75869,71861
1172,rlex,2,0.00278,58036,80.76147,71861
1173,robatwave,2,0.00278,58038,80.76425,71861
1174,rohanprabhu,2,0.00278,58040,80.76704,71861
1175,rohitgit-web,2,0.00278,58042,80.76982,71861
1176,RomkaV,2,0.00278,58044,80.77260,71861
1177,romulofranca,2,0.00278,58046,80.77539,71861
1178,rsvalerio,2,0.00278,58048,80.77817,71861
1179,rushrs,2,0.00278,58050,80.78095,71861
1180,RyanJarv,2,0.00278,58052,80.78374,71861
1181,ryanking,2,0.00278,58054,80.78652,71861
1182,rymha-sj,2,0.00278,58056,80.78930,71861
1183,sadminriley,2,0.00278,58058,80.79208,71861
1184,salvaxedor,2,0.00278,58060,80.79487,71861
1185,samlaf,2,0.00278,58062,80.79765,71861
1186,sandy-0007,2,0.00278,58064,80.80043,71861
1187,sankansm23,2,0.00278,58066,80.80322,71861
1188,santhosh1994m,2,0.00278,58068,80.80600,71861
1189,scott-standard,2,0.00278,58070,80.80878,71861
1190,secjosh,2,0.00278,58072,80.81157,71861
1191,selmison,2,0.00278,58074,80.81435,71861
1192,Sergey-Kirgizov,2,0.00278,58076,80.81713,71861
1193,SerhiiK,2,0.00278,58078,80.81992,71861
1194,SerhiiSokolov,2,0.00278,58080,80.82270,71861
1195,shantanugadgil,2,0.00278,58082,80.82548,71861
1196,Shocktrooper,2,0.00278,58084,80.82827,71861
1197,SimonBiggs,2,0.00278,58086,80.83105,71861
1198,sindhusegment,2,0.00278,58088,80.83383,71861
1199,Smixi,2,0.00278,58090,80.83662,71861
1200,soapergem,2,0.00278,58092,80.83940,71861
1201,sp-aliciaalcalde,2,0.00278,58094,80.84218,71861
1202,spamoom,2,0.00278,58096,80.84496,71861
1203,spasam,2,0.00278,58098,80.84775,71861
1204,srsirius,2,0.00278,58100,80.85053,71861
1205,ssabo,2,0.00278,58102,80.85331,71861
1206,SteezyCougar,2,0.00278,58104,80.85610,71861
1207,sudhi272,2,0.00278,58106,80.85888,71861
1208,sunnykrGupta,2,0.00278,58108,80.86166,71861
1209,surminus,2,0.00278,58110,80.86445,71861
1210,suryaakhila002,2,0.00278,58112,80.86723,71861
1211,sw-carlin,2,0.00278,58114,80.87001,71861
1212,t3mi,2,0.00278,58116,80.87280,71861
1213,talibidris,2,0.00278,58118,80.87558,71861
1214,tao-devops,2,0.00278,58120,80.87836,71861
1215,tedder,2,0.00278,58122,80.88115,71861
1216,TGM,2,0.00278,58124,80.88393,71861
1217,theautoroboto,2,0.00278,58126,80.88671,71861
1218,the-nando,2,0.00278,58128,80.88949,71861
1219,THL3VPN,2,0.00278,58130,80.89228,71861
1220,thomas-orange,2,0.00278,58132,80.89506,71861
1221,thomasv314,2,0.00278,58134,80.89784,71861
1222,thorkildcognite,2,0.00278,58136,80.90063,71861
1223,titanlien,2,0.00278,58138,80.90341,71861
1224,tltran-legion,2,0.00278,58140,80.90619,71861
1225,tmad,2,0.00278,58142,80.90898,71861
1226,tobwiens,2,0.00278,58144,80.91176,71861
1227,TonyDMorris,2,0.00278,58146,80.91454,71861
1228,tribu,2,0.00278,58148,80.91733,71861
1229,tylermarshall,2,0.00278,58150,80.92011,71861
1230,Tyrael,2,0.00278,58152,80.92289,71861
1231,velvetzhero,2,0.00278,58154,80.92568,71861
1232,vgpastor,2,0.00278,58156,80.92846,71861
1233,vibhuyadav,2,0.00278,58158,80.93124,71861
1234,vicente-valls,2,0.00278,58160,80.93403,71861
1235,victorfrancax1,2,0.00278,58162,80.93681,71861
1236,Vikas-Tamboli,2,0.00278,58164,80.93959,71861
1237,vincentmrg,2,0.00278,58166,80.94237,71861
1238,wagner,2,0.00278,58168,80.94516,71861
1239,wasanhimanshu,2,0.00278,58170,80.94794,71861
1240,wilhelmi,2,0.00278,58172,80.95072,71861
1241,williamlord-wise,2,0.00278,58174,80.95351,71861
1242,worldwideward,2,0.00278,58176,80.95629,71861
1243,wzur-r3,2,0.00278,58178,80.95907,71861
1244,xavixendit,2,0.00278,58180,80.96186,71861
1245,xNok,2,0.00278,58182,80.96464,71861
1246,yannh,2,0.00278,58184,80.96742,71861
1247,yazidalg,2,0.00278,58186,80.97021,71861
1248,ygersie,2,0.00278,58188,80.97299,71861
1249,yhndrk,2,0.00278,58190,80.97577,71861
1250,yiranyao,2,0.00278,58192,80.97856,71861
1251,yorik,2,0.00278,58194,80.98134,71861
1252,youkun19,2,0.00278,58196,80.98412,71861
1253,yuriydee,2,0.00278,58198,80.98691,71861
1254,zhangluva,2,0.00278,58200,80.98969,71861
1255,0x0013,1,0.00139,58201,80.99108,71861
1256,0xch4z,1,0.00139,58202,80.99247,71861
1257,119Vik,1,0.00139,58203,80.99386,71861
1258,aaelius-medallia,1,0.00139,58204,80.99525,71861
1259,aandre-wise,1,0.00139,58205,80.99665,71861
1260,AaveshK,1,0.00139,58206,80.99804,71861
1261,abemusic,1,0.00139,58207,80.99943,71861
1262,absenth,1,0.00139,58208,81.00082,71861
1263,a-carter,1,0.00139,58209,81.00221,71861
1264,acrontum-ferreira,1,0.00139,58210,81.00360,71861
1265,adharmawan,1,0.00139,58211,81.00500,71861
1266,adnankobir,1,0.00139,58212,81.00639,71861
1267,adsgray,1,0.00139,58213,81.00778,71861
1268,adubeniuk,1,0.00139,58214,81.00917,71861
1269,aeugenio,1,0.00139,58215,81.01056,71861
1270,agupta94,1,0.00139,58216,81.01195,71861
1271,a-hat,1,0.00139,58217,81.01335,71861
1272,ahiaht,1,0.00139,58218,81.01474,71861
1273,aiell0,1,0.00139,58219,81.01613,71861
1274,AJakkam38,1,0.00139,58220,81.01752,71861
1275,akhan23wgu,1,0.00139,58221,81.01891,71861
1276,akintewe,1,0.00139,58222,81.02030,71861
1277,AkshathPatkar,1,0.00139,58223,81.02169,71861
1278,Akshaybobade-searce,1,0.00139,58224,81.02309,71861
1279,aldenstpage,1,0.00139,58225,81.02448,71861
1280,aldojimenez,1,0.00139,58226,81.02587,71861
1281,Alex734xx,1,0.00139,58227,81.02726,71861
1282,AlexanderRasmussen,1,0.00139,58228,81.02865,71861
1283,alexclifford,1,0.00139,58229,81.03004,71861
1284,alexdaviestray,1,0.00139,58230,81.03144,71861
1285,alexkosj,1,0.00139,58231,81.03283,71861
1286,Alex-Mussell,1,0.00139,58232,81.03422,71861
1287,alexoliveira88,1,0.00139,58233,81.03561,71861
1288,alex-practice,1,0.00139,58234,81.03700,71861
1289,alexsuninsth,1,0.00139,58235,81.03839,71861
1290,Alexvianet,1,0.00139,58236,81.03979,71861
1291,aliadolfo,1,0.00139,58237,81.04118,71861
1292,Alsyia,1,0.00139,58238,81.04257,71861
1293,amv-github-automation,1,0.00139,58239,81.04396,71861
1294,andresjulia1,1,0.00139,58240,81.04535,71861
1295,Andrews-repo,1,0.00139,58241,81.04674,71861
1296,andridzi,1,0.00139,58242,81.04813,71861
1297,andyyaldoo,1,0.00139,58243,81.04953,71861
1298,Angelin01,1,0.00139,58244,81.05092,71861
1299,anismajd,1,0.00139,58245,81.05231,71861
1300,anitakrueger,1,0.00139,58246,81.05370,71861
1301,ankitnith99,1,0.00139,58247,81.05509,71861
1302,anotherminh,1,0.00139,58248,81.05648,71861
1303,AnushkaMat,1,0.00139,58249,81.05788,71861
1304,apoorvabelsare,1,0.00139,58250,81.05927,71861
1305,apopkalypse,1,0.00139,58251,81.06066,71861
1306,appros,1,0.00139,58252,81.06205,71861
1307,archil620,1,0.00139,58253,81.06344,71861
1308,arcjor,1,0.00139,58254,81.06483,71861
1309,arnaudmm,1,0.00139,58255,81.06623,71861
1310,arquitetura-cloud,1,0.00139,58256,81.06762,71861
1311,arsaghri,1,0.00139,58257,81.06901,71861
1312,artarazavi,1,0.00139,58258,81.07040,71861
1313,artworkad,1,0.00139,58259,81.07179,71861
1314,asafdavid23,1,0.00139,58260,81.07318,71861
1315,asaghri,1,0.00139,58261,81.07457,71861
1316,asavoy,1,0.00139,58262,81.07597,71861
1317,asevans,1,0.00139,58263,81.07736,71861
1318,ashraf-minhaj,1,0.00139,58264,81.07875,71861
1319,aston-r,1,0.00139,58265,81.08014,71861
1320,asvinours,1,0.00139,58266,81.08153,71861
1321,atali,1,0.00139,58267,81.08292,71861
1322,atlantis-infotech,1,0.00139,58268,81.08432,71861
1323,atmask,1,0.00139,58269,81.08571,71861
1324,augustohp,1,0.00139,58270,81.08710,71861
1325,Austin37AF,1,0.00139,58271,81.08849,71861
1326,avazhnov-griddynamics,1,0.00139,58272,81.08988,71861
1327,awhitepl,1,0.00139,58273,81.09127,71861
1328,awiddersheim,1,0.00139,58274,81.09267,71861
1329,awright-oak9,1,0.00139,58275,81.09406,71861
1330,ax-nmac,1,0.00139,58276,81.09545,71861
1331,azizzoaib786,1,0.00139,58277,81.09684,71861
1332,azmathasan92,1,0.00139,58278,81.09823,71861
1333,babyhuey,1,0.00139,58279,81.09962,71861
1334,bacoboy-doordash,1,0.00139,58280,81.10101,71861
1335,bainss,1,0.00139,58281,81.10241,71861
1336,barrosoj,1,0.00139,58282,81.10380,71861
1337,bartelemi,1,0.00139,58283,81.10519,71861
1338,bartosz-sadowy,1,0.00139,58284,81.10658,71861
1339,barundel,1,0.00139,58285,81.10797,71861
1340,BC-EWygonik,1,0.00139,58286,81.10936,71861
1341,bchu-oanda,1,0.00139,58287,81.11076,71861
1342,ben-dov,1,0.00139,58288,81.11215,71861
1343,benjy44,1,0.00139,58289,81.11354,71861
1344,bentterp,1,0.00139,58290,81.11493,71861
1345,bertinmeshita,1,0.00139,58291,81.11632,71861
1346,bfanyuk,1,0.00139,58292,81.11771,71861
1347,bgrams,1,0.00139,58293,81.11910,71861
1348,bhagya-98,1,0.00139,58294,81.12050,71861
1349,biancarosa,1,0.00139,58295,81.12189,71861
1350,BioEricSalter,1,0.00139,58296,81.12328,71861
1351,bkalcho,1,0.00139,58297,81.12467,71861
1352,blastdan,1,0.00139,58298,81.12606,71861
1353,bl-robinson,1,0.00139,58299,81.12745,71861
1354,bobtfish,1,0.00139,58300,81.12885,71861
1355,bogdan-rizac,1,0.00139,58301,81.13024,71861
1356,boggsboggs,1,0.00139,58302,81.13163,71861
1357,BouchaaraAdil,1,0.00139,58303,81.13302,71861
1358,brbraziel,1,0.00139,58304,81.13441,71861
1359,briananstett,1,0.00139,58305,81.13580,71861
1360,briannipper,1,0.00139,58306,81.13720,71861
1361,Brightside56,1,0.00139,58307,81.13859,71861
1362,brightwood83,1,0.00139,58308,81.13998,71861
1363,brodul,1,0.00139,58309,81.14137,71861
1364,bruce-szalwinski-he,1,0.00139,58310,81.14276,71861
1365,bryan-rhm,1,0.00139,58311,81.14415,71861
1366,bsecker,1,0.00139,58312,81.14554,71861
1367,B-Souty,1,0.00139,58313,81.14694,71861
1368,btsteve,1,0.00139,58314,81.14833,71861
1369,btsuhako,1,0.00139,58315,81.14972,71861
1370,byakku,1,0.00139,58316,81.15111,71861
1371,c0da,1,0.00139,58317,81.15250,71861
1372,calebAtIspot,1,0.00139,58318,81.15389,71861
1373,CallMeLaNN,1,0.00139,58319,81.15529,71861
1374,canidam,1,0.00139,58320,81.15668,71861
1375,carmo-evan,1,0.00139,58321,81.15807,71861
1376,cc-robertson,1,0.00139,58322,81.15946,71861
1377,Chad-Bailer,1,0.00139,58323,81.16085,71861
1378,chasse-code,1,0.00139,58324,81.16224,71861
1379,chauffer,1,0.00139,58325,81.16364,71861
1380,chauntelkellar,1,0.00139,58326,81.16503,71861
1381,chris1248,1,0.00139,58327,81.16642,71861
1382,ChrisGrayLDN,1,0.00139,58328,81.16781,71861
1383,chrisguitarguy,1,0.00139,58329,81.16920,71861
1384,chrislevi007,1,0.00139,58330,81.17059,71861
1385,christensen143,1,0.00139,58331,81.17198,71861
1386,ckite,1,0.00139,58332,81.17338,71861
1387,clatour,1,0.00139,58333,81.17477,71861
1388,claytonpiccinin,1,0.00139,58334,81.17616,71861
1389,clburlison,1,0.00139,58335,81.17755,71861
1390,cliffchapmanrbx,1,0.00139,58336,81.17894,71861
1391,cloud-pharaoh,1,0.00139,58337,81.18033,71861
1392,Cmadd12,1,0.00139,58338,81.18173,71861
1393,co2Taichi-skygrid,1,0.00139,58339,81.18312,71861
1394,codingconcepts,1,0.00139,58340,81.18451,71861
1395,codrinh,1,0.00139,58341,81.18590,71861
1396,collinpowerkariman,1,0.00139,58342,81.18729,71861
1397,corradomatt,1,0.00139,58343,81.18868,71861
1398,Cova,1,0.00139,58344,81.19008,71861
1399,cpuspellcaster,1,0.00139,58345,81.19147,71861
1400,cpwc,1,0.00139,58346,81.19286,71861
1401,crazy-matt,1,0.00139,58347,81.19425,71861
1402,cShirley14,1,0.00139,58348,81.19564,71861
1403,ctjens,1,0.00139,58349,81.19703,71861
1404,cynful,1,0.00139,58350,81.19842,71861
1405,Cyril89,1,0.00139,58351,81.19982,71861
1406,cyrilgdn,1,0.00139,58352,81.20121,71861
1407,czenderink,1,0.00139,58353,81.20260,71861
1408,DaniaErnest,1,0.00139,58354,81.20399,71861
1409,DanielRis,1,0.00139,58355,81.20538,71861
1410,danielvoxy,1,0.00139,58356,81.20677,71861
1411,dannyrife,1,0.00139,58357,81.20817,71861
1412,DanOfir,1,0.00139,58358,81.20956,71861
1413,dan-petty,1,0.00139,58359,81.21095,71861
1414,darkside720,1,0.00139,58360,81.21234,71861
1415,das-super,1,0.00139,58361,81.21373,71861
1416,davidji99,1,0.00139,58362,81.21512,71861
1417,davidpristovnik,1,0.00139,58363,81.21652,71861
1418,davidwmcneill,1,0.00139,58364,81.21791,71861
1419,davirodriguesrezende,1,0.00139,58365,81.21930,71861
1420,dbalucas,1,0.00139,58366,81.22069,71861
1421,dcallao,1,0.00139,58367,81.22208,71861
1422,dcernag,1,0.00139,58368,81.22347,71861
1423,dcpc007,1,0.00139,58369,81.22486,71861
1424,ddrugeon,1,0.00139,58370,81.22626,71861
1425,deefha,1,0.00139,58371,81.22765,71861
1426,Defozo,1,0.00139,58372,81.22904,71861
1427,dennislapchenko,1,0.00139,58373,81.23043,71861
1428,detvdl,1,0.00139,58374,81.23182,71861
1429,devops-groww,1,0.00139,58375,81.23321,71861
1430,devSarry,1,0.00139,58376,81.23461,71861
1431,dfsdevops,1,0.00139,58377,81.23600,71861
1432,dginzbourg,1,0.00139,58378,81.23739,71861
1433,dh-apporto,1,0.00139,58379,81.23878,71861
1434,dheerajbhaskar,1,0.00139,58380,81.24017,71861
1435,dinvlad,1,0.00139,58381,81.24156,71861
1436,dion-fernando,1,0.00139,58382,81.24296,71861
1437,divyeshramani,1,0.00139,58383,81.24435,71861
1438,djaboxx,1,0.00139,58384,81.24574,71861
1439,djsingh23,1,0.00139,58385,81.24713,71861
1440,dmaljovec,1,0.00139,58386,81.24852,71861
1441,dmerrick,1,0.00139,58387,81.24991,71861
1442,dmitri-lerko,1,0.00139,58388,81.25130,71861
1443,DomFourn,1,0.00139,58389,81.25270,71861
1444,dougbw,1,0.00139,58390,81.25409,71861
1445,drey143,1,0.00139,58391,81.25548,71861
1446,drmaciej,1,0.00139,58392,81.25687,71861
1447,ducleminhuiza,1,0.00139,58393,81.25826,71861
1448,duclm2609,1,0.00139,58394,81.25965,71861
1449,ducminhle,1,0.00139,58395,81.26105,71861
1450,duncanwraightzip,1,0.00139,58396,81.26244,71861
1451,duomaxwellr,1,0.00139,58397,81.26383,71861
1452,DwaineSaunderson,1,0.00139,58398,81.26522,71861
1453,eamonryan,1,0.00139,58399,81.26661,71861
1454,eballetbaz,1,0.00139,58400,81.26800,71861
1455,edgarsandi,1,0.00139,58401,81.26940,71861
1456,eechava66,1,0.00139,58402,81.27079,71861
1457,ehuizar1028,1,0.00139,58403,81.27218,71861
1458,ekrem95,1,0.00139,58404,81.27357,71861
1459,eliasscosta,1,0.00139,58405,81.27496,71861
1460,elisiariocouto,1,0.00139,58406,81.27635,71861
1461,elliott-weston-transferwise,1,0.00139,58407,81.27774,71861
1462,ellisio,1,0.00139,58408,81.27914,71861
1463,emcniece,1,0.00139,58409,81.28053,71861
1464,epacke,1,0.00139,58410,81.28192,71861
1465,erickearns,1,0.00139,58411,81.28331,71861
1466,ervin-pactum,1,0.00139,58412,81.28470,71861
1467,Ethan-Yupan-Liu,1,0.00139,58413,81.28609,71861
1468,etienne-napoleone,1,0.00139,58414,81.28749,71861
1469,faelau,1,0.00139,58415,81.28888,71861
1470,felipeIntelipost,1,0.00139,58416,81.29027,71861
1471,fergaldonlon,1,0.00139,58417,81.29166,71861
1472,filipemiguelrocha,1,0.00139,58418,81.29305,71861
1473,FlorianNeacsu,1,0.00139,58419,81.29444,71861
1474,fniko,1,0.00139,58420,81.29584,71861
1475,fourirakbar,1,0.00139,58421,81.29723,71861
1476,fr3man1,1,0.00139,58422,81.29862,71861
1477,FRABUCHI,1,0.00139,58423,81.30001,71861
1478,FrancoisPoinsot,1,0.00139,58424,81.30140,71861
1479,frtr1p,1,0.00139,58425,81.30279,71861
1480,gabel0287,1,0.00139,58426,81.30418,71861
1481,GabeL7r,1,0.00139,58427,81.30558,71861
1482,Gabidiela,1,0.00139,58428,81.30697,71861
1483,GabrielBB,1,0.00139,58429,81.30836,71861
1484,gai6948,1,0.00139,58430,81.30975,71861
1485,gaston-te,1,0.00139,58431,81.31114,71861
1486,gaurav517,1,0.00139,58432,81.31253,71861
1487,gerrywd,1,0.00139,58433,81.31393,71861
1488,gespi1,1,0.00139,58434,81.31532,71861
1489,ggoddemeier,1,0.00139,58435,81.31671,71861
1490,ggujabidze,1,0.00139,58436,81.31810,71861
1491,Gilk260,1,0.00139,58437,81.31949,71861
1492,girlpunk,1,0.00139,58438,81.32088,71861
1493,giskou,1,0.00139,58439,81.32227,71861
1494,glcx,1,0.00139,58440,81.32367,71861
1495,glenwinters,1,0.00139,58441,81.32506,71861
1496,gluehbirnenkopf,1,0.00139,58442,81.32645,71861
1497,gmaliar,1,0.00139,58443,81.32784,71861
1498,g-psantos,1,0.00139,58444,81.32923,71861
1499,grace-instrumental,1,0.00139,58445,81.33062,71861
1500,gregory-v,1,0.00139,58446,81.33202,71861
1501,GreyTeardrop,1,0.00139,58447,81.33341,71861
1502,grjones,1,0.00139,58448,81.33480,71861
1503,gszakonyNitro,1,0.00139,58449,81.33619,71861
1504,guidor,1,0.00139,58450,81.33758,71861
1505,guilhermetrescatozup,1,0.00139,58451,81.33897,71861
1506,guillermotti,1,0.00139,58452,81.34037,71861
1507,gutmensch,1,0.00139,58453,81.34176,71861
1508,gvwirth,1,0.00139,58454,81.34315,71861
1509,hamstah,1,0.00139,58455,81.34454,71861
1510,hanpeter,1,0.00139,58456,81.34593,71861
1511,hart1dechu,1,0.00139,58457,81.34732,71861
1512,hasland,1,0.00139,58458,81.34871,71861
1513,Hax7,1,0.00139,58459,81.35011,71861
1514,hayaah,1,0.00139,58460,81.35150,71861
1515,hcevensen,1,0.00139,58461,81.35289,71861
1516,hd214,1,0.00139,58462,81.35428,71861
1517,Heiko-san,1,0.00139,58463,81.35567,71861
1518,Heldroe,1,0.00139,58464,81.35706,71861
1519,heruscode,1,0.00139,58465,81.35846,71861
1520,hinling-blisspoint,1,0.00139,58466,81.35985,71861
1521,HK78-HAHA,1,0.00139,58467,81.36124,71861
1522,hle-iad,1,0.00139,58468,81.36263,71861
1523,holosix,1,0.00139,58469,81.36402,71861
1524,hopin-anton,1,0.00139,58470,81.36541,71861
1525,hoppalotta,1,0.00139,58471,81.36681,71861
1526,houdinisparks,1,0.00139,58472,81.36820,71861
1527,hprasad068,1,0.00139,58473,81.36959,71861
1528,hrzbrg,1,0.00139,58474,81.37098,71861
1529,hussainbani,1,0.00139,58475,81.37237,71861
1530,HyperMe1200,1,0.00139,58476,81.37376,71861
1531,ibottabt,1,0.00139,58477,81.37515,71861
1532,ibrahima,1,0.00139,58478,81.37655,71861
1533,idlebot,1,0.00139,58479,81.37794,71861
1534,igorjanevski,1,0.00139,58480,81.37933,71861
1535,imalinin,1,0.00139,58481,81.38072,71861
1536,Imsurajkr,1,0.00139,58482,81.38211,71861
1537,infernaltechnology,1,0.00139,58483,81.38350,71861
1538,infestonn,1,0.00139,58484,81.38490,71861
1539,infratidev,1,0.00139,58485,81.38629,71861
1540,iresprite,1,0.00139,58486,81.38768,71861
1541,ishaq-searce,1,0.00139,58487,81.38907,71861
1542,IvanPryshchpa,1,0.00139,58488,81.39046,71861
1543,j0rzsh,1,0.00139,58489,81.39185,71861
1544,JafoFett,1,0.00139,58490,81.39325,71861
1545,jakauppila,1,0.00139,58491,81.39464,71861
1546,jakemalleyman,1,0.00139,58492,81.39603,71861
1547,jakubjakubik,1,0.00139,58493,81.39742,71861
1548,jamesburriss,1,0.00139,58494,81.39881,71861
1549,jamesnicolas,1,0.00139,58495,81.40020,71861
1550,janhoon,1,0.00139,58496,81.40159,71861
1551,jannaspam,1,0.00139,58497,81.40299,71861
1552,jarviliam,1,0.00139,58498,81.40438,71861
1553,jaswennyhuangg,1,0.00139,58499,81.40577,71861
1554,jayhding,1,0.00139,58500,81.40716,71861
1555,jccarte,1,0.00139,58501,81.40855,71861
1556,JeanFred,1,0.00139,58502,81.40994,71861
1557,jeffersontavaresdm,1,0.00139,58503,81.41134,71861
1558,jeff-symphony,1,0.00139,58504,81.41273,71861
1559,JerkyTreats,1,0.00139,58505,81.41412,71861
1560,Jeroe37,1,0.00139,58506,81.41551,71861
1561,jeska,1,0.00139,58507,81.41690,71861
1562,JesseRhoads-PD,1,0.00139,58508,81.41829,71861
1563,JessieAMorris,1,0.00139,58509,81.41969,71861
1564,jficz,1,0.00139,58510,81.42108,71861
1565,JFryy,1,0.00139,58511,81.42247,71861
1566,jgeralnik,1,0.00139,58512,81.42386,71861
1567,jgoret,1,0.00139,58513,81.42525,71861
1568,jgournet,1,0.00139,58514,81.42664,71861
1569,jhebert-coursera,1,0.00139,58515,81.42803,71861
1570,jimsmith,1,0.00139,58516,81.42943,71861
1571,jlm0x013,1,0.00139,58517,81.43082,71861
1572,jlsjonas,1,0.00139,58518,81.43221,71861
1573,jmateusppay,1,0.00139,58519,81.43360,71861
1574,jmoraz1,1,0.00139,58520,81.43499,71861
1575,joao-zanutto,1,0.00139,58521,81.43638,71861
1576,joelp172,1,0.00139,58522,81.43778,71861
1577,joeybaer,1,0.00139,58523,81.43917,71861
1578,joeyqliu,1,0.00139,58524,81.44056,71861
1579,johntran-fastly,1,0.00139,58525,81.44195,71861
1580,jonmaestas,1,0.00139,58526,81.44334,71861
1581,jonnydford,1,0.00139,58527,81.44473,71861
1582,Jonnymcc,1,0.00139,58528,81.44613,71861
1583,jonny-rimek,1,0.00139,58529,81.44752,71861
1584,jonwtech,1,0.00139,58530,81.44891,71861
1585,JoostSaanen,1,0.00139,58531,81.45030,71861
1586,jordan-evans,1,0.00139,58532,81.45169,71861
1587,jorgemarey,1,0.00139,58533,81.45308,71861
1588,jorianvo,1,0.00139,58534,81.45447,71861
1589,joshraub-bw,1,0.00139,58535,81.45587,71861
1590,jpastoor,1,0.00139,58536,81.45726,71861
1591,j-p-k,1,0.00139,58537,81.45865,71861
1592,jrodante,1,0.00139,58538,81.46004,71861
1593,jrouly,1,0.00139,58539,81.46143,71861
1594,jschwartz79,1,0.00139,58540,81.46282,71861
1595,jsi73,1,0.00139,58541,81.46422,71861
1596,jsosic,1,0.00139,58542,81.46561,71861
1597,jstadnik,1,0.00139,58543,81.46700,71861
1598,juanidufourc,1,0.00139,58544,81.46839,71861
1599,judgeaxl,1,0.00139,58545,81.46978,71861
1600,juozasget,1,0.00139,58546,81.47117,71861
1601,kabaliwths,1,0.00139,58547,81.47257,71861
1602,karimbouchouicha,1,0.00139,58548,81.47396,71861
1603,kasimon,1,0.00139,58549,81.47535,71861
1604,katenels,1,0.00139,58550,81.47674,71861
1605,kclinden,1,0.00139,58551,81.47813,71861
1606,KeenanLawrence,1,0.00139,58552,81.47952,71861
1607,kelvingl,1,0.00139,58553,81.48091,71861
1608,kemv,1,0.00139,58554,81.48231,71861
1609,kenerwin88,1,0.00139,58555,81.48370,71861
1610,KevinCarterDev,1,0.00139,58556,81.48509,71861
1611,kevinduterne,1,0.00139,58557,81.48648,71861
1612,kevinneufeld,1,0.00139,58558,81.48787,71861
1613,khateeb15,1,0.00139,58559,81.48926,71861
1614,khatib-moh,1,0.00139,58560,81.49066,71861
1615,khushboo121,1,0.00139,58561,81.49205,71861
1616,kiddom-kq,1,0.00139,58562,81.49344,71861
1617,kiddouk,1,0.00139,58563,81.49483,71861
1618,kieferrj,1,0.00139,58564,81.49622,71861
1619,kiqdestro,1,0.00139,58565,81.49761,71861
1620,kirillmakhonin-brt,1,0.00139,58566,81.49901,71861
1621,kirstus,1,0.00139,58567,81.50040,71861
1622,kishanbsh-gilead,1,0.00139,58568,81.50179,71861
1623,kkirpichnikov-collibra,1,0.00139,58569,81.50318,71861
1624,kleinsmk,1,0.00139,58570,81.50457,71861
1625,kmannuz,1,0.00139,58571,81.50596,71861
1626,knjoroge,1,0.00139,58572,81.50735,71861
1627,ko-be,1,0.00139,58573,81.50875,71861
1628,kochmatzet,1,0.00139,58574,81.51014,71861
1629,krishnanandchoudhary,1,0.00139,58575,81.51153,71861
1630,kuwas,1,0.00139,58576,81.51292,71861
1631,lachlanmulcahy,1,0.00139,58577,81.51431,71861
1632,laertis,1,0.00139,58578,81.51570,71861
1633,lanzrein,1,0.00139,58579,81.51710,71861
1634,Lapeth,1,0.00139,58580,81.51849,71861
1635,lapwingcloud,1,0.00139,58581,81.51988,71861
1636,Lawands,1,0.00139,58582,81.52127,71861
1637,LeandroLeon102,1,0.00139,58583,81.52266,71861
1638,Ledermayer,1,0.00139,58584,81.52405,71861
1639,leodamasceno,1,0.00139,58585,81.52544,71861
1640,leonK-DI,1,0.00139,58586,81.52684,71861
1641,leonsodhi-lf,1,0.00139,58587,81.52823,71861
1642,letic,1,0.00139,58588,81.52962,71861
1643,liaden,1,0.00139,58589,81.53101,71861
1644,LieneJansone,1,0.00139,58590,81.53240,71861
1645,LiquidLemon,1,0.00139,58591,81.53379,71861
1646,LitianCai,1,0.00139,58592,81.53519,71861
1647,llamasad,1,0.00139,58593,81.53658,71861
1648,lnattrass,1,0.00139,58594,81.53797,71861
1649,logicminds,1,0.00139,58595,81.53936,71861
1650,Loic-R,1,0.00139,58596,81.54075,71861
1651,lordz-ei,1,0.00139,58597,81.54214,71861
1652,Lowess,1,0.00139,58598,81.54354,71861
1653,LrrrHF,1,0.00139,58599,81.54493,71861
1654,lub0v-parsable,1,0.00139,58600,81.54632,71861
1655,lucasko-dot,1,0.00139,58601,81.54771,71861
1656,lucass4,1,0.00139,58602,81.54910,71861
1657,Ludingfeng,1,0.00139,58603,81.55049,71861
1658,luizandrends,1,0.00139,58604,81.55188,71861
1659,luizliso,1,0.00139,58605,81.55328,71861
1660,lukmanulhakimd,1,0.00139,58606,81.55467,71861
1661,lusee88,1,0.00139,58607,81.55606,71861
1662,m477r1x,1,0.00139,58608,81.55745,71861
1663,MacTynow,1,0.00139,58609,81.55884,71861
1664,Maddco,1,0.00139,58610,81.56023,71861
1665,magneland,1,0.00139,58611,81.56163,71861
1666,MaheshDoiphode,1,0.00139,58612,81.56302,71861
1667,MahmoudDolah,1,0.00139,58613,81.56441,71861
1668,makzzz1986,1,0.00139,58614,81.56580,71861
1669,manojnayakkuna,1,0.00139,58615,81.56719,71861
1670,marcbas1,1,0.00139,58616,81.56858,71861
1671,Marcus-James-Adams,1,0.00139,58617,81.56998,71861
1672,Martelete,1,0.00139,58618,81.57137,71861
1673,martinohansen,1,0.00139,58619,81.57276,71861
1674,mathijshoogland,1,0.00139,58620,81.57415,71861
1675,MatijaBurisa,1,0.00139,58621,81.57554,71861
1676,matilote,1,0.00139,58622,81.57693,71861
1677,Matroxt,1,0.00139,58623,81.57832,71861
1678,mattb18,1,0.00139,58624,81.57972,71861
1679,matthieu-swu,1,0.00139,58625,81.58111,71861
1680,maxtacu,1,0.00139,58626,81.58250,71861
1681,mdeeks,1,0.00139,58627,81.58389,71861
1682,mdiez-modus,1,0.00139,58628,81.58528,71861
1683,mdmelo,1,0.00139,58629,81.58667,71861
1684,mehrdad-faridi,1,0.00139,58630,81.58807,71861
1685,MelodyyJay,1,0.00139,58631,81.58946,71861
1686,memphis88,1,0.00139,58632,81.59085,71861
1687,mholttech,1,0.00139,58633,81.59224,71861
1688,MicheleArturo,1,0.00139,58634,81.59363,71861
1689,mihaiturcu,1,0.00139,58635,81.59502,71861
1690,milalima,1,0.00139,58636,81.59642,71861
1691,modesvops,1,0.00139,58637,81.59781,71861
1692,moemoeq,1,0.00139,58638,81.59920,71861
1693,Mohkam,1,0.00139,58639,81.60059,71861
1694,morganhein,1,0.00139,58640,81.60198,71861
1695,Mor-Simplex,1,0.00139,58641,81.60337,71861
1696,moskitone,1,0.00139,58642,81.60476,71861
1697,moxli,1,0.00139,58643,81.60616,71861
1698,mplzik,1,0.00139,58644,81.60755,71861
1699,mqmr,1,0.00139,58645,81.60894,71861
1700,mrbitrary,1,0.00139,58646,81.61033,71861
1701,mrg2k8,1,0.00139,58647,81.61172,71861
1702,mrj0,1,0.00139,58648,81.61311,71861
1703,Mr-Mark2112,1,0.00139,58649,81.61451,71861
1704,mrnovalles,1,0.00139,58650,81.61590,71861
1705,msacchiPPRO,1,0.00139,58651,81.61729,71861
1706,MshahidPasha,1,0.00139,58652,81.61868,71861
1707,mspolitaev,1,0.00139,58653,81.62007,71861
1708,msurovcak,1,0.00139,58654,81.62146,71861
1709,mukeshpatil76,1,0.00139,58655,81.62286,71861
1710,murrelljenna,1,0.00139,58656,81.62425,71861
1711,musabmirza-amperon,1,0.00139,58657,81.62564,71861
1712,n3wt0n,1,0.00139,58658,81.62703,71861
1713,namanbajpayi,1,0.00139,58659,81.62842,71861
1714,nantiferov,1,0.00139,58660,81.62981,71861
1715,naresh-rupeek,1,0.00139,58661,81.63120,71861
1716,natewarr,1,0.00139,58662,81.63260,71861
1717,nattvasan,1,0.00139,58663,81.63399,71861
1718,ndoddaiah,1,0.00139,58664,81.63538,71861
1719,nealharris,1,0.00139,58665,81.63677,71861
1720,neefrehman,1,0.00139,58666,81.63816,71861
1721,neethu-p,1,0.00139,58667,81.63955,71861
1722,nevesm,1,0.00139,58668,81.64095,71861
1723,ngoclamnn,1,0.00139,58669,81.64234,71861
1724,nguyenhoaibao,1,0.00139,58670,81.64373,71861
1725,nilsSure,1,0.00139,58671,81.64512,71861
1726,ninjaSec7,1,0.00139,58672,81.64651,71861
1727,nipr-jdoenges,1,0.00139,58673,81.64790,71861
1728,nkolev-mparticle,1,0.00139,58674,81.64930,71861
1729,noordeen03,1,0.00139,58675,81.65069,71861
1730,nopp,1,0.00139,58676,81.65208,71861
1731,NorfairKing,1,0.00139,58677,81.65347,71861
1732,NotLikeThisCHR,1,0.00139,58678,81.65486,71861
1733,npsoniembark,1,0.00139,58679,81.65625,71861
1734,nthienan,1,0.00139,58680,81.65764,71861
1735,nunonog87,1,0.00139,58681,81.65904,71861
1736,nuno-silva,1,0.00139,58682,81.66043,71861
1737,nuteee,1,0.00139,58683,81.66182,71861
1738,nvima,1,0.00139,58684,81.66321,71861
1739,odedpriva,1,0.00139,58685,81.66460,71861
1740,oleg-glushak,1,0.00139,58686,81.66599,71861
1741,oxrishang,1,0.00139,58687,81.66739,71861
1742,packrat386,1,0.00139,58688,81.66878,71861
1743,PadreGregor,1,0.00139,58689,81.67017,71861
1744,paparuco,1,0.00139,58690,81.67156,71861
1745,patr00n,1,0.00139,58691,81.67295,71861
1746,paulbrianstephenson,1,0.00139,58692,81.67434,71861
1747,pavan-fp,1,0.00139,58693,81.67574,71861
1748,pdhara,1,0.00139,58694,81.67713,71861
1749,peplc,1,0.00139,58695,81.67852,71861
1750,petemounce,1,0.00139,58696,81.67991,71861
1751,pierknueppel,1,0.00139,58697,81.68130,71861
1752,piglowskilukasz,1,0.00139,58698,81.68269,71861
1753,piotr-vimn,1,0.00139,58699,81.68408,71861
1754,pkoltermann,1,0.00139,58700,81.68548,71861
1755,pkudaiyar,1,0.00139,58701,81.68687,71861
1756,PocketMobsters,1,0.00139,58702,81.68826,71861
1757,pof-jhansilva,1,0.00139,58703,81.68965,71861
1758,polarclair,1,0.00139,58704,81.69104,71861
1759,pozimkiewicz,1,0.00139,58705,81.69243,71861
1760,pranavdesai1900,1,0.00139,58706,81.69383,71861
1761,preetsindhal,1,0.00139,58707,81.69522,71861
1762,PScoriae,1,0.00139,58708,81.69661,71861
1763,pthornton,1,0.00139,58709,81.69800,71861
1764,qibint,1,0.00139,58710,81.69939,71861
1765,qimike,1,0.00139,58711,81.70078,71861
1766,quynhnhatnguyen,1,0.00139,58712,81.70218,71861
1767,raeder1986,1,0.00139,58713,81.70357,71861
1768,raffimohammed,1,0.00139,58714,81.70496,71861
1769,raghulkrishna,1,0.00139,58715,81.70635,71861
1770,raizyr,1,0.00139,58716,81.70774,71861
1771,Ram-Priyatham,1,0.00139,58717,81.70913,71861
1772,ranschn,1,0.00139,58718,81.71052,71861
1773,rathoreshakti7,1,0.00139,58719,81.71192,71861
1774,raz-bn,1,0.00139,58720,81.71331,71861
1775,rbenyounes,1,0.00139,58721,81.71470,71861
1776,rbolar,1,0.00139,58722,81.71609,71861
1777,rcalosso,1,0.00139,58723,81.71748,71861
1778,rednap,1,0.00139,58724,81.71887,71861
1779,remiflament,1,0.00139,58725,81.72027,71861
1780,reulan,1,0.00139,58726,81.72166,71861
1781,rgleme,1,0.00139,58727,81.72305,71861
1782,rguevara84,1,0.00139,58728,81.72444,71861
1783,rhea-so,1,0.00139,58729,81.72583,71861
1784,ricardolopes86,1,0.00139,58730,81.72722,71861
1785,richgerrard,1,0.00139,58731,81.72861,71861
1786,rjayaprakash-exelixis,1,0.00139,58732,81.73001,71861
1787,Rjerk,1,0.00139,58733,81.73140,71861
1788,rlonberg,1,0.00139,58734,81.73279,71861
1789,robbwagoner,1,0.00139,58735,81.73418,71861
1790,RobertAlbus,1,0.00139,58736,81.73557,71861
1791,rodrigocustodio92,1,0.00139,58737,81.73696,71861
1792,rodrigorato,1,0.00139,58738,81.73836,71861
1793,rogeruiz,1,0.00139,58739,81.73975,71861
1794,rohitshrivastava04,1,0.00139,58740,81.74114,71861
1795,romeuhcf,1,0.00139,58741,81.74253,71861
1796,RonLek,1,0.00139,58742,81.74392,71861
1797,rossstr-clickup,1,0.00139,58743,81.74531,71861
1798,r-pra,1,0.00139,58744,81.74671,71861
1799,rr0hit,1,0.00139,58745,81.74810,71861
1800,rsbernardesuol,1,0.00139,58746,81.74949,71861
1801,rs-spectrm,1,0.00139,58747,81.75088,71861
1802,rtb-recursion,1,0.00139,58748,81.75227,71861
1803,rtkjbeverly,1,0.00139,58749,81.75366,71861
1804,rudub,1,0.00139,58750,81.75505,71861
1805,rux616,1,0.00139,58751,81.75645,71861
1806,RVennu,1,0.00139,58752,81.75784,71861
1807,rwc,1,0.00139,58753,81.75923,71861
1808,ryan-at-gogo,1,0.00139,58754,81.76062,71861
1809,safeith,1,0.00139,58755,81.76201,71861
1810,sakshigawande12,1,0.00139,58756,81.76340,71861
1811,samarara,1,0.00139,58757,81.76480,71861
1812,samcgardner,1,0.00139,58758,81.76619,71861
1813,sam-myers,1,0.00139,58759,81.76758,71861
1814,SamuelNeves,1,0.00139,58760,81.76897,71861
1815,sandesvitor,1,0.00139,58761,81.77036,71861
1816,sara-hann,1,0.00139,58762,81.77175,71861
1817,saraiva82,1,0.00139,58763,81.77315,71861
1818,sathish-git123,1,0.00139,58764,81.77454,71861
1819,satyapramodh,1,0.00139,58765,81.77593,71861
1820,sb-travelperk,1,0.00139,58766,81.77732,71861
1821,ScaCap,1,0.00139,58767,81.77871,71861
1822,scytem,1,0.00139,58768,81.78010,71861
1823,sdellang,1,0.00139,58769,81.78149,71861
1824,seancaffery,1,0.00139,58770,81.78289,71861
1825,sendit2me,1,0.00139,58771,81.78428,71861
1826,shaharveeva,1,0.00139,58772,81.78567,71861
1827,shanesavoie,1,0.00139,58773,81.78706,71861
1828,ShankyJS,1,0.00139,58774,81.78845,71861
1829,shapeofarchitect,1,0.00139,58775,81.78984,71861
1830,sharkymcdongles,1,0.00139,58776,81.79124,71861
1831,shinka81,1,0.00139,58777,81.79263,71861
1832,ShivamSinghSRE,1,0.00139,58778,81.79402,71861
1833,shrutijodevops,1,0.00139,58779,81.79541,71861
1834,shubhang93,1,0.00139,58780,81.79680,71861
1835,siggimoo,1,0.00139,58781,81.79819,71861
1836,silopolis,1,0.00139,58782,81.79959,71861
1837,sinux-l5d,1,0.00139,58783,81.80098,71861
1838,skleiner-te,1,0.00139,58784,81.80237,71861
1839,skolsuper,1,0.00139,58785,81.80376,71861
1840,sksaranraj,1,0.00139,58786,81.80515,71861
1841,SkypLabs,1,0.00139,58787,81.80654,71861
1842,sleevin,1,0.00139,58788,81.80793,71861
1843,slessardjr,1,0.00139,58789,81.80933,71861
1844,smutel,1,0.00139,58790,81.81072,71861
1845,snazzyfox,1,0.00139,58791,81.81211,71861
1846,sohel2020,1,0.00139,58792,81.81350,71861
1847,soloradish,1,0.00139,58793,81.81489,71861
1848,solutiongeek,1,0.00139,58794,81.81628,71861
1849,sowpapaibrahima,1,0.00139,58795,81.81768,71861
1850,sphvn,1,0.00139,58796,81.81907,71861
1851,ssaxen0-0909,1,0.00139,58797,81.82046,71861
1852,starkers,1,0.00139,58798,81.82185,71861
1853,stdmje,1,0.00139,58799,81.82324,71861
1854,sterfield,1,0.00139,58800,81.82463,71861
1855,stevenpwang,1,0.00139,58801,81.82603,71861
1856,stevepatter,1,0.00139,58802,81.82742,71861
1857,sudhakarinka,1,0.00139,58803,81.82881,71861
1858,sujanbonga-devops,1,0.00139,58804,81.83020,71861
1859,supertopher,1,0.00139,58805,81.83159,71861
1860,svenwb,1,0.00139,58806,81.83298,71861
1861,sviatsom,1,0.00139,58807,81.83437,71861
1862,szaffarano,1,0.00139,58808,81.83577,71861
1863,szferle,1,0.00139,58809,81.83716,71861
1864,taiidani,1,0.00139,58810,81.83855,71861
1865,tamilver-amzn,1,0.00139,58811,81.83994,71861
1866,tamoanxx,1,0.00139,58812,81.84133,71861
1867,tarunmallavarapu,1,0.00139,58813,81.84272,71861
1868,taylor-fis,1,0.00139,58814,81.84412,71861
1869,tcheksa62,1,0.00139,58815,81.84551,71861
1870,techtyler,1,0.00139,58816,81.84690,71861
1871,tenzin-nepallink,1,0.00139,58817,81.84829,71861
1872,terramauthe,1,0.00139,58818,81.84968,71861
1873,tewing,1,0.00139,58819,81.85107,71861
1874,TheDougJohnson,1,0.00139,58820,81.85247,71861
1875,therapy-lf,1,0.00139,58821,81.85386,71861
1876,ThiagoMartinsdeMelo,1,0.00139,58822,81.85525,71861
1877,thomascraig,1,0.00139,58823,81.85664,71861
1878,thomas-desforges,1,0.00139,58824,81.85803,71861
1879,thomaslorreyte,1,0.00139,58825,81.85942,71861
1880,thpereira2020,1,0.00139,58826,81.86081,71861
1881,thpham,1,0.00139,58827,81.86221,71861
1882,timhirsh,1,0.00139,58828,81.86360,71861
1883,tjarjoura,1,0.00139,58829,81.86499,71861
1884,tjtaill,1,0.00139,58830,81.86638,71861
1885,tkwy-rick,1,0.00139,58831,81.86777,71861
1886,tlkamp,1,0.00139,58832,81.86916,71861
1887,tomellis91,1,0.00139,58833,81.87056,71861
1888,toreilly718,1,0.00139,58834,81.87195,71861
1889,tothger,1,0.00139,58835,81.87334,71861
1890,tquach,1,0.00139,58836,81.87473,71861
1891,TraGicCode,1,0.00139,58837,81.87612,71861
1892,TravisSRE,1,0.00139,58838,81.87751,71861
1893,Trillon008,1,0.00139,58839,81.87891,71861
1894,trnguyencflt,1,0.00139,58840,81.88030,71861
1895,troby,1,0.00139,58841,81.88169,71861
1896,trozborilCA,1,0.00139,58842,81.88308,71861
1897,ttk,1,0.00139,58843,81.88447,71861
1898,tvlk-bimanata,1,0.00139,58844,81.88586,71861
1899,tyler-rt,1,0.00139,58845,81.88725,71861
1900,Tyrion85,1,0.00139,58846,81.88865,71861
1901,ugurcancaykara,1,0.00139,58847,81.89004,71861
1902,umesh-sha-mali,1,0.00139,58848,81.89143,71861
1903,Unibozu,1,0.00139,58849,81.89282,71861
1904,unkls,1,0.00139,58850,81.89421,71861
1905,V1Ct0RHMz,1,0.00139,58851,81.89560,71861
1906,vaibhav-sparebank1,1,0.00139,58852,81.89700,71861
1907,ValeriiVozniuk,1,0.00139,58853,81.89839,71861
1908,varsis,1,0.00139,58854,81.89978,71861
1909,vecchp,1,0.00139,58855,81.90117,71861
1910,vestibuule,1,0.00139,58856,81.90256,71861
1911,vglen,1,0.00139,58857,81.90395,71861
1912,vikiuvb,1,0.00139,58858,81.90535,71861
1913,vimitd,1,0.00139,58859,81.90674,71861
1914,vinodkumar4b9,1,0.00139,58860,81.90813,71861
1915,vishal-pradhan-procore,1,0.00139,58861,81.90952,71861
1916,vitalifed,1,0.00139,58862,81.91091,71861
1917,vivekpara,1,0.00139,58863,81.91230,71861
1918,VladimirSt-TPE,1,0.00139,58864,81.91369,71861
1919,vl-kp,1,0.00139,58865,81.91509,71861
1920,vl-shopback,1,0.00139,58866,81.91648,71861
1921,voidlily,1,0.00139,58867,81.91787,71861
1922,vquie,1,0.00139,58868,81.91926,71861
1923,vsawant1608,1,0.00139,58869,81.92065,71861
1924,vveliev-tc,1,0.00139,58870,81.92204,71861
1925,waylew-lexis,1,0.00139,58871,81.92344,71861
1926,weeezes,1,0.00139,58872,81.92483,71861
1927,weslleycamilo,1,0.00139,58873,81.92622,71861
1928,widogg,1,0.00139,58874,81.92761,71861
1929,winiz,1,0.00139,58875,81.92900,71861
1930,wobo-mattmencel,1,0.00139,58876,81.93039,71861
1931,worawatwi,1,0.00139,58877,81.93178,71861
1932,wosc,1,0.00139,58878,81.93318,71861
1933,WSmonkey,1,0.00139,58879,81.93457,71861
1934,wsromek,1,0.00139,58880,81.93596,71861
1935,wwahlstedt,1,0.00139,58881,81.93735,71861
1936,wyrie,1,0.00139,58882,81.93874,71861
1937,xerhab,1,0.00139,58883,81.94013,71861
1938,xmclark,1,0.00139,58884,81.94153,71861
1939,xxwassyxx,1,0.00139,58885,81.94292,71861
1940,yaeba,1,0.00139,58886,81.94431,71861
1941,yasinlachiny,1,0.00139,58887,81.94570,71861
1942,yevhenvolchenko,1,0.00139,58888,81.94709,71861
1943,yohannafrans,1,0.00139,58889,81.94848,71861
1944,Youngboss657,1,0.00139,58890,81.94988,71861
1945,yradsmikham,1,0.00139,58891,81.95127,71861
1946,yratush,1,0.00139,58892,81.95266,71861
1947,yuankunzhang,1,0.00139,58893,81.95405,71861
1948,zbialik,1,0.00139,58894,81.95544,71861
1949,zerodayyy,1,0.00139,58895,81.95683,71861
1950,zhangsj,1,0.00139,58896,81.95822,71861
1951,zsoltion,1,0.00139,58897,81.95962,71861
1952,zwolfinger,1,0.00139,58898,81.96101,71861
