rank_number,actor,contributions,percent,cumulative_sum,cumulative_percent,all_contributions
1,csatib02,3928,16.41729,3928,16.41729,23926
2,ramizpolic,3563,14.89175,7491,31.30904,23926
3,akijakya,3172,13.25754,10663,44.56658,23926
4,tanmay-pnaik,196,0.81919,10859,45.38577,23926
5,gowthamsubbu,65,0.27167,10924,45.65744,23926
6,Rasek91,59,0.24659,10983,45.90404,23926
7,TomaszKlosinski,46,0.19226,11029,46.09630,23926
8,sparqueur,42,0.17554,11071,46.27184,23926
9,lgecse,34,0.14210,11105,46.41394,23926
10,wazery,32,0.13375,11137,46.54769,23926
11,moskitone,28,0.11703,11165,46.66472,23926
12,weberjn,26,0.10867,11191,46.77338,23926
13,szymonpk,25,0.10449,11216,46.87787,23926
14,gw0,24,0.10031,11240,46.97818,23926
15,dfengshi,21,0.08777,11261,47.06595,23926
16,sanderma,21,0.08777,11282,47.15372,23926
17,ichasco-heytrade,18,0.07523,11300,47.22896,23926
18,TanZng,18,0.07523,11318,47.30419,23926
19,nsimons,17,0.07105,11335,47.37524,23926
20,adityagu0910,16,0.06687,11351,47.44211,23926
21,chrisob,16,0.06687,11367,47.50899,23926
22,lelvisl,16,0.06687,11383,47.57586,23926
23,marcoreni,16,0.06687,11399,47.64273,23926
24,thpham,16,0.06687,11415,47.70960,23926
25,aidun,15,0.06269,11430,47.77230,23926
26,mgruener,15,0.06269,11445,47.83499,23926
27,universam1,15,0.06269,11460,47.89768,23926
28,gxpd-jjh,14,0.05851,11474,47.95620,23926
29,Kasama,14,0.05851,11488,48.01471,23926
30,kirilvasilev,14,0.05851,11502,48.07323,23926
31,onimsha,14,0.05851,11516,48.13174,23926
32,tim-beatson,14,0.05851,11530,48.19025,23926
33,audrey-brightloom,13,0.05433,11543,48.24459,23926
34,Elyytscha,13,0.05433,11556,48.29892,23926
35,jwitko,13,0.05433,11569,48.35326,23926
36,NeonSludge,13,0.05433,11582,48.40759,23926
37,polaroi8d,13,0.05433,11595,48.46192,23926
38,szwed,13,0.05433,11608,48.51626,23926
39,gnadaban,12,0.05015,11620,48.56641,23926
40,kschu91,12,0.05015,11632,48.61657,23926
41,laukaichung,12,0.05015,11644,48.66672,23926
42,rahmnathan,12,0.05015,11656,48.71688,23926
43,theonewolf,12,0.05015,11668,48.76703,23926
44,aravind-bluescape,11,0.04598,11679,48.81301,23926
45,BojanZelic,11,0.04598,11690,48.85898,23926
46,jkirkham-ratehub,11,0.04598,11701,48.90496,23926
47,joshdvir,11,0.04598,11712,48.95093,23926
48,sando38,11,0.04598,11723,48.99691,23926
49,squaricdot,11,0.04598,11734,49.04288,23926
50,wmene,11,0.04598,11745,49.08886,23926
51,chrism417,10,0.04180,11755,49.13065,23926
52,david-dc-chen,10,0.04180,11765,49.17245,23926
53,dhumphries-sainsburys,10,0.04180,11775,49.21424,23926
54,shidoh,10,0.04180,11785,49.25604,23926
55,akin-ozer,9,0.03762,11794,49.29366,23926
56,ameyp,9,0.03762,11803,49.33127,23926
57,AndreasSko,9,0.03762,11812,49.36889,23926
58,hydratim,9,0.03762,11821,49.40650,23926
59,jochen-schreiber,9,0.03762,11830,49.44412,23926
60,Nello-Angelo,9,0.03762,11839,49.48174,23926
61,robertgates55,9,0.03762,11848,49.51935,23926
62,rocpatel,9,0.03762,11857,49.55697,23926
63,tvarade,9,0.03762,11866,49.59458,23926
64,94DanielBrown,8,0.03344,11874,49.62802,23926
65,adamantal,8,0.03344,11882,49.66146,23926
66,andreygolev,8,0.03344,11890,49.69489,23926
67,JonTheNiceGuy,8,0.03344,11898,49.72833,23926
68,pbriet,8,0.03344,11906,49.76177,23926
69,tabossert,8,0.03344,11914,49.79520,23926
70,tczekajlo,8,0.03344,11922,49.82864,23926
71,VFourneau,8,0.03344,11930,49.86207,23926
72,yaroslavkasatikov,8,0.03344,11938,49.89551,23926
73,arturkasperek,7,0.02926,11945,49.92477,23926
74,dzirg44,7,0.02926,11952,49.95402,23926
75,forsberg,7,0.02926,11959,49.98328,23926
76,ftpd,7,0.02926,11966,50.01254,23926
77,Gentoli,7,0.02926,11973,50.04180,23926
78,jamie-34254,7,0.02926,11980,50.07105,23926
79,kajov,7,0.02926,11987,50.10031,23926
80,michael-todorovic,7,0.02926,11994,50.12957,23926
81,nullck,7,0.02926,12001,50.15882,23926
82,revathyr13,7,0.02926,12008,50.18808,23926
83,rrondeau,7,0.02926,12015,50.21734,23926
84,rsafonseca,7,0.02926,12022,50.24659,23926
85,tandrup,7,0.02926,12029,50.27585,23926
86,Tolsto,7,0.02926,12036,50.30511,23926
87,BryanDollery,6,0.02508,12042,50.33018,23926
88,camaeel,6,0.02508,12048,50.35526,23926
89,comfortablynumb,6,0.02508,12054,50.38034,23926
90,cten,6,0.02508,12060,50.40542,23926
91,davidphayanouvong,6,0.02508,12066,50.43049,23926
92,dgamo,6,0.02508,12072,50.45557,23926
93,farhan-pasha,6,0.02508,12078,50.48065,23926
94,ikraemer-dd,6,0.02508,12084,50.50573,23926
95,jonwtech,6,0.02508,12090,50.53080,23926
96,jpuskar,6,0.02508,12096,50.55588,23926
97,Masber,6,0.02508,12102,50.58096,23926
98,mii-syahid,6,0.02508,12108,50.60604,23926
99,mikeyGlitz,6,0.02508,12114,50.63111,23926
100,naemono,6,0.02508,12120,50.65619,23926
101,paigr,6,0.02508,12126,50.68127,23926
102,rkoosaar,6,0.02508,12132,50.70634,23926
103,ron1,6,0.02508,12138,50.73142,23926
104,viniciusgarcia-hotmart,6,0.02508,12144,50.75650,23926
105,alexey-ban,5,0.02090,12149,50.77740,23926
106,anthonyhaussman,5,0.02090,12154,50.79829,23926
107,ashemedai,5,0.02090,12159,50.81919,23926
108,boekkooi-fresh,5,0.02090,12164,50.84009,23926
109,caiofralmeida,5,0.02090,12169,50.86099,23926
110,dhileepbalaji,5,0.02090,12174,50.88189,23926
111,erikbergsten,5,0.02090,12179,50.90278,23926
112,fakeNews-jpg,5,0.02090,12184,50.92368,23926
113,fran-wl,5,0.02090,12189,50.94458,23926
114,Goose29,5,0.02090,12194,50.96548,23926
115,hulucc,5,0.02090,12199,50.98637,23926
116,jcooley,5,0.02090,12204,51.00727,23926
117,jinjie-unity,5,0.02090,12209,51.02817,23926
118,johnny990,5,0.02090,12214,51.04907,23926
119,josueCarvajal,5,0.02090,12219,51.06997,23926
120,kirillplis,5,0.02090,12224,51.09086,23926
121,lagunary,5,0.02090,12229,51.11176,23926
122,Lord-Y,5,0.02090,12234,51.13266,23926
123,Lucaber,5,0.02090,12239,51.15356,23926
124,malachiobadeyi,5,0.02090,12244,51.17445,23926
125,maratsal,5,0.02090,12249,51.19535,23926
126,Moon1706,5,0.02090,12254,51.21625,23926
127,mooncube,5,0.02090,12259,51.23715,23926
128,phootip,5,0.02090,12264,51.25805,23926
129,Reversaidx,5,0.02090,12269,51.27894,23926
130,rmullinnix461332,5,0.02090,12274,51.29984,23926
131,robertdudusbjss,5,0.02090,12279,51.32074,23926
132,ryandbump,5,0.02090,12284,51.34164,23926
133,sedadas,5,0.02090,12289,51.36253,23926
134,spanarek,5,0.02090,12294,51.38343,23926
135,stokkie90,5,0.02090,12299,51.40433,23926
136,timbuchwaldt,5,0.02090,12304,51.42523,23926
137,ananth-racherla,4,0.01672,12308,51.44195,23926
138,ats0stv,4,0.01672,12312,51.45866,23926
139,bradfordwagner,4,0.01672,12316,51.47538,23926
140,bramaq,4,0.01672,12320,51.49210,23926
141,cjcos1903,4,0.01672,12324,51.50882,23926
142,cl0udguru,4,0.01672,12328,51.52554,23926
143,cpoule23,4,0.01672,12332,51.54226,23926
144,dtkachenko,4,0.01672,12336,51.55897,23926
145,eisjcormier,4,0.01672,12340,51.57569,23926
146,fdpeiter,4,0.01672,12344,51.59241,23926
147,ficofer,4,0.01672,12348,51.60913,23926
148,flozzone,4,0.01672,12352,51.62585,23926
149,geastman3,4,0.01672,12356,51.64256,23926
150,gkid,4,0.01672,12360,51.65928,23926
151,GoingFast,4,0.01672,12364,51.67600,23926
152,joseph-kimberley,4,0.01672,12368,51.69272,23926
153,jozuenoon,4,0.01672,12372,51.70944,23926
154,kannamr,4,0.01672,12376,51.72616,23926
155,kumarBiplab1987,4,0.01672,12380,51.74287,23926
156,misanche,4,0.01672,12384,51.75959,23926
157,philband,4,0.01672,12388,51.77631,23926
158,priyanka-gupta-appd,4,0.01672,12392,51.79303,23926
159,ramonberrutti,4,0.01672,12396,51.80975,23926
160,reshproy,4,0.01672,12400,51.82646,23926
161,shaileshlaghane,4,0.01672,12404,51.84318,23926
162,shash81,4,0.01672,12408,51.85990,23926
163,sid8489,4,0.01672,12412,51.87662,23926
164,signinred,4,0.01672,12416,51.89334,23926
165,sosoriov,4,0.01672,12420,51.91006,23926
166,suhastm19,4,0.01672,12424,51.92677,23926
167,tiferrei,4,0.01672,12428,51.94349,23926
168,tkatrichenko,4,0.01672,12432,51.96021,23926
169,viktorradnai,4,0.01672,12436,51.97693,23926
170,z1nkum,4,0.01672,12440,51.99365,23926
171,Ais8Ooz8,3,0.01254,12443,52.00619,23926
172,akhileshbhople,3,0.01254,12446,52.01872,23926
173,aleksandrovpa,3,0.01254,12449,52.03126,23926
174,amilanoski,3,0.01254,12452,52.04380,23926
175,andresgarcia29,3,0.01254,12455,52.05634,23926
176,benjamink,3,0.01254,12458,52.06888,23926
177,bkaznowski,3,0.01254,12461,52.08142,23926
178,brewneaux,3,0.01254,12464,52.09396,23926
179,bruhsb,3,0.01254,12467,52.10650,23926
180,carn1x,3,0.01254,12470,52.11903,23926
181,cdgz,3,0.01254,12473,52.13157,23926
182,cjibendra19,3,0.01254,12476,52.14411,23926
183,colin014,3,0.01254,12479,52.15665,23926
184,Dbzman,3,0.01254,12482,52.16919,23926
185,DewaldV,3,0.01254,12485,52.18173,23926
186,dingxiangfei2009,3,0.01254,12488,52.19427,23926
187,dm91,3,0.01254,12491,52.20680,23926
188,dyvol777,3,0.01254,12494,52.21934,23926
189,efimenko-dmi,3,0.01254,12497,52.23188,23926
190,elFarto,3,0.01254,12500,52.24442,23926
191,Epiclemonaid,3,0.01254,12503,52.25696,23926
192,forselli-stratio,3,0.01254,12506,52.26950,23926
193,fvosburgh,3,0.01254,12509,52.28204,23926
194,gitdr,3,0.01254,12512,52.29457,23926
195,idgenchev,3,0.01254,12515,52.30711,23926
196,inesterenko,3,0.01254,12518,52.31965,23926
197,javdet,3,0.01254,12521,52.33219,23926
198,jayasuryakumar-dh,3,0.01254,12524,52.34473,23926
199,jobcespedes,3,0.01254,12527,52.35727,23926
200,Johnch9,3,0.01254,12530,52.36981,23926
201,johnwoo247,3,0.01254,12533,52.38235,23926
202,jordanjean,3,0.01254,12536,52.39488,23926
203,jordan-next,3,0.01254,12539,52.40742,23926
204,Kannabir,3,0.01254,12542,52.41996,23926
205,KnudFrandsen,3,0.01254,12545,52.43250,23926
206,kratisto,3,0.01254,12548,52.44504,23926
207,LuciferInLove,3,0.01254,12551,52.45758,23926
208,LuckySB,3,0.01254,12554,52.47012,23926
209,majimenez-stratio,3,0.01254,12557,52.48265,23926
210,marcusianlevine,3,0.01254,12560,52.49519,23926
211,mark64,3,0.01254,12563,52.50773,23926
212,martinkubrak,3,0.01254,12566,52.52027,23926
213,mkroman,3,0.01254,12569,52.53281,23926
214,mykolakobzar,3,0.01254,12572,52.54535,23926
215,Ninja-mann,3,0.01254,12575,52.55789,23926
216,nippip,3,0.01254,12578,52.57043,23926
217,NitriKx,3,0.01254,12581,52.58296,23926
218,nwp,3,0.01254,12584,52.59550,23926
219,prog76,3,0.01254,12587,52.60804,23926
220,rfvmonteiro,3,0.01254,12590,52.62058,23926
221,shanehughes1990,3,0.01254,12593,52.63312,23926
222,suchitsancheti,3,0.01254,12596,52.64566,23926
223,Tearix,3,0.01254,12599,52.65820,23926
224,timduhenchanter,3,0.01254,12602,52.67073,23926
225,tnguyencota,3,0.01254,12605,52.68327,23926
226,tomhjp,3,0.01254,12608,52.69581,23926
227,trombonax,3,0.01254,12611,52.70835,23926
228,ut0mt8,3,0.01254,12614,52.72089,23926
229,virtyaluk,3,0.01254,12617,52.73343,23926
230,wstarzak,3,0.01254,12620,52.74597,23926
231,aaron-grewell,2,0.00836,12622,52.75433,23926
232,adamtagscherer,2,0.00836,12624,52.76268,23926
233,agringeri,2,0.00836,12626,52.77104,23926
234,allthecode0,2,0.00836,12628,52.77940,23926
235,ALX-TH,2,0.00836,12630,52.78776,23926
236,amirkhonov,2,0.00836,12632,52.79612,23926
237,andre-lx,2,0.00836,12634,52.80448,23926
238,andrewnicolalde,2,0.00836,12636,52.81284,23926
239,andriihrachov,2,0.00836,12638,52.82120,23926
240,AniGarikipati,2,0.00836,12640,52.82956,23926
241,arjen-s,2,0.00836,12642,52.83792,23926
242,arminbuerkle,2,0.00836,12644,52.84628,23926
243,arpad-csepi,2,0.00836,12646,52.85464,23926
244,bakakas,2,0.00836,12648,52.86299,23926
245,bipeens,2,0.00836,12650,52.87135,23926
246,blazed,2,0.00836,12652,52.87971,23926
247,Born2Bake,2,0.00836,12654,52.88807,23926
248,bumarcell,2,0.00836,12656,52.89643,23926
249,chris1786,2,0.00836,12658,52.90479,23926
250,chrlwrd,2,0.00836,12660,52.91315,23926
251,containerpope,2,0.00836,12662,52.92151,23926
252,czenker,2,0.00836,12664,52.92987,23926
253,dakine1111,2,0.00836,12666,52.93823,23926
254,december1981,2,0.00836,12668,52.94659,23926
255,dhpizza,2,0.00836,12670,52.95494,23926
256,digitaljedi2,2,0.00836,12672,52.96330,23926
257,doggvalera,2,0.00836,12674,52.97166,23926
258,DrummyFloyd,2,0.00836,12676,52.98002,23926
259,dwgillies-bluescape,2,0.00836,12678,52.98838,23926
260,ebdekock,2,0.00836,12680,52.99674,23926
261,e-desouza,2,0.00836,12682,53.00510,23926
262,evafp90,2,0.00836,12684,53.01346,23926
263,EvertonSA,2,0.00836,12686,53.02182,23926
264,f84anton,2,0.00836,12688,53.03018,23926
265,fdmota,2,0.00836,12690,53.03854,23926
266,gaineryns,2,0.00836,12692,53.04689,23926
267,gbuirel,2,0.00836,12694,53.05525,23926
268,GlorifiedTypist,2,0.00836,12696,53.06361,23926
269,gris-gris,2,0.00836,12698,53.07197,23926
270,guillaumedossantos,2,0.00836,12700,53.08033,23926
271,gvych,2,0.00836,12702,53.08869,23926
272,hanitn,2,0.00836,12704,53.09705,23926
273,Hejwo,2,0.00836,12706,53.10541,23926
274,hhh-zest,2,0.00836,12708,53.11377,23926
275,isca0,2,0.00836,12710,53.12213,23926
276,jb-elos,2,0.00836,12712,53.13049,23926
277,jespada,2,0.00836,12714,53.13884,23926
278,jgrabenstein,2,0.00836,12716,53.14720,23926
279,JohnHoward9,2,0.00836,12718,53.15556,23926
280,johnny-burak,2,0.00836,12720,53.16392,23926
281,josephmcasey,2,0.00836,12722,53.17228,23926
282,jrab66,2,0.00836,12724,53.18064,23926
283,kanadaj,2,0.00836,12726,53.18900,23926
284,kazaff,2,0.00836,12728,53.19736,23926
285,kflautner,2,0.00836,12730,53.20572,23926
286,kingdruid,2,0.00836,12732,53.21408,23926
287,klibr007,2,0.00836,12734,53.22244,23926
288,kodachimaru,2,0.00836,12736,53.23079,23926
289,Kriys94,2,0.00836,12738,53.23915,23926
290,leosayous21,2,0.00836,12740,53.24751,23926
291,Lesss1,2,0.00836,12742,53.25587,23926
292,maaft,2,0.00836,12744,53.26423,23926
293,madianas21,2,0.00836,12746,53.27259,23926
294,ManfredLiuSolera,2,0.00836,12748,53.28095,23926
295,manik9910,2,0.00836,12750,53.28931,23926
296,maresac,2,0.00836,12752,53.29767,23926
297,mehmetcodes,2,0.00836,12754,53.30603,23926
298,Mel-Github,2,0.00836,12756,53.31439,23926
299,MightySCollins,2,0.00836,12758,53.32275,23926
300,mkoukal,2,0.00836,12760,53.33110,23926
301,mkryva,2,0.00836,12762,53.33946,23926
302,mohithg,2,0.00836,12764,53.34782,23926
303,mtavaresmedeiros,2,0.00836,12766,53.35618,23926
304,nate-kennedy,2,0.00836,12768,53.36454,23926
305,Nexus2k,2,0.00836,12770,53.37290,23926
306,notdodo,2,0.00836,12772,53.38126,23926
307,obsessionsys,2,0.00836,12774,53.38962,23926
308,omriarieli,2,0.00836,12776,53.39798,23926
309,Oriolemon,2,0.00836,12778,53.40634,23926
310,osnagovskyi,2,0.00836,12780,53.41470,23926
311,paivin-dn,2,0.00836,12782,53.42305,23926
312,pashafirdous,2,0.00836,12784,53.43141,23926
313,patrickdappollonio,2,0.00836,12786,53.43977,23926
314,pheianox,2,0.00836,12788,53.44813,23926
315,Pibotasnus,2,0.00836,12790,53.45649,23926
316,polycaster,2,0.00836,12792,53.46485,23926
317,Poweranimal,2,0.00836,12794,53.47321,23926
318,rejoshed,2,0.00836,12796,53.48157,23926
319,Renz2018,2,0.00836,12798,53.48993,23926
320,richardfan1126,2,0.00836,12800,53.49829,23926
321,rllzyy,2,0.00836,12802,53.50665,23926
322,russellseymour,2,0.00836,12804,53.51500,23926
323,saiDevkar,2,0.00836,12806,53.52336,23926
324,saitama-dh,2,0.00836,12808,53.53172,23926
325,Sandy1438,2,0.00836,12810,53.54008,23926
326,satoshinakamotoblockchain1,2,0.00836,12812,53.54844,23926
327,shebanian,2,0.00836,12814,53.55680,23926
328,shubhamrajvanshi,2,0.00836,12816,53.56516,23926
329,sigurdblueface,2,0.00836,12818,53.57352,23926
330,SvenMark,2,0.00836,12820,53.58188,23926
331,Tatskaari,2,0.00836,12822,53.59024,23926
332,testmad,2,0.00836,12824,53.59860,23926
333,vikneshgs,2,0.00836,12826,53.60695,23926
334,vperi1730,2,0.00836,12828,53.61531,23926
335,wadexu007,2,0.00836,12830,53.62367,23926
336,weldrake13,2,0.00836,12832,53.63203,23926
337,win-t,2,0.00836,12834,53.64039,23926
338,wmgroot,2,0.00836,12836,53.64875,23926
339,Z3r0Sum,2,0.00836,12838,53.65711,23926
340,9digitdev,1,0.00418,12839,53.66129,23926
341,abdiali9617,1,0.00418,12840,53.66547,23926
342,adamdrozdz,1,0.00418,12841,53.66965,23926
343,adrieng1977,1,0.00418,12842,53.67383,23926
344,ahmed-kadri,1,0.00418,12843,53.67801,23926
345,ahmed-kadri-tt,1,0.00418,12844,53.68219,23926
346,alainknaebel,1,0.00418,12845,53.68637,23926
347,alearon,1,0.00418,12846,53.69055,23926
348,alekskar,1,0.00418,12847,53.69473,23926
349,alex-vmw,1,0.00418,12848,53.69890,23926
350,alwaysastudent,1,0.00418,12849,53.70308,23926
351,amit-o,1,0.00418,12850,53.70726,23926
352,amnk,1,0.00418,12851,53.71144,23926
353,andrii88-ku,1,0.00418,12852,53.71562,23926
354,anhbt1005,1,0.00418,12853,53.71980,23926
355,Antykor,1,0.00418,12854,53.72398,23926
356,ap-vishal,1,0.00418,12855,53.72816,23926
357,aquisx,1,0.00418,12856,53.73234,23926
358,arumer,1,0.00418,12857,53.73652,23926
359,ashwinrajadurai3,1,0.00418,12858,53.74070,23926
360,avinashbhashyam-rs,1,0.00418,12859,53.74488,23926
361,awilliams-bb,1,0.00418,12860,53.74906,23926
362,azizkarimovv,1,0.00418,12861,53.75324,23926
363,bakuppus,1,0.00418,12862,53.75742,23926
364,balazsbc,1,0.00418,12863,53.76160,23926
365,bazzilio,1,0.00418,12864,53.76578,23926
366,bcarlock-mycarrier,1,0.00418,12865,53.76996,23926
367,benedikt-bartscher,1,0.00418,12866,53.77414,23926
368,borisputerka,1,0.00418,12867,53.77832,23926
369,BrandonS05,1,0.00418,12868,53.78250,23926
370,callaertanthony,1,0.00418,12869,53.78668,23926
371,cenk1cenk2,1,0.00418,12870,53.79086,23926
372,Centro1993,1,0.00418,12871,53.79503,23926
373,chap-dr,1,0.00418,12872,53.79921,23926
374,chopanovv,1,0.00418,12873,53.80339,23926
375,chrisfw,1,0.00418,12874,53.80757,23926
376,danielmikor,1,0.00418,12875,53.81175,23926
377,dawidek88,1,0.00418,12876,53.81593,23926
378,deepaksinghkhetwal,1,0.00418,12877,53.82011,23926
379,defesteban,1,0.00418,12878,53.82429,23926
380,Denissa89,1,0.00418,12879,53.82847,23926
381,dervoeti,1,0.00418,12880,53.83265,23926
382,dintel,1,0.00418,12881,53.83683,23926
383,djerfy,1,0.00418,12882,53.84101,23926
384,dk89,1,0.00418,12883,53.84519,23926
385,dlarrison,1,0.00418,12884,53.84937,23926
386,dminninger-devk,1,0.00418,12885,53.85355,23926
387,DmitriyEsin,1,0.00418,12886,53.85773,23926
388,douglaswth,1,0.00418,12887,53.86191,23926
389,dudicoco,1,0.00418,12888,53.86609,23926
390,Dylan2010,1,0.00418,12889,53.87027,23926
391,dystewart,1,0.00418,12890,53.87445,23926
392,eduardmak,1,0.00418,12891,53.87863,23926
393,enggalilioo,1,0.00418,12892,53.88281,23926
394,fabianobianchi,1,0.00418,12893,53.88698,23926
395,fiksm,1,0.00418,12894,53.89116,23926
396,gaborho,1,0.00418,12895,53.89534,23926
397,gespinoza22,1,0.00418,12896,53.89952,23926
398,granadacoder,1,0.00418,12897,53.90370,23926
399,gregor-rieble,1,0.00418,12898,53.90788,23926
400,gtranchant-decathlon,1,0.00418,12899,53.91206,23926
401,guirgouveia,1,0.00418,12900,53.91624,23926
402,horjulf,1,0.00418,12901,53.92042,23926
403,icereed,1,0.00418,12902,53.92460,23926
404,ilyache,1,0.00418,12903,53.92878,23926
405,ishanjain28,1,0.00418,12904,53.93296,23926
406,itmwiw,1,0.00418,12905,53.93714,23926
407,ivan046,1,0.00418,12906,53.94132,23926
408,jacohend,1,0.00418,12907,53.94550,23926
409,jansobczak,1,0.00418,12908,53.94968,23926
410,jazzy-r,1,0.00418,12909,53.95386,23926
411,jcarter1738,1,0.00418,12910,53.95804,23926
412,jkevlin,1,0.00418,12911,53.96222,23926
413,jmartin127,1,0.00418,12912,53.96640,23926
414,jobbunko,1,0.00418,12913,53.97058,23926
415,jobbunko002,1,0.00418,12914,53.97476,23926
416,Joffref,1,0.00418,12915,53.97894,23926
417,jon-rei,1,0.00418,12916,53.98311,23926
418,JoseFMP,1,0.00418,12917,53.98729,23926
419,Jpnock,1,0.00418,12918,53.99147,23926
420,jsnouffer,1,0.00418,12919,53.99565,23926
421,jtmilan,1,0.00418,12920,53.99983,23926
422,Jude188,1,0.00418,12921,54.00401,23926
423,karnphongkie,1,0.00418,12922,54.00819,23926
424,Kaswob,1,0.00418,12923,54.01237,23926
425,Katnopic,1,0.00418,12924,54.01655,23926
426,koteswara-kelam,1,0.00418,12925,54.02073,23926
427,koukshi,1,0.00418,12926,54.02491,23926
428,ksemele,1,0.00418,12927,54.02909,23926
429,l4z41,1,0.00418,12928,54.03327,23926
430,leonaascimento,1,0.00418,12929,54.03745,23926
431,liuqi-sun,1,0.00418,12930,54.04163,23926
432,longnbao,1,0.00418,12931,54.04581,23926
433,lundsec,1,0.00418,12932,54.04999,23926
434,lwille,1,0.00418,12933,54.05417,23926
435,Mais316,1,0.00418,12934,54.05835,23926
436,makrelas,1,0.00418,12935,54.06253,23926
437,malcolm061990,1,0.00418,12936,54.06671,23926
438,malyousof,1,0.00418,12937,54.07089,23926
439,maratsh,1,0.00418,12938,54.07506,23926
440,marcencov,1,0.00418,12939,54.07924,23926
441,matrix-root,1,0.00418,12940,54.08342,23926
442,messi-gao,1,0.00418,12941,54.08760,23926
443,mikeluttikhuis,1,0.00418,12942,54.09178,23926
444,mikhae1,1,0.00418,12943,54.09596,23926
445,Minivolk02,1,0.00418,12944,54.10014,23926
446,mkostelcev,1,0.00418,12945,54.10432,23926
447,mrala,1,0.00418,12946,54.10850,23926
448,mrsrvman,1,0.00418,12947,54.11268,23926
449,msg-gregor,1,0.00418,12948,54.11686,23926
450,mslagle,1,0.00418,12949,54.12104,23926
451,muspelheim,1,0.00418,12950,54.12522,23926
452,mustdiechik,1,0.00418,12951,54.12940,23926
453,MXfive,1,0.00418,12952,54.13358,23926
454,nate-ribelin,1,0.00418,12953,54.13776,23926
455,nayanen,1,0.00418,12954,54.14194,23926
456,naydoo,1,0.00418,12955,54.14612,23926
457,nirlevywalkme,1,0.00418,12956,54.15030,23926
458,nomatterz,1,0.00418,12957,54.15448,23926
459,oche-jay,1,0.00418,12958,54.15866,23926
460,oksanakalyuzhenko,1,0.00418,12959,54.16284,23926
461,olga-salesloft,1,0.00418,12960,54.16701,23926
462,pabardina,1,0.00418,12961,54.17119,23926
463,PaulLol,1,0.00418,12962,54.17537,23926
464,paul-yolabs,1,0.00418,12963,54.17955,23926
465,pcjun97,1,0.00418,12964,54.18373,23926
466,pzim,1,0.00418,12965,54.18791,23926
467,raffis,1,0.00418,12966,54.19209,23926
468,rexbut,1,0.00418,12967,54.19627,23926
469,rgaoistheone,1,0.00418,12968,54.20045,23926
470,ripx80,1,0.00418,12969,54.20463,23926
471,rodosskiand,1,0.00418,12970,54.20881,23926
472,ronballesteros,1,0.00418,12971,54.21299,23926
473,RSE132,1,0.00418,12972,54.21717,23926
474,ruuda,1,0.00418,12973,54.22135,23926
475,ryousry,1,0.00418,12974,54.22553,23926
476,RyuunoAelia,1,0.00418,12975,54.22971,23926
477,samedguener,1,0.00418,12976,54.23389,23926
478,sanvlog,1,0.00418,12977,54.23807,23926
479,sdevang,1,0.00418,12978,54.24225,23926
480,selmison,1,0.00418,12979,54.24643,23926
481,skhedim,1,0.00418,12980,54.25061,23926
482,slumbi,1,0.00418,12981,54.25479,23926
483,smarimus,1,0.00418,12982,54.25897,23926
484,smoorsausje,1,0.00418,12983,54.26314,23926
485,som-priani-maersk,1,0.00418,12984,54.26732,23926
486,sopriani,1,0.00418,12985,54.27150,23926
487,spbkelt,1,0.00418,12986,54.27568,23926
488,stephenwolfe1,1,0.00418,12987,54.27986,23926
489,suneclausen,1,0.00418,12988,54.28404,23926
490,supernomad,1,0.00418,12989,54.28822,23926
491,supratim-persistent,1,0.00418,12990,54.29240,23926
492,TomAdmz,1,0.00418,12991,54.29658,23926
493,ttreptow,1,0.00418,12992,54.30076,23926
494,Twinki14,1,0.00418,12993,54.30494,23926
495,ujoergen,1,0.00418,12994,54.30912,23926
496,underdark456,1,0.00418,12995,54.31330,23926
497,victor-tsykanov,1,0.00418,12996,54.31748,23926
498,vishnu-anil,1,0.00418,12997,54.32166,23926
499,weichuliu,1,0.00418,12998,54.32584,23926
500,willhaines,1,0.00418,12999,54.33002,23926
501,xavier007bb,1,0.00418,13000,54.33420,23926
502,Yalafeg,1,0.00418,13001,54.33838,23926
503,yelhouti,1,0.00418,13002,54.34256,23926
504,Yvonne2017,1,0.00418,13003,54.34674,23926
505,ziedbouf,1,0.00418,13004,54.35092,23926
506,zsmartin,1,0.00418,13005,54.35509,23926
