rank_number,actor,contributions,percent,cumulative_sum,cumulative_percent,all_contributions
1,liggitt,74859,1.73645,74859,1.73645,4311040
2,thockin,50121,1.16262,124980,2.89907,4311040
3,sftim,48305,1.12050,173285,4.01956,4311040
4,BenTheElder,45151,1.04733,218436,5.06690,4311040
5,wojtek-t,42574,0.98756,261010,6.05446,4311040
6,tengqm,39736,0.92173,300746,6.97618,4311040
7,dims,38250,0.88726,338996,7.86344,4311040
8,lavalamp,35814,0.83075,374810,8.69419,4311040
9,neolit123,34487,0.79997,409297,9.49416,4311040
10,smarterclayton,32664,0.75768,441961,10.25184,4311040
11,aojea,32360,0.75063,474321,11.00247,4311040
12,andyzhangx,31598,0.73296,505919,11.73543,4311040
13,sbueringer,31170,0.72303,537089,12.45846,4311040
14,alculquicondor,27784,0.64448,564873,13.10294,4311040
15,bgrant0607,26610,0.61725,591483,13.72019,4311040
16,msau42,26543,0.61570,618026,14.33589,4311040
17,brendandburns,26130,0.60612,644156,14.94201,4311040
18,justinsb,25637,0.59468,669793,15.53669,4311040
19,pohly,22516,0.52229,692309,16.05898,4311040
20,spiffxp,22347,0.51837,714656,16.57735,4311040
21,sttts,22311,0.51753,736967,17.09488,4311040
22,deads2k,22281,0.51684,759248,17.61171,4311040
23,fabriziopandini,21818,0.50610,781066,18.11781,4311040
24,aledbf,21537,0.49958,802603,18.61739,4311040
25,vincepri,21127,0.49007,823730,19.10745,4311040
26,saschagrunert,20861,0.48390,844591,19.59135,4311040
27,CecileRobertMichon,20480,0.47506,865071,20.06641,4311040
28,medyagh,19669,0.45625,884740,20.52266,4311040
29,hakman,18398,0.42676,903138,20.94942,4311040
30,fejta,17844,0.41391,920982,21.36334,4311040
31,mikedanese,17044,0.39536,938026,21.75869,4311040
32,justaugustus,16754,0.38863,954780,22.14732,4311040
33,krzyzacy,16694,0.38724,971474,22.53456,4311040
34,ixdy,16462,0.38186,987936,22.91642,4311040
35,cpanato,16166,0.37499,1004102,23.29141,4311040
36,caesarxuchao,15338,0.35578,1019440,23.64719,4311040
37,feiskyer,15216,0.35295,1034656,24.00015,4311040
38,derekwaynecarr,14675,0.34041,1049331,24.34055,4311040
39,apelisse,14251,0.33057,1063582,24.67112,4311040
40,jsafrane,14107,0.32723,1077689,24.99835,4311040
41,yujuhong,14088,0.32679,1091777,25.32514,4311040
42,xing-yang,14001,0.32477,1105778,25.64991,4311040
43,luxas,13759,0.31916,1119537,25.96907,4311040
44,camilamacedo86,13559,0.31452,1133096,26.28359,4311040
45,Huang-Wei,13496,0.31306,1146592,26.59664,4311040
46,robscott,13264,0.30768,1159856,26.90432,4311040
47,andrewsykim,13225,0.30677,1173081,27.21109,4311040
48,nikhita,13144,0.30489,1186225,27.51598,4311040
49,ahg-g,13133,0.30464,1199358,27.82062,4311040
50,ncdc,12954,0.30048,1212312,28.12110,4311040
51,cblecker,12552,0.29116,1224864,28.41226,4311040
52,pwittrock,12298,0.28527,1237162,28.69753,4311040
53,Random-Liu,12211,0.28325,1249373,28.98078,4311040
54,pacoxu,12197,0.28292,1261570,29.26370,4311040
55,pmorie,12155,0.28195,1273725,29.54565,4311040
56,tstromberg,12064,0.27984,1285789,29.82549,4311040
57,kargakis,12031,0.27907,1297820,30.10457,4311040
58,soltysh,11909,0.27624,1309729,30.38081,4311040
59,chrislovecnm,11659,0.27045,1321388,30.65126,4311040
60,dchen1107,11476,0.26620,1332864,30.91746,4311040
61,stevekuznetsov,11018,0.25558,1343882,31.17303,4311040
62,spowelljr,10926,0.25344,1354808,31.42648,4311040
63,detiber,10891,0.25263,1365699,31.67911,4311040
64,vishh,10854,0.25177,1376553,31.93088,4311040
65,kbhawkey,10618,0.24630,1387171,32.17718,4311040
66,erictune,10529,0.24423,1397700,32.42141,4311040
67,gmarek,10365,0.24043,1408065,32.66184,4311040
68,johngmyers,10148,0.23540,1418213,32.89724,4311040
69,mwielgus,9964,0.23113,1428177,33.12836,4311040
70,saad-ali,9821,0.22781,1437998,33.35617,4311040
71,davidopp,9739,0.22591,1447737,33.58208,4311040
72,DirectXMan12,9510,0.22060,1457247,33.80268,4311040
73,ahmetb,9496,0.22027,1466743,34.02295,4311040
74,bprashanth,9469,0.21965,1476212,34.24260,4311040
75,SergeyKanzhelev,9430,0.21874,1485642,34.46134,4311040
76,killianmuldoon,9370,0.21735,1495012,34.67869,4311040
77,timothysc,9300,0.21573,1504312,34.89441,4311040
78,roberthbailey,9219,0.21385,1513531,35.10826,4311040
79,alvaroaleman,9205,0.21352,1522736,35.32178,4311040
80,cjwagner,9166,0.21262,1531902,35.53440,4311040
81,marquiz,9009,0.20898,1540911,35.74337,4311040
82,afbjorklund,8944,0.20747,1549855,35.95084,4311040
83,bowei,8916,0.20682,1558771,36.15766,4311040
84,spxtr,8881,0.20601,1567652,36.36366,4311040
85,mrbobbytables,8865,0.20563,1576517,36.56930,4311040
86,jpbetz,8788,0.20385,1585305,36.77315,4311040
87,maciaszczykm,8760,0.20320,1594065,36.97634,4311040
88,olemarkus,8703,0.20188,1602768,37.17822,4311040
89,wongma7,8617,0.19988,1611385,37.37810,4311040
90,mrunalp,8604,0.19958,1619989,37.57768,4311040
91,gnufied,8594,0.19935,1628583,37.77703,4311040
92,jichenjc,8542,0.19814,1637125,37.97518,4311040
93,nikhiljindal,8460,0.19624,1645585,38.17142,4311040
94,MikeSpreitzer,8444,0.19587,1654029,38.36728,4311040
95,rikatz,8362,0.19397,1662391,38.56125,4311040
96,serathius,8304,0.19262,1670695,38.75387,4311040
97,zmerlynn,8301,0.19255,1678996,38.94643,4311040
98,jayunit100,8286,0.19220,1687282,39.13863,4311040
99,monopole,8236,0.19104,1695518,39.32967,4311040
100,oomichi,8081,0.18745,1703599,39.51712,4311040
101,ameukam,7965,0.18476,1711564,39.70188,4311040
102,tallclair,7847,0.18202,1719411,39.88390,4311040
103,rifelpet,7795,0.18081,1727206,40.06472,4311040
104,jingxu97,7780,0.18047,1734986,40.24518,4311040
105,floreks,7698,0.17856,1742684,40.42375,4311040
106,chenopis,7691,0.17840,1750375,40.60215,4311040
107,k82cn,7637,0.17715,1758012,40.77930,4311040
108,piosz,7629,0.17696,1765641,40.95627,4311040
109,divyenpatel,7462,0.17309,1773103,41.12936,4311040
110,shyamjvs,7453,0.17288,1780556,41.30224,4311040
111,mimowo,7425,0.17223,1787981,41.47447,4311040
112,janetkuo,7369,0.17093,1795350,41.64540,4311040
113,dashpole,7260,0.16840,1802610,41.81381,4311040
114,jsturtevant,7260,0.16840,1809870,41.98221,4311040
115,MrHohn,7143,0.16569,1817013,42.14790,4311040
116,aramase,7094,0.16455,1824107,42.31246,4311040
117,yue9944882,7053,0.16360,1831160,42.47606,4311040
118,ehashman,7014,0.16270,1838174,42.63876,4311040
119,randomvariable,6893,0.15989,1845067,42.79865,4311040
120,quinton-hoole,6888,0.15978,1851955,42.95843,4311040
121,sanposhiho,6862,0.15917,1858817,43.11760,4311040
122,bryk,6673,0.15479,1865490,43.27239,4311040
123,marosset,6644,0.15412,1872134,43.42650,4311040
124,kerthcet,6642,0.15407,1878776,43.58057,4311040
125,eparis,6533,0.15154,1885309,43.73212,4311040
126,tedyu,6489,0.15052,1891798,43.88264,4311040
127,danwinship,6475,0.15020,1898273,44.03283,4311040
128,chaodaiG,6465,0.14996,1904738,44.18280,4311040
129,xiangpengzhao,6448,0.14957,1911186,44.33237,4311040
130,jackfrancis,6427,0.14908,1917613,44.48145,4311040
131,windsonsea,6237,0.14468,1923850,44.62612,4311040
132,zacharysarah,6204,0.14391,1930054,44.77003,4311040
133,wzshiming,6199,0.14379,1936253,44.91383,4311040
134,xmudrii,5986,0.13885,1942239,45.05268,4311040
135,cheftako,5979,0.13869,1948218,45.19137,4311040
136,mboersma,5977,0.13864,1954195,45.33001,4311040
137,runcom,5902,0.13690,1960097,45.46692,4311040
138,bart0sh,5871,0.13619,1965968,45.60310,4311040
139,mkumatag,5830,0.13523,1971798,45.73834,4311040
140,ingvagabund,5743,0.13322,1977541,45.87155,4311040
141,SataQiu,5717,0.13261,1983258,46.00417,4311040
142,mtaufen,5705,0.13233,1988963,46.13650,4311040
143,roycaihw,5699,0.13220,1994662,46.26870,4311040
144,MartinForReal,5697,0.13215,2000359,46.40085,4311040
145,jbeda,5654,0.13115,2006013,46.53200,4311040
146,humblec,5512,0.12786,2011525,46.65985,4311040
147,enj,5475,0.12700,2017000,46.78685,4311040
148,chuckha,5426,0.12586,2022426,46.91272,4311040
149,longwuyuan,5297,0.12287,2027723,47.03559,4311040
150,kannon92,5252,0.12183,2032975,47.15741,4311040
151,richardcase,5245,0.12166,2038220,47.27908,4311040
152,mbohlool,5233,0.12139,2043453,47.40046,4311040
153,adrianludwin,5200,0.12062,2048653,47.52109,4311040
154,seokho-son,5092,0.11812,2053745,47.63920,4311040
155,palnabarun,5082,0.11788,2058827,47.75708,4311040
156,natasha41575,5052,0.11719,2063879,47.87427,4311040
157,tenzen-y,5035,0.11679,2068914,47.99106,4311040
158,chendave,5030,0.11668,2073944,48.10774,4311040
159,chrischdi,5030,0.11668,2078974,48.22442,4311040
160,davidz627,5026,0.11658,2084000,48.34100,4311040
161,floryut,4985,0.11563,2088985,48.45664,4311040
162,rhatdan,4967,0.11522,2093952,48.57185,4311040
163,marun,4963,0.11512,2098915,48.68698,4311040
164,sharifelgamal,4956,0.11496,2103871,48.80194,4311040
165,lzhecheng,4953,0.11489,2108824,48.91683,4311040
166,steveperry-53,4942,0.11464,2113766,49.03146,4311040
167,Ankitasw,4940,0.11459,2118706,49.14605,4311040
168,starpit,4936,0.11450,2123642,49.26055,4311040
169,listx,4913,0.11396,2128555,49.37451,4311040
170,freehan,4910,0.11389,2133465,49.48841,4311040
171,cici37,4877,0.11313,2138342,49.60153,4311040
172,dlorenc,4795,0.11123,2143137,49.71276,4311040
173,fedebongio,4790,0.11111,2147927,49.82387,4311040
174,sedefsavas,4769,0.11062,2152696,49.93449,4311040
175,nilo19,4737,0.10988,2157433,50.04437,4311040
176,mengqiy,4690,0.10879,2162123,50.15316,4311040
177,logicalhan,4664,0.10819,2166787,50.26135,4311040
178,seans3,4552,0.10559,2171339,50.36694,4311040
179,damemi,4542,0.10536,2175881,50.47230,4311040
180,MHBauer,4528,0.10503,2180409,50.57733,4311040
181,MaciekPytel,4491,0.10417,2184900,50.68151,4311040
182,resouer,4445,0.10311,2189345,50.78461,4311040
183,bsalamat,4397,0.10199,2193742,50.88661,4311040
184,M00nF1sh,4370,0.10137,2198112,50.98798,4311040
185,chethanv28,4339,0.10065,2202451,51.08862,4311040
186,mattymo,4288,0.09947,2206739,51.18809,4311040
187,yangjunmyfm192085,4222,0.09793,2210961,51.28602,4311040
188,jlowdermilk,4183,0.09703,2215144,51.38305,4311040
189,mumoshu,4163,0.09657,2219307,51.47962,4311040
190,satnam6502,4149,0.09624,2223456,51.57586,4311040
191,rmmh,4143,0.09610,2227599,51.67196,4311040
192,puerco,4142,0.09608,2231741,51.76804,4311040
193,yastij,4139,0.09601,2235880,51.86405,4311040
194,madhusudancs,4112,0.09538,2239992,51.95943,4311040
195,alexzielenski,4085,0.09476,2244077,52.05419,4311040
196,ArangoGutierrez,4081,0.09466,2248158,52.14886,4311040
197,mm4tt,4039,0.09369,2252197,52.24254,4311040
198,rootfs,3998,0.09274,2256195,52.33528,4311040
199,dgrisonnet,3978,0.09227,2260173,52.42756,4311040
200,divya-mohan0209,3966,0.09200,2264139,52.51955,4311040
201,m1093782566,3906,0.09060,2268045,52.61016,4311040
202,tanjunchen,3904,0.09056,2271949,52.70072,4311040
203,kishorj,3899,0.09044,2275848,52.79116,4311040
204,dixudx,3897,0.09040,2279745,52.88156,4311040
205,Liujingfang1,3852,0.08935,2283597,52.97091,4311040
206,xichengliudui,3832,0.08889,2287429,53.05980,4311040
207,brancz,3812,0.08842,2291241,53.14822,4311040
208,timstclair,3801,0.08817,2295042,53.23639,4311040
209,shu-mutou,3774,0.08754,2298816,53.32393,4311040
210,matthyx,3770,0.08745,2302586,53.41138,4311040
211,jihoon-seo,3749,0.08696,2306335,53.49834,4311040
212,reylejano,3731,0.08655,2310066,53.58489,4311040
213,r2d4,3723,0.08636,2313789,53.67125,4311040
214,hzxuzhonghu,3720,0.08629,2317509,53.75754,4311040
215,zetaab,3642,0.08448,2321151,53.84202,4311040
216,yifan-gu,3637,0.08436,2324788,53.92638,4311040
217,gyliu513,3624,0.08406,2328412,54.01045,4311040
218,krzysied,3623,0.08404,2332035,54.09449,4311040
219,mborsz,3616,0.08388,2335651,54.17837,4311040
220,yliaog,3616,0.08388,2339267,54.26224,4311040
221,saikat-royc,3603,0.08358,2342870,54.34582,4311040
222,vmarmol,3601,0.08353,2346471,54.42935,4311040
223,klueska,3576,0.08295,2350047,54.51230,4311040
224,krousey,3540,0.08211,2353587,54.59441,4311040
225,KnVerey,3534,0.08198,2357121,54.67639,4311040
226,Jefftree,3526,0.08179,2360647,54.75818,4311040
227,bobbypage,3488,0.08091,2364135,54.83909,4311040
228,ykakarap,3483,0.08079,2367618,54.91988,4311040
229,mengjiao-liu,3452,0.08007,2371070,54.99995,4311040
230,nojnhuh,3434,0.07966,2374504,55.07961,4311040
231,cdrage,3402,0.07891,2377906,55.15852,4311040
232,inductor,3378,0.07836,2381284,55.23688,4311040
233,Adirio,3377,0.07833,2384661,55.31521,4311040
234,cofyc,3329,0.07722,2387990,55.39243,4311040
235,prameshj,3290,0.07632,2391280,55.46875,4311040
236,irfanurrehman,3262,0.07567,2394542,55.54442,4311040
237,Arhell,3252,0.07543,2397794,55.61985,4311040
238,shaneutt,3228,0.07488,2401022,55.69473,4311040
239,tpepper,3228,0.07488,2404250,55.76961,4311040
240,a-robinson,3225,0.07481,2407475,55.84441,4311040
241,RA489,3209,0.07444,2410684,55.91885,4311040
242,ihmccreery,3188,0.07395,2413872,55.99280,4311040
243,srm09,3184,0.07386,2417056,56.06666,4311040
244,pjhwa,3171,0.07356,2420227,56.14021,4311040
245,ravisantoshgudimetla,3160,0.07330,2423387,56.21351,4311040
246,bskiba,3152,0.07311,2426539,56.28663,4311040
247,leakingtapan,3138,0.07279,2429677,56.35942,4311040
248,jberkus,3137,0.07277,2432814,56.43218,4311040
249,duglin,3130,0.07260,2435944,56.50479,4311040
250,foxish,3108,0.07209,2439052,56.57688,4311040
251,nckturner,3096,0.07182,2442148,56.64870,4311040
252,denkensk,3089,0.07165,2445237,56.72035,4311040
253,ramineni,3079,0.07142,2448316,56.79177,4311040
254,Sea-n,3065,0.07110,2451381,56.86287,4311040
255,mdbooth,3059,0.07096,2454440,56.93383,4311040
256,akutz,3054,0.07084,2457494,57.00467,4311040
257,ericchiang,3034,0.07038,2460528,57.07504,4311040
258,rramkumar1,2987,0.06929,2463515,57.14433,4311040
259,johnbelamaric,2962,0.06871,2466477,57.21304,4311040
260,nasa9084,2946,0.06834,2469423,57.28138,4311040
261,tkashem,2925,0.06785,2472348,57.34922,4311040
262,seanmalloy,2902,0.06732,2475250,57.41654,4311040
263,Jont828,2886,0.06694,2478136,57.48348,4311040
264,fromanirh,2873,0.06664,2481009,57.55013,4311040
265,hasheddan,2870,0.06657,2483879,57.61670,4311040
266,andyxning,2847,0.06604,2486726,57.68274,4311040
267,MadhavJivrajani,2844,0.06597,2489570,57.74871,4311040
268,codenrhoden,2840,0.06588,2492410,57.81459,4311040
269,jiahuif,2812,0.06523,2495222,57.87982,4311040
270,p0lyn0mial,2808,0.06514,2498030,57.94495,4311040
271,hbagdi,2798,0.06490,2500828,58.00985,4311040
272,krmayankk,2796,0.06486,2503624,58.07471,4311040
273,tao12345666333,2788,0.06467,2506412,58.13938,4311040
274,swetharepakula,2770,0.06425,2509182,58.20364,4311040
275,mauriciopoppe,2742,0.06360,2511924,58.26724,4311040
276,lingxiankong,2738,0.06351,2514662,58.33075,4311040
277,RaunakShah,2735,0.06344,2517397,58.39419,4311040
278,cmluciano,2732,0.06337,2520129,58.45756,4311040
279,fgrzadkowski,2731,0.06335,2522860,58.52091,4311040
280,howieyuen,2713,0.06293,2525573,58.58385,4311040
281,priyawadhwa,2695,0.06251,2528268,58.64636,4311040
282,shashidharatd,2665,0.06182,2530933,58.70818,4311040
283,CaoShuFeng,2654,0.06156,2533587,58.76974,4311040
284,corneliusweig,2653,0.06154,2536240,58.83128,4311040
285,markturansky,2653,0.06154,2538893,58.89282,4311040
286,woopstar,2634,0.06110,2541527,58.95392,4311040
287,jszczepkowski,2633,0.06108,2544160,59.01499,4311040
288,karlkfi,2631,0.06103,2546791,59.07602,4311040
289,devigned,2619,0.06075,2549410,59.13677,4311040
290,ElvinEfendi,2618,0.06073,2552028,59.19750,4311040
291,nicksardo,2608,0.06050,2554636,59.25800,4311040
292,strongjz,2607,0.06047,2557243,59.31847,4311040
293,adisky,2562,0.05943,2559805,59.37790,4311040
294,xiang90,2559,0.05936,2562364,59.43726,4311040
295,vladimirvivien,2549,0.05913,2564913,59.49639,4311040
296,mikebrow,2547,0.05908,2567460,59.55547,4311040
297,idvoretskyi,2537,0.05885,2569997,59.61432,4311040
298,mortent,2530,0.05869,2572527,59.67300,4311040
299,Skarlso,2529,0.05866,2575056,59.73167,4311040
300,crimsonfaith91,2525,0.05857,2577581,59.79024,4311040
301,Raffo,2523,0.05852,2580104,59.84876,4311040
302,aleksandra-malinowska,2521,0.05848,2582625,59.90724,4311040
303,youngnick,2518,0.05841,2585143,59.96565,4311040
304,Miouge1,2511,0.05825,2587654,60.02389,4311040
305,carlory,2507,0.05815,2590161,60.08205,4311040
306,enisoc,2502,0.05804,2592663,60.14008,4311040
307,trasc,2492,0.05781,2595155,60.19789,4311040
308,arschles,2481,0.05755,2597636,60.25544,4311040
309,verult,2480,0.05753,2600116,60.31296,4311040
310,uablrek,2478,0.05748,2602594,60.37044,4311040
311,zhangxiaoyu-zidif,2451,0.05685,2605045,60.42730,4311040
312,stormqueen1990,2448,0.05678,2607493,60.48408,4311040
313,nader-ziada,2442,0.05665,2609935,60.54073,4311040
314,hongchaodeng,2422,0.05618,2612357,60.59691,4311040
315,errordeveloper,2417,0.05607,2614774,60.65297,4311040
316,jeffvance,2402,0.05572,2617176,60.70869,4311040
317,jimangel,2379,0.05518,2619555,60.76388,4311040
318,enxebre,2377,0.05514,2621932,60.81901,4311040
319,aveshagarwal,2368,0.05493,2624300,60.87394,4311040
320,chenrui333,2364,0.05484,2626664,60.92878,4311040
321,swatisehgal,2358,0.05470,2629022,60.98347,4311040
322,droot,2351,0.05453,2631373,61.03801,4311040
323,cjcullen,2350,0.05451,2633723,61.09252,4311040
324,atoato88,2338,0.05423,2636061,61.14675,4311040
325,x13n,2329,0.05402,2638390,61.20078,4311040
326,dipesh-rawat,2320,0.05382,2640710,61.25459,4311040
327,claudiubelu,2319,0.05379,2643029,61.30838,4311040
328,jdef,2316,0.05372,2645345,61.36211,4311040
329,christopherhein,2311,0.05361,2647656,61.41571,4311040
330,howardjohn,2310,0.05358,2649966,61.46930,4311040
331,jimmidyson,2302,0.05340,2652268,61.52270,4311040
332,mikesplain,2290,0.05312,2654558,61.57581,4311040
333,Shubham82,2289,0.05310,2656847,61.62891,4311040
334,brianpursley,2288,0.05307,2659135,61.68198,4311040
335,khenidak,2288,0.05307,2661423,61.73506,4311040
336,ialidzhikov,2281,0.05291,2663704,61.78797,4311040
337,crassirostris,2271,0.05268,2665975,61.84065,4311040
338,ddysher,2262,0.05247,2668237,61.89312,4311040
339,draveness,2259,0.05240,2670496,61.94552,4311040
340,philips,2253,0.05226,2672749,61.99778,4311040
341,david-mcmahon,2252,0.05224,2675001,62.05002,4311040
342,alejandrox1,2250,0.05219,2677251,62.10221,4311040
343,furkatgofurov7,2247,0.05212,2679498,62.15433,4311040
344,estroz,2217,0.05143,2681715,62.20576,4311040
345,ArtfulCoder,2214,0.05136,2683929,62.25711,4311040
346,haircommander,2181,0.05059,2686110,62.30770,4311040
347,rphillips,2181,0.05059,2688291,62.35829,4311040
348,tg123,2181,0.05059,2690472,62.40889,4311040
349,edreed,2179,0.05054,2692651,62.45943,4311040
350,mattjmcnaughton,2169,0.05031,2694820,62.50974,4311040
351,alexeldeib,2156,0.05001,2696976,62.55975,4311040
352,chewong,2148,0.04983,2699124,62.60958,4311040
353,amwat,2142,0.04969,2701266,62.65927,4311040
354,jennybuckley,2141,0.04966,2703407,62.70893,4311040
355,dcbw,2135,0.04952,2705542,62.75845,4311040
356,danehans,2126,0.04932,2707668,62.80777,4311040
357,ddebroy,2114,0.04904,2709782,62.85680,4311040
358,mml,2111,0.04897,2711893,62.90577,4311040
359,tariq1890,2110,0.04894,2714003,62.95472,4311040
360,johndmulhausen,2095,0.04860,2716098,63.00331,4311040
361,RainbowMango,2087,0.04841,2718185,63.05172,4311040
362,devin-donnelly,2086,0.04839,2720271,63.10011,4311040
363,Katharine,2086,0.04839,2722357,63.14850,4311040
364,ardaguclu,2079,0.04823,2724436,63.19672,4311040
365,harshanarayana,2076,0.04816,2726512,63.24488,4311040
366,parispittman,2073,0.04809,2728585,63.29296,4311040
367,Prajyot-Parab,2071,0.04804,2730656,63.34100,4311040
368,ffromani,2062,0.04783,2732718,63.38883,4311040
369,gjkim42,2049,0.04753,2734767,63.43636,4311040
370,girikuncoro,2043,0.04739,2736810,63.48375,4311040
371,yiqigao217,2042,0.04737,2738852,63.53112,4311040
372,gochist,2033,0.04716,2740885,63.57828,4311040
373,cristicalin,2028,0.04704,2742913,63.62532,4311040
374,wfernandes,2023,0.04693,2744936,63.67225,4311040
375,qbarrand,2021,0.04688,2746957,63.71913,4311040
376,kikisdeliveryservice,2019,0.04683,2748976,63.76596,4311040
377,NickrenREN,2019,0.04683,2750995,63.81279,4311040
378,shalini-b,1997,0.04632,2752992,63.85912,4311040
379,upodroid,1991,0.04618,2754983,63.90530,4311040
380,elmiko,1988,0.04611,2756971,63.95141,4311040
381,aaronlevy,1981,0.04595,2758952,63.99736,4311040
382,ant31,1974,0.04579,2760926,64.04315,4311040
383,SandeepPissay,1967,0.04563,2762893,64.08878,4311040
384,verb,1967,0.04563,2764860,64.13441,4311040
385,jeremyrickard,1966,0.04560,2766826,64.18001,4311040
386,mrueg,1963,0.04553,2768789,64.22555,4311040
387,irvifa,1946,0.04514,2770735,64.27069,4311040
388,jbartosik,1944,0.04509,2772679,64.31578,4311040
389,losipiuk,1936,0.04491,2774615,64.36069,4311040
390,aaron-prindle,1932,0.04482,2776547,64.40550,4311040
391,linki,1926,0.04468,2778473,64.45018,4311040
392,my-git9,1925,0.04465,2780398,64.49483,4311040
393,knabben,1918,0.04449,2782316,64.53932,4311040
394,JoelSpeed,1911,0.04433,2784227,64.58365,4311040
395,grodrigues3,1910,0.04430,2786137,64.62796,4311040
396,AdoHe,1902,0.04412,2788039,64.67207,4311040
397,AdamDang,1898,0.04403,2789937,64.71610,4311040
398,Jiawei0227,1896,0.04398,2791833,64.76008,4311040
399,juanvallejo,1889,0.04382,2793722,64.80390,4311040
400,oke-py,1887,0.04377,2795609,64.84767,4311040
401,dlipovetsky,1876,0.04352,2797485,64.89119,4311040
402,ybettan,1874,0.04347,2799359,64.93466,4311040
403,Bradamant3,1861,0.04317,2801220,64.97782,4311040
404,kow3ns,1859,0.04312,2803079,65.02095,4311040
405,rata,1858,0.04310,2804937,65.06404,4311040
406,zouyee,1830,0.04245,2806767,65.10649,4311040
407,eddiezane,1827,0.04238,2808594,65.14887,4311040
408,njuettner,1823,0.04229,2810417,65.19116,4311040
409,calebamiles,1819,0.04219,2812236,65.23335,4311040
410,ritazh,1819,0.04219,2814055,65.27555,4311040
411,invidian,1793,0.04159,2815848,65.31714,4311040
412,php-coder,1793,0.04159,2817641,65.35873,4311040
413,filbranden,1790,0.04152,2819431,65.40025,4311040
414,leiyiz,1784,0.04138,2821215,65.44163,4311040
415,Shell32-Natsu,1782,0.04134,2822997,65.48297,4311040
416,danielvegamyhre,1776,0.04120,2824773,65.52417,4311040
417,droslean,1775,0.04117,2826548,65.56534,4311040
418,ash2k,1773,0.04113,2828321,65.60647,4311040
419,vinaykul,1769,0.04103,2830090,65.64750,4311040
420,wgliang,1767,0.04099,2831857,65.68849,4311040
421,caseydavenport,1764,0.04092,2833621,65.72941,4311040
422,jdumars,1754,0.04069,2835375,65.77009,4311040
423,fabianofranz,1753,0.04066,2837128,65.81076,4311040
424,mbforbes,1738,0.04032,2838866,65.85107,4311040
425,castrojo,1734,0.04022,2840600,65.89129,4311040
426,cwdsuzhou,1731,0.04015,2842331,65.93145,4311040
427,shysank,1725,0.04001,2844056,65.97146,4311040
428,shannonxtreme,1715,0.03978,2845771,66.01124,4311040
429,perotinus,1714,0.03976,2847485,66.05100,4311040
430,Riaankl,1708,0.03962,2849193,66.09062,4311040
431,jeefy,1705,0.03955,2850898,66.13017,4311040
432,heckj,1697,0.03936,2852595,66.16953,4311040
433,kris-nova,1695,0.03932,2854290,66.20885,4311040
434,pires,1690,0.03920,2855980,66.24805,4311040
435,ydFu,1684,0.03906,2857664,66.28711,4311040
436,torredil,1670,0.03874,2859334,66.32585,4311040
437,kundan2707,1669,0.03871,2861003,66.36457,4311040
438,rosti,1666,0.03864,2862669,66.40321,4311040
439,markthink,1665,0.03862,2864334,66.44183,4311040
440,stevehipwell,1656,0.03841,2865990,66.48025,4311040
441,wlan0,1655,0.03839,2867645,66.51864,4311040
442,jessfraz,1654,0.03837,2869299,66.55700,4311040
443,celestehorgan,1638,0.03800,2870937,66.59500,4311040
444,hidekazuna,1638,0.03800,2872575,66.63299,4311040
445,gjtempleton,1633,0.03788,2874208,66.67087,4311040
446,anubha-v-ardhan,1630,0.03781,2875838,66.70868,4311040
447,idealhack,1628,0.03776,2877466,66.74645,4311040
448,sjenning,1616,0.03749,2879082,66.78393,4311040
449,yankay,1603,0.03718,2880685,66.82112,4311040
450,knight42,1601,0.03714,2882286,66.85825,4311040
451,Priyankasaggu11929,1596,0.03702,2883882,66.89527,4311040
452,kfox1111,1595,0.03700,2885477,66.93227,4311040
453,adtac,1587,0.03681,2887064,66.96908,4311040
454,carolynvs,1585,0.03677,2888649,67.00585,4311040
455,ConnorDoyle,1585,0.03677,2890234,67.04262,4311040
456,colemickens,1583,0.03672,2891817,67.07934,4311040
457,jpeach,1573,0.03649,2893390,67.11582,4311040
458,bertinatto,1561,0.03621,2894951,67.15203,4311040
459,euank,1558,0.03614,2896509,67.18817,4311040
460,AkihiroSuda,1557,0.03612,2898066,67.22429,4311040
461,fredkan,1545,0.03584,2899611,67.26013,4311040
462,kayrus,1544,0.03582,2901155,67.29594,4311040
463,petr-muller,1540,0.03572,2902695,67.33166,4311040
464,stewart-yu,1536,0.03563,2904231,67.36729,4311040
465,cheld,1535,0.03561,2905766,67.40290,4311040
466,JAORMX,1531,0.03551,2907297,67.43841,4311040
467,yguo0905,1530,0.03549,2908827,67.47390,4311040
468,tosi3k,1526,0.03540,2910353,67.50930,4311040
469,benmoss,1521,0.03528,2911874,67.54458,4311040
470,pjbgf,1505,0.03491,2913379,67.57949,4311040
471,mkimuram,1504,0.03489,2914883,67.61438,4311040
472,RenaudWasTaken,1503,0.03486,2916386,67.64924,4311040
473,pipejakob,1502,0.03484,2917888,67.68409,4311040
474,jiayingz,1495,0.03468,2919383,67.71876,4311040
475,nilebox,1493,0.03463,2920876,67.75340,4311040
476,klaases,1492,0.03461,2922368,67.78800,4311040
477,zshihang,1492,0.03461,2923860,67.82261,4311040
478,odinuge,1491,0.03459,2925351,67.85720,4311040
479,munnerz,1486,0.03447,2926837,67.89167,4311040
480,zjj2wry,1485,0.03445,2928322,67.92612,4311040
481,ConnorJC3,1482,0.03438,2929804,67.96049,4311040
482,astoycos,1481,0.03435,2931285,67.99485,4311040
483,hoegaarden,1478,0.03428,2932763,68.02913,4311040
484,vinayakankugoyal,1470,0.03410,2934233,68.06323,4311040
485,annajung,1459,0.03384,2935692,68.09707,4311040
486,PatrickLang,1457,0.03380,2937149,68.13087,4311040
487,a7i,1438,0.03336,2938587,68.16422,4311040
488,awly,1435,0.03329,2940022,68.19751,4311040
489,riverzhang,1429,0.03315,2941451,68.23066,4311040
490,chrishenzie,1428,0.03312,2942879,68.26378,4311040
491,hangyan,1424,0.03303,2944303,68.29681,4311040
492,jkh52,1423,0.03301,2945726,68.32982,4311040
493,bogdando,1420,0.03294,2947146,68.36276,4311040
494,harche,1419,0.03292,2948565,68.39568,4311040
495,alex-mohr,1408,0.03266,2949973,68.42834,4311040
496,mfojtik,1407,0.03264,2951380,68.46097,4311040
497,davidmccormick,1406,0.03261,2952786,68.49359,4311040
498,jprzychodzen,1405,0.03259,2954191,68.52618,4311040
499,Jeffwan,1403,0.03254,2955594,68.55872,4311040
500,lichuqiang,1400,0.03247,2956994,68.59120,4311040
501,sbezverk,1399,0.03245,2958393,68.62365,4311040
502,coderanger,1396,0.03238,2959789,68.65603,4311040
503,jaredbhatti,1384,0.03210,2961173,68.68814,4311040
504,marseel,1384,0.03210,2962557,68.72024,4311040
505,bradtopol,1381,0.03203,2963938,68.75227,4311040
506,endocrimes,1370,0.03178,2965308,68.78405,4311040
507,jhrozek,1369,0.03176,2966677,68.81581,4311040
508,misterikkit,1365,0.03166,2968042,68.84747,4311040
509,raelga,1358,0.03150,2969400,68.87897,4311040
510,AishSundar,1356,0.03145,2970756,68.91043,4311040
511,annasong20,1351,0.03134,2972107,68.94176,4311040
512,dulek,1350,0.03131,2973457,68.97308,4311040
513,nilekhc,1348,0.03127,2974805,69.00435,4311040
514,oxddr,1344,0.03118,2976149,69.03552,4311040
515,szuecs,1344,0.03118,2977493,69.06670,4311040
516,JanetKuo,1339,0.03106,2978832,69.09776,4311040
517,champtar,1338,0.03104,2980170,69.12879,4311040
518,pjh,1335,0.03097,2981505,69.15976,4311040
519,umohnani8,1335,0.03097,2982840,69.19073,4311040
520,kevindelgado,1334,0.03094,2984174,69.22167,4311040
521,michelle192837,1324,0.03071,2985498,69.25238,4311040
522,panslava,1318,0.03057,2986816,69.28296,4311040
523,PushkarJ,1315,0.03050,2988131,69.31346,4311040
524,shiywang,1310,0.03039,2989441,69.34385,4311040
525,guineveresaenger,1308,0.03034,2990749,69.37419,4311040
526,jkaniuk,1301,0.03018,2992050,69.40437,4311040
527,Kartik494,1301,0.03018,2993351,69.43454,4311040
528,WanLinghao,1300,0.03016,2994651,69.46470,4311040
529,Fei-Guo,1294,0.03002,2995945,69.49472,4311040
530,BaluDontu,1285,0.02981,2997230,69.52452,4311040
531,249043822,1269,0.02944,2998499,69.55396,4311040
532,BobyMCbobs,1269,0.02944,2999768,69.58340,4311040
533,Lion-Wei,1269,0.02944,3001037,69.61283,4311040
534,vikaschoudhary16,1249,0.02897,3002286,69.64180,4311040
535,lentzi90,1241,0.02879,3003527,69.67059,4311040
536,electrocucaracha,1240,0.02876,3004767,69.69935,4311040
537,gavinfish,1239,0.02874,3006006,69.72809,4311040
538,cezarygerard,1233,0.02860,3007239,69.75669,4311040
539,cynepco3hahue,1232,0.02858,3008471,69.78527,4311040
540,spencerhance,1230,0.02853,3009701,69.81380,4311040
541,dvonthenen,1224,0.02839,3010925,69.84220,4311040
542,ggriffiths,1224,0.02839,3012149,69.87059,4311040
543,porridge,1224,0.02839,3013373,69.89898,4311040
544,jianglingxia,1223,0.02837,3014596,69.92735,4311040
545,hh,1218,0.02825,3015814,69.95560,4311040
546,stmcginnis,1211,0.02809,3017025,69.98369,4311040
547,savitharaghunathan,1208,0.02802,3018233,70.01171,4311040
548,nate-double-u,1195,0.02772,3019428,70.03943,4311040
549,ymqytw,1193,0.02767,3020621,70.06711,4311040
550,yuanchen8911,1191,0.02763,3021812,70.09473,4311040
551,mistyhacks,1163,0.02698,3022975,70.12171,4311040
552,brahmaroutu,1157,0.02684,3024132,70.14855,4311040
553,markyjackson-taulia,1155,0.02679,3025287,70.17534,4311040
554,mqliang,1154,0.02677,3026441,70.20211,4311040
555,kkeshavamurthy,1153,0.02675,3027594,70.22885,4311040
556,jberkhahn,1148,0.02663,3028742,70.25548,4311040
557,ironcladlou,1144,0.02654,3029886,70.28202,4311040
558,sonasingh46,1141,0.02647,3031027,70.30849,4311040
559,DangerOnTheRanger,1139,0.02642,3032166,70.33491,4311040
560,MushuEE,1136,0.02635,3033302,70.36126,4311040
561,seh,1135,0.02633,3034437,70.38759,4311040
562,fabioy,1134,0.02630,3035571,70.41389,4311040
563,redbaron,1134,0.02630,3036705,70.44020,4311040
564,chases2,1133,0.02628,3037838,70.46648,4311040
565,lpabon,1131,0.02623,3038969,70.49271,4311040
566,frapposelli,1127,0.02614,3040096,70.51885,4311040
567,lilic,1126,0.02612,3041222,70.54497,4311040
568,kawych,1125,0.02610,3042347,70.57107,4311040
569,wackxu,1122,0.02603,3043469,70.59709,4311040
570,surajssd,1116,0.02589,3044585,70.62298,4311040
571,ilya-zuyev,1112,0.02579,3045697,70.64878,4311040
572,leilajal,1109,0.02572,3046806,70.67450,4311040
573,jamiehannaford,1106,0.02566,3047912,70.70016,4311040
574,wking,1106,0.02566,3049018,70.72581,4311040
575,dougsland,1103,0.02559,3050121,70.75140,4311040
576,bigkraig,1098,0.02547,3051219,70.77687,4311040
577,jonathan-innis,1094,0.02538,3052313,70.80224,4311040
578,mowangdk,1092,0.02533,3053405,70.82757,4311040
579,jmyung,1091,0.02531,3054496,70.85288,4311040
580,jwtty,1087,0.02521,3055583,70.87809,4311040
581,micahhausler,1087,0.02521,3056670,70.90331,4311040
582,tam7t,1085,0.02517,3057755,70.92848,4311040
583,ramrodo,1084,0.02514,3058839,70.95362,4311040
584,ideahitme,1081,0.02508,3059920,70.97870,4311040
585,Fedosin,1078,0.02501,3060998,71.00370,4311040
586,Atoms,1077,0.02498,3062075,71.02868,4311040
587,kad,1075,0.02494,3063150,71.05362,4311040
588,Ritikaa96,1073,0.02489,3064223,71.07851,4311040
589,hwdef,1071,0.02484,3065294,71.10335,4311040
590,yuzhiquan,1071,0.02484,3066365,71.12820,4311040
591,lubronzhan,1068,0.02477,3067433,71.15297,4311040
592,PiotrProkop,1068,0.02477,3068501,71.17774,4311040
593,kelseyhightower,1060,0.02459,3069561,71.20233,4311040
594,krancour,1059,0.02456,3070620,71.22690,4311040
595,michmike,1057,0.02452,3071677,71.25141,4311040
596,kwiesmueller,1053,0.02443,3072730,71.27584,4311040
597,bclau,1050,0.02436,3073780,71.30020,4311040
598,giuseppe,1050,0.02436,3074830,71.32455,4311040
599,ClaudiaJKang,1047,0.02429,3075877,71.34884,4311040
600,rjsadow,1047,0.02429,3076924,71.37313,4311040
601,ZeroMagic,1047,0.02429,3077971,71.39741,4311040
602,ghodss,1042,0.02417,3079013,71.42158,4311040
603,tobiasgiese,1039,0.02410,3080052,71.44568,4311040
604,vaibhav2107,1038,0.02408,3081090,71.46976,4311040
605,yuwenma,1036,0.02403,3082126,71.49379,4311040
606,antoineco,1035,0.02401,3083161,71.51780,4311040
607,ashish-amarnath,1035,0.02401,3084196,71.54181,4311040
608,FengyunPan,1033,0.02396,3085229,71.56577,4311040
609,yoonian,1030,0.02389,3086259,71.58966,4311040
610,mtanino,1027,0.02382,3087286,71.61349,4311040
611,xilabao,1026,0.02380,3088312,71.63728,4311040
612,leonardpahlke,1025,0.02378,3089337,71.66106,4311040
613,figo,1024,0.02375,3090361,71.68481,4311040
614,dprotaso,1022,0.02371,3091383,71.70852,4311040
615,cyclinder,1018,0.02361,3092401,71.73213,4311040
616,font,1015,0.02354,3093416,71.75568,4311040
617,gongguan,1011,0.02345,3094427,71.77913,4311040
618,KashifSaadat,1006,0.02334,3095433,71.80247,4311040
619,wangzhen127,1005,0.02331,3096438,71.82578,4311040
620,lauchokyip,1003,0.02327,3097441,71.84904,4311040
621,zhouhaibing089,1000,0.02320,3098441,71.87224,4311040
622,kadel,999,0.02317,3099440,71.89541,4311040
623,yichengq,999,0.02317,3100439,71.91859,4311040
624,AhmedGrati,997,0.02313,3101436,71.94171,4311040
625,varshaprasad96,997,0.02313,3102433,71.96484,4311040
626,stp-ip,993,0.02303,3103426,71.98787,4311040
627,xunpan,990,0.02296,3104416,72.01084,4311040
628,anguslees,989,0.02294,3105405,72.03378,4311040
629,rajansandeep,988,0.02292,3106393,72.05670,4311040
630,tyuchn,988,0.02292,3107381,72.07961,4311040
631,ysyukr,984,0.02283,3108365,72.10244,4311040
632,rsmitty,982,0.02278,3109347,72.12522,4311040
633,tnozicka,980,0.02273,3110327,72.14795,4311040
634,geojaz,979,0.02271,3111306,72.17066,4311040
635,zparnold,976,0.02264,3112282,72.19330,4311040
636,LiorLieberman,973,0.02257,3113255,72.21587,4311040
637,fmuyassarov,972,0.02255,3114227,72.23842,4311040
638,mindprince,971,0.02252,3115198,72.26094,4311040
639,clarketm,967,0.02243,3116165,72.28337,4311040
640,hex108,964,0.02236,3117129,72.30573,4311040
641,Rajakavitha1,964,0.02236,3118093,72.32809,4311040
642,therc,964,0.02236,3119057,72.35045,4311040
643,cstoku,960,0.02227,3120017,72.37272,4311040
644,danielqsj,956,0.02218,3120973,72.39490,4311040
645,s-urbaniak,956,0.02218,3121929,72.41707,4311040
646,jonboulle,954,0.02213,3122883,72.43920,4311040
647,JimBugwadia,950,0.02204,3123833,72.46124,4311040
648,taotaotheripper,950,0.02204,3124783,72.48328,4311040
649,ccojocar,946,0.02194,3125729,72.50522,4311040
650,goltermann,944,0.02190,3126673,72.52712,4311040
651,joelsmith,934,0.02167,3127607,72.54878,4311040
652,adelina-t,931,0.02160,3128538,72.57038,4311040
653,kibbles-n-bytes,929,0.02155,3129467,72.59193,4311040
654,onlydole,929,0.02155,3130396,72.61348,4311040
655,hanxiaoshuai,927,0.02150,3131323,72.63498,4311040
656,koba1t,925,0.02146,3132248,72.65644,4311040
657,TravisBuddy,925,0.02146,3133173,72.67789,4311040
658,mpherman2,924,0.02143,3134097,72.69933,4311040
659,dalanlan,919,0.02132,3135016,72.72064,4311040
660,girishkalele,917,0.02127,3135933,72.74191,4311040
661,Steve53,917,0.02127,3136850,72.76318,4311040
662,tzneal,916,0.02125,3137766,72.78443,4311040
663,chrisnegus,912,0.02115,3138678,72.80559,4311040
664,gab-satchi,910,0.02111,3139588,72.82670,4311040
665,EmilienM,906,0.02102,3140494,72.84771,4311040
666,rjnagal,905,0.02099,3141399,72.86870,4311040
667,towca,904,0.02097,3142303,72.88967,4311040
668,dghubble,902,0.02092,3143205,72.91060,4311040
669,Madhan-SWE,902,0.02092,3144107,72.93152,4311040
670,NikhilSharmaWe,897,0.02081,3145004,72.95233,4311040
671,GinnyJI,896,0.02078,3145900,72.97311,4311040
672,mirwan,896,0.02078,3146796,72.99389,4311040
673,remyleone,893,0.02071,3147689,73.01461,4311040
674,wawa0210,892,0.02069,3148581,73.03530,4311040
675,xlgao-zju,885,0.02053,3149466,73.05583,4311040
676,hongkailiu,882,0.02046,3150348,73.07629,4311040
677,immutableT,881,0.02044,3151229,73.09672,4311040
678,ityuhui,881,0.02044,3152110,73.11716,4311040
679,vadasambar,881,0.02044,3152991,73.13760,4311040
680,ping035627,879,0.02039,3153870,73.15799,4311040
681,ariscahyadi,875,0.02030,3154745,73.17828,4311040
682,TomSweeneyRedHat,875,0.02030,3155620,73.19858,4311040
683,gohilankit,866,0.02009,3156486,73.21867,4311040
684,karan,862,0.02000,3157348,73.23866,4311040
685,bells17,861,0.01997,3158209,73.25863,4311040
686,phanimarupaka,861,0.01997,3159070,73.27861,4311040
687,JornShen,860,0.01995,3159930,73.29855,4311040
688,oliviassss,859,0.01993,3160789,73.31848,4311040
689,jboyd01,854,0.01981,3161643,73.33829,4311040
690,zhouya0,854,0.01981,3162497,73.35810,4311040
691,cevich,853,0.01979,3163350,73.37789,4311040
692,rjbez17,848,0.01967,3164198,73.39756,4311040
693,rrati,848,0.01967,3165046,73.41723,4311040
694,bartsmykla,846,0.01962,3165892,73.43685,4311040
695,t-inu,846,0.01962,3166738,73.45647,4311040
696,pweil-,845,0.01960,3167583,73.47608,4311040
697,kbarnard10,842,0.01953,3168425,73.49561,4311040
698,timoreimann,842,0.01953,3169267,73.51514,4311040
699,prezha,841,0.01951,3170108,73.53465,4311040
700,rolfedh,841,0.01951,3170949,73.55415,4311040
701,spzala,841,0.01951,3171790,73.57366,4311040
702,aravindhp,840,0.01948,3172630,73.59315,4311040
703,bradbeam,840,0.01948,3173470,73.61263,4311040
704,feihujiang,840,0.01948,3174310,73.63212,4311040
705,aj11anuj,838,0.01944,3175148,73.65156,4311040
706,ayberk,837,0.01942,3175985,73.67097,4311040
707,cprivitere,837,0.01942,3176822,73.69039,4311040
708,yuxiangqian,836,0.01939,3177658,73.70978,4311040
709,andyzheng0831,835,0.01937,3178493,73.72915,4311040
710,NitishKumar06,835,0.01937,3179328,73.74852,4311040
711,shuuji3,834,0.01935,3180162,73.76786,4311040
712,RomanBednar,829,0.01923,3180991,73.78709,4311040
713,tianshapjq,829,0.01923,3181820,73.80632,4311040
714,rexagod,827,0.01918,3182647,73.82550,4311040
715,bswartz,826,0.01916,3183473,73.84466,4311040
716,pydctw,824,0.01911,3184297,73.86378,4311040
717,ruiwen-zhao,822,0.01907,3185119,73.88284,4311040
718,bluefriday,820,0.01902,3185939,73.90187,4311040
719,tamalsaha,814,0.01888,3186753,73.92075,4311040
720,vaikas-google,814,0.01888,3187567,73.93963,4311040
721,chrisohaver,813,0.01886,3188380,73.95849,4311040
722,Zhuzhenghao,812,0.01884,3189192,73.97732,4311040
723,FillZpp,806,0.01870,3189998,73.99602,4311040
724,gambol99,801,0.01858,3190799,74.01460,4311040
725,liztio,798,0.01851,3191597,74.03311,4311040
726,MrErlison,797,0.01849,3192394,74.05160,4311040
727,chadswen,795,0.01844,3193189,74.07004,4311040
728,diegs,795,0.01844,3193984,74.08848,4311040
729,sunpa93,794,0.01842,3194778,74.10690,4311040
730,julianvmodesto,793,0.01839,3195571,74.12529,4311040
731,hjacobs,792,0.01837,3196363,74.14366,4311040
732,jessicaochen,791,0.01835,3197154,74.16201,4311040
733,MrFreezeex,789,0.01830,3197943,74.18031,4311040
734,marwanad,786,0.01823,3198729,74.19855,4311040
735,johnSchnake,784,0.01819,3199513,74.21673,4311040
736,shubheksha,784,0.01819,3200297,74.23492,4311040
737,vllry,783,0.01816,3201080,74.25308,4311040
738,mlavacca,782,0.01814,3201862,74.27122,4311040
739,Crassirostris,779,0.01807,3202641,74.28929,4311040
740,ahmedtd,778,0.01805,3203419,74.30734,4311040
741,bboreham,778,0.01805,3204197,74.32538,4311040
742,DanyC97,776,0.01800,3204973,74.34338,4311040
743,sdminonne,776,0.01800,3205749,74.36138,4311040
744,Atharva-Shinde,771,0.01788,3206520,74.37927,4311040
745,TommyStarK,769,0.01784,3207289,74.39711,4311040
746,jhorwit2,768,0.01781,3208057,74.41492,4311040
747,rlenferink,768,0.01781,3208825,74.43274,4311040
748,mysunshine92,767,0.01779,3209592,74.45053,4311040
749,wonderfly,765,0.01775,3210357,74.46827,4311040
750,chris-short,763,0.01770,3211120,74.48597,4311040
751,heyste,763,0.01770,3211883,74.50367,4311040
752,wilsonehusin,763,0.01770,3212646,74.52137,4311040
753,mehabhalodiya,759,0.01761,3213405,74.53897,4311040
754,ethernetdan,758,0.01758,3214163,74.55656,4311040
755,ereslibre,757,0.01756,3214920,74.57412,4311040
756,surajnarwade,757,0.01756,3215677,74.59168,4311040
757,JamesLaverack,756,0.01754,3216433,74.60921,4311040
758,eddycharly,755,0.01751,3217188,74.62673,4311040
759,Q-Lee,755,0.01751,3217943,74.64424,4311040
760,gman0,753,0.01747,3218696,74.66171,4311040
761,RichieEscarez,744,0.01726,3219440,74.67896,4311040
762,fsmunoz,743,0.01723,3220183,74.69620,4311040
763,hectorj2f,741,0.01719,3220924,74.71339,4311040
764,EppO,740,0.01717,3221664,74.73055,4311040
765,vteratipally,740,0.01717,3222404,74.74772,4311040
766,loburm,737,0.01710,3223141,74.76481,4311040
767,ianchakeres,735,0.01705,3223876,74.78186,4311040
768,chizhg,732,0.01698,3224608,74.79884,4311040
769,rsdcastro,732,0.01698,3225340,74.81582,4311040
770,andriyDev,731,0.01696,3226071,74.83278,4311040
771,mszostok,730,0.01693,3226801,74.84971,4311040
772,barney-s,729,0.01691,3227530,74.86662,4311040
773,zhuangqh,729,0.01691,3228259,74.88353,4311040
774,mskanth972,727,0.01686,3228986,74.90040,4311040
775,n3wscott,722,0.01675,3229708,74.91714,4311040
776,LochanRn,720,0.01670,3230428,74.93384,4311040
777,deepakkinni,719,0.01668,3231147,74.95052,4311040
778,kevin-wangzefeng,718,0.01665,3231865,74.96718,4311040
779,prksu,717,0.01663,3232582,74.98381,4311040
780,stealthybox,712,0.01652,3233294,75.00032,4311040
781,skmatti,711,0.01649,3234005,75.01682,4311040
782,kakts,710,0.01647,3234715,75.03329,4311040
783,pwschuurman,710,0.01647,3235425,75.04976,4311040
784,mattfenwick,708,0.01642,3236133,75.06618,4311040
785,RinkiyaKeDad,708,0.01642,3236841,75.08260,4311040
786,wanghaoran1988,708,0.01642,3237549,75.09902,4311040
787,g-gaston,707,0.01640,3238256,75.11542,4311040
788,anfernee,706,0.01638,3238962,75.13180,4311040
789,makocchi-git,706,0.01638,3239668,75.14818,4311040
790,mattfarina,706,0.01638,3240374,75.16455,4311040
791,michaelgugino,702,0.01628,3241076,75.18084,4311040
792,hurf,701,0.01626,3241777,75.19710,4311040
793,tssurya,701,0.01626,3242478,75.21336,4311040
794,bridgetkromhout,699,0.01621,3243177,75.22957,4311040
795,helayoty,699,0.01621,3243876,75.24579,4311040
796,fpetkovski,697,0.01617,3244573,75.26196,4311040
797,jeffmendoza,697,0.01617,3245270,75.27812,4311040
798,T-Lakshmi,697,0.01617,3245967,75.29429,4311040
799,shivi28,696,0.01614,3246663,75.31044,4311040
800,AverageMarcus,695,0.01612,3247358,75.32656,4311040
801,c-knowles,695,0.01612,3248053,75.34268,4311040
802,kgolab,695,0.01612,3248748,75.35880,4311040
803,yagonobre,695,0.01612,3249443,75.37492,4311040
804,kacole2,694,0.01610,3250137,75.39102,4311040
805,mzaian,694,0.01610,3250831,75.40712,4311040
806,rdrgmnzs,694,0.01610,3251525,75.42322,4311040
807,ivan4th,693,0.01608,3252218,75.43929,4311040
808,everpeace,692,0.01605,3252910,75.45534,4311040
809,Amulyam24,690,0.01601,3253600,75.47135,4311040
810,grayluck,689,0.01598,3254289,75.48733,4311040
811,guangxuli,688,0.01596,3254977,75.50329,4311040
812,chrigl,686,0.01591,3255663,75.51920,4311040
813,coffeepac,686,0.01591,3256349,75.53511,4311040
814,Pingan2017,686,0.01591,3257035,75.55103,4311040
815,mheon,685,0.01589,3257720,75.56692,4311040
816,WIZARD-CXY,685,0.01589,3258405,75.58281,4311040
817,sayantani11,684,0.01587,3259089,75.59867,4311040
818,staebler,684,0.01587,3259773,75.61454,4311040
819,Babapool,682,0.01582,3260455,75.63036,4311040
820,tnqn,682,0.01582,3261137,75.64618,4311040
821,scottilee,681,0.01580,3261818,75.66197,4311040
822,chymy,680,0.01577,3262498,75.67775,4311040
823,mlmhl,680,0.01577,3263178,75.69352,4311040
824,alexander-demichev,679,0.01575,3263857,75.70927,4311040
825,nicolehanjing,678,0.01573,3264535,75.72500,4311040
826,alexanderConstantinescu,677,0.01570,3265212,75.74070,4311040
827,MoShitrit,677,0.01570,3265889,75.75641,4311040
828,johscheuer,676,0.01568,3266565,75.77209,4311040
829,zreigz,675,0.01566,3267240,75.78774,4311040
830,Verolop,670,0.01554,3267910,75.80329,4311040
831,chakri-nelluri,669,0.01552,3268579,75.81880,4311040
832,proppy,669,0.01552,3269248,75.83432,4311040
833,cartermckinnon,665,0.01543,3269913,75.84975,4311040
834,gyuho,665,0.01543,3270578,75.86517,4311040
835,iamNoah1,661,0.01533,3271239,75.88051,4311040
836,kvaps,660,0.01531,3271899,75.89582,4311040
837,perithompson,659,0.01529,3272558,75.91110,4311040
838,tanshanshan,659,0.01529,3273217,75.92639,4311040
839,johananl,657,0.01524,3273874,75.94163,4311040
840,CatherineF-dev,656,0.01522,3274530,75.95685,4311040
841,Karthik-K-N,656,0.01522,3275186,75.97206,4311040
842,wenjiaswe,656,0.01522,3275842,75.98728,4311040
843,yanxuean,655,0.01519,3276497,76.00247,4311040
844,j-griffith,654,0.01517,3277151,76.01764,4311040
845,joelanford,654,0.01517,3277805,76.03281,4311040
846,mtardy,653,0.01515,3278458,76.04796,4311040
847,mythi,653,0.01515,3279111,76.06311,4311040
848,mvdan,651,0.01510,3279762,76.07821,4311040
849,troy0820,649,0.01505,3280411,76.09326,4311040
850,adrianreber,647,0.01501,3281058,76.10827,4311040
851,pmichali,647,0.01501,3281705,76.12328,4311040
852,swagiaal,647,0.01501,3282352,76.13829,4311040
853,sunjayBhatia,642,0.01489,3282994,76.15318,4311040
854,mmiranda96,641,0.01487,3283635,76.16805,4311040
855,rhockenbury,641,0.01487,3284276,76.18292,4311040
856,habibrosyad,638,0.01480,3284914,76.19772,4311040
857,nikopen,638,0.01480,3285552,76.21251,4311040
858,karataliu,637,0.01478,3286189,76.22729,4311040
859,landreasyan,637,0.01478,3286826,76.24207,4311040
860,amacaskill,634,0.01471,3287460,76.25677,4311040
861,liu-cong,634,0.01471,3288094,76.27148,4311040
862,lukaszo,633,0.01468,3288727,76.28616,4311040
863,nearora-msft,632,0.01466,3289359,76.30082,4311040
864,jpeeler,630,0.01461,3289989,76.31544,4311040
865,davidvossel,629,0.01459,3290618,76.33003,4311040
866,feloy,628,0.01457,3291246,76.34459,4311040
867,seanschneeweiss,628,0.01457,3291874,76.35916,4311040
868,wk8,628,0.01457,3292502,76.37373,4311040
869,xueweiz,628,0.01457,3293130,76.38830,4311040
870,mgdevstack,625,0.01450,3293755,76.40279,4311040
871,jcbsmpsn,623,0.01445,3294378,76.41725,4311040
872,PI-Victor,623,0.01445,3295001,76.43170,4311040
873,YuikoTakada,620,0.01438,3295621,76.44608,4311040
874,schrej,619,0.01436,3296240,76.46044,4311040
875,luksa,618,0.01434,3296858,76.47477,4311040
876,jaypipes,617,0.01431,3297475,76.48908,4311040
877,aimuz,615,0.01427,3298090,76.50335,4311040
878,phanama,612,0.01420,3298702,76.51755,4311040
879,utkarsh-singh1,612,0.01420,3299314,76.53174,4311040
880,ankeesler,609,0.01413,3299923,76.54587,4311040
881,chentao1596,609,0.01413,3300532,76.55999,4311040
882,childsb,604,0.01401,3301136,76.57401,4311040
883,spew,602,0.01396,3301738,76.58797,4311040
884,charleszheng44,600,0.01392,3302338,76.60189,4311040
885,kevtaylor,600,0.01392,3302938,76.61581,4311040
886,prankul88,599,0.01389,3303537,76.62970,4311040
887,xingzhou,597,0.01385,3304134,76.64355,4311040
888,prasadkatti,595,0.01380,3304729,76.65735,4311040
889,Arvinderpal,593,0.01376,3305322,76.67110,4311040
890,linyouchong,593,0.01376,3305915,76.68486,4311040
891,chengxiangdong,592,0.01373,3306507,76.69859,4311040
892,akhilerm,591,0.01371,3307098,76.71230,4311040
893,dougm,591,0.01371,3307689,76.72601,4311040
894,sebastienvas,589,0.01366,3308278,76.73967,4311040
895,jeremyje,588,0.01364,3308866,76.75331,4311040
896,MorrisLaw,588,0.01364,3309454,76.76695,4311040
897,yxxhero,588,0.01364,3310042,76.78059,4311040
898,jupblb,584,0.01355,3310626,76.79414,4311040
899,sebgoa,584,0.01355,3311210,76.80768,4311040
900,tamilselvan1102,584,0.01355,3311794,76.82123,4311040
901,k82,581,0.01348,3312375,76.83471,4311040
902,huffmanca,579,0.01343,3312954,76.84814,4311040
903,pravarag,579,0.01343,3313533,76.86157,4311040
904,pierluigilenoci,578,0.01341,3314111,76.87498,4311040
905,superbrothers,574,0.01331,3314685,76.88829,4311040
906,jacobwolfaws,572,0.01327,3315257,76.90156,4311040
907,mcluseau,572,0.01327,3315829,76.91483,4311040
908,pigletfly,572,0.01327,3316401,76.92810,4311040
909,jsravn,571,0.01325,3316972,76.94134,4311040
910,ivelichkovich,570,0.01322,3317542,76.95456,4311040
911,josephburnett,570,0.01322,3318112,76.96779,4311040
912,warmchang,570,0.01322,3318682,76.98101,4311040
913,janosi,567,0.01315,3319249,76.99416,4311040
914,jmguzik,566,0.01313,3319815,77.00729,4311040
915,olivierlemasle,564,0.01308,3320379,77.02037,4311040
916,edsoncelio,562,0.01304,3320941,77.03341,4311040
917,islinwb,562,0.01304,3321503,77.04644,4311040
918,krzysztof-jastrzebski,562,0.01304,3322065,77.05948,4311040
919,csrwng,561,0.01301,3322626,77.07249,4311040
920,AlexeyPerevalov,560,0.01299,3323186,77.08548,4311040
921,BigDarkClown,559,0.01297,3323745,77.09845,4311040
922,daminisatya,558,0.01294,3324303,77.11139,4311040
923,rf232,558,0.01294,3324861,77.12434,4311040
924,joakimr-axis,556,0.01290,3325417,77.13723,4311040
925,adohe,553,0.01283,3325970,77.15006,4311040
926,codablock,553,0.01283,3326523,77.16289,4311040
927,micw523,553,0.01283,3327076,77.17572,4311040
928,Sh4d1,553,0.01283,3327629,77.18854,4311040
929,tsmetana,552,0.01280,3328181,77.20135,4311040
930,balajismaniam,551,0.01278,3328732,77.21413,4311040
931,arkodg,550,0.01276,3329282,77.22689,4311040
932,adikul30,549,0.01273,3329831,77.23962,4311040
933,kolyshkin,549,0.01273,3330380,77.25236,4311040
934,aoxn,548,0.01271,3330928,77.26507,4311040
935,squeed,548,0.01271,3331476,77.27778,4311040
936,alexander-demicev,547,0.01269,3332023,77.29047,4311040
937,vsoch,546,0.01267,3332569,77.30313,4311040
938,cody-clark,545,0.01264,3333114,77.31578,4311040
939,k-toyoda-pi,545,0.01264,3333659,77.32842,4311040
940,lachie83,540,0.01253,3334199,77.34094,4311040
941,Tal-or,540,0.01253,3334739,77.35347,4311040
942,Sajiyah-Salat,539,0.01250,3335278,77.36597,4311040
943,fiunchinho,537,0.01246,3335815,77.37843,4311040
944,zvonkok,535,0.01241,3336350,77.39084,4311040
945,alexandercampbell,534,0.01239,3336884,77.40323,4311040
946,byako,534,0.01239,3337418,77.41561,4311040
947,mariantalla,534,0.01239,3337952,77.42800,4311040
948,cyphar,530,0.01229,3338482,77.44029,4311040
949,gujingit,529,0.01227,3339011,77.45256,4311040
950,nzoueidi,529,0.01227,3339540,77.46483,4311040
951,pandaamanda,529,0.01227,3340069,77.47711,4311040
952,fisherxu,527,0.01222,3340596,77.48933,4311040
953,AndyXiangLi,526,0.01220,3341122,77.50153,4311040
954,pbx0,526,0.01220,3341648,77.51373,4311040
955,candita,524,0.01215,3342172,77.52589,4311040
956,desaintmartin,523,0.01213,3342695,77.53802,4311040
957,liupeng0518,522,0.01211,3343217,77.55013,4311040
958,f0rmiga,518,0.01202,3343735,77.56214,4311040
959,paralin,517,0.01199,3344252,77.57414,4311040
960,sarveshr7,517,0.01199,3344769,77.58613,4311040
961,rudoi,515,0.01195,3345284,77.59807,4311040
962,yaroslava-serdiuk,515,0.01195,3345799,77.61002,4311040
963,qhuynh96,513,0.01190,3346312,77.62192,4311040
964,s-kawamura-w664,513,0.01190,3346825,77.63382,4311040
965,srikiz,512,0.01188,3347337,77.64570,4311040
966,jonyhy96,511,0.01185,3347848,77.65755,4311040
967,dhilipkumars,509,0.01181,3348357,77.66936,4311040
968,stlaz,509,0.01181,3348866,77.68116,4311040
969,maxsmythe,506,0.01174,3349372,77.69290,4311040
970,sallyom,506,0.01174,3349878,77.70464,4311040
971,AndrewSirenko,505,0.01171,3350383,77.71635,4311040
972,lala123912,504,0.01169,3350887,77.72804,4311040
973,sdmodi,503,0.01167,3351390,77.73971,4311040
974,chrisz100,501,0.01162,3351891,77.75133,4311040
975,fengzixu,501,0.01162,3352392,77.76295,4311040
976,digitalfishpond,500,0.01160,3352892,77.77455,4311040
977,lojies,500,0.01160,3353392,77.78615,4311040
978,RobertKielty,499,0.01157,3353891,77.79772,4311040
979,sethpollack,498,0.01155,3354389,77.80928,4311040
980,grosser,497,0.01153,3354886,77.82080,4311040
981,marekbiskup,496,0.01151,3355382,77.83231,4311040
982,blakebarnett,495,0.01148,3355877,77.84379,4311040
983,kerneltime,495,0.01148,3356372,77.85527,4311040
984,ZP-AlwaysWin,495,0.01148,3356867,77.86676,4311040
985,xiaoxubeii,494,0.01146,3357361,77.87822,4311040
986,fraenkel,493,0.01144,3357854,77.88965,4311040
987,RobertKrawitz,493,0.01144,3358347,77.90109,4311040
988,devlware,492,0.01141,3358839,77.91250,4311040
989,lbernail,492,0.01141,3359331,77.92391,4311040
990,deitch,490,0.01137,3359821,77.93528,4311040
991,hogepodge,490,0.01137,3360311,77.94664,4311040
992,geoffcline,488,0.01132,3360799,77.95796,4311040
993,haiyanmeng,488,0.01132,3361287,77.96928,4311040
994,mfilocha,487,0.01130,3361774,77.98058,4311040
995,salaxander,486,0.01127,3362260,77.99185,4311040
996,fabiand,484,0.01123,3362744,78.00308,4311040
997,skitt,484,0.01123,3363228,78.01431,4311040
998,boddumanohar,483,0.01120,3363711,78.02551,4311040
999,dmmcquay,482,0.01118,3364193,78.03669,4311040
1000,bcwaldon,481,0.01116,3364674,78.04785,4311040
1001,dobsonj,481,0.01116,3365155,78.05901,4311040
1002,jbrette,480,0.01113,3365635,78.07014,4311040
1003,nalind,480,0.01113,3366115,78.08128,4311040
1004,fenggw-fnst,479,0.01111,3366594,78.09239,4311040
1005,tmrts,479,0.01111,3367073,78.10350,4311040
1006,egernst,477,0.01106,3367550,78.11456,4311040
1007,dekkagaijin,476,0.01104,3368026,78.12560,4311040
1008,erikgb,474,0.01100,3368500,78.13660,4311040
1009,gracenng,474,0.01100,3368974,78.14759,4311040
1010,qinqon,474,0.01100,3369448,78.15859,4311040
1011,sameo,474,0.01100,3369922,78.16958,4311040
1012,monnand,473,0.01097,3370395,78.18056,4311040
1013,natalisucks,473,0.01097,3370868,78.19153,4311040
1014,amolmote,472,0.01095,3371340,78.20248,4311040
1015,Abirdcfly,471,0.01093,3371811,78.21340,4311040
1016,niranjandarshann,471,0.01093,3372282,78.22433,4311040
1017,sflxn,471,0.01093,3372753,78.23525,4311040
1018,yonatankahana,469,0.01088,3373222,78.24613,4311040
1019,sxllwx,468,0.01086,3373690,78.25699,4311040
1020,tossmilestone,468,0.01086,3374158,78.26784,4311040
1021,yuexiao-wang,467,0.01083,3374625,78.27868,4311040
1022,Debanitrkl,466,0.01081,3375091,78.28948,4311040
1023,mochizuki875,466,0.01081,3375557,78.30029,4311040
1024,shivanshu1333,466,0.01081,3376023,78.31110,4311040
1025,Xenwar,464,0.01076,3376487,78.32187,4311040
1026,zhucan,462,0.01072,3376949,78.33258,4311040
1027,haosdent,461,0.01069,3377410,78.34328,4311040
1028,mitul3737,461,0.01069,3377871,78.35397,4311040
1029,tahsinrahman,461,0.01069,3378332,78.36466,4311040
1030,chaosaffe,460,0.01067,3378792,78.37533,4311040
1031,stevesloka,460,0.01067,3379252,78.38600,4311040
1032,aimeeu,459,0.01065,3379711,78.39665,4311040
1033,yanrongshi,458,0.01062,3380169,78.40728,4311040
1034,dgoodwin,457,0.01060,3380626,78.41788,4311040
1035,Rishit-dagli,457,0.01060,3381083,78.42848,4311040
1036,alexcontini,456,0.01058,3381539,78.43905,4311040
1037,LiliC,456,0.01058,3381995,78.44963,4311040
1038,yuxiaobo96,456,0.01058,3382451,78.46021,4311040
1039,answer1991,455,0.01055,3382906,78.47076,4311040
1040,hswong3i,455,0.01055,3383361,78.48132,4311040
1041,AlmogBaku,453,0.01051,3383814,78.49183,4311040
1042,ashcrow,453,0.01051,3384267,78.50233,4311040
1043,mpuckett159,453,0.01051,3384720,78.51284,4311040
1044,preillyme,452,0.01048,3385172,78.52333,4311040
1045,chriskim06,450,0.01044,3385622,78.53376,4311040
1046,lianghao208,448,0.01039,3386070,78.54416,4311040
1047,praseodym,448,0.01039,3386518,78.55455,4311040
1048,csantanapr,447,0.01037,3386965,78.56492,4311040
1049,displague,447,0.01037,3387412,78.57529,4311040
1050,jhadvig,447,0.01037,3387859,78.58565,4311040
1051,miaoyq,447,0.01037,3388306,78.59602,4311040
1052,moshloop,447,0.01037,3388753,78.60639,4311040
1053,discordianfish,444,0.01030,3389197,78.61669,4311040
1054,taimir,444,0.01030,3389641,78.62699,4311040
1055,airbornepony,443,0.01028,3390084,78.63727,4311040
1056,krol3,442,0.01025,3390526,78.64752,4311040
1057,sophieliu15,441,0.01023,3390967,78.65775,4311040
1058,andrewrynhard,440,0.01021,3391407,78.66795,4311040
1059,mikemorris,439,0.01018,3391846,78.67814,4311040
1060,jfrazelle,438,0.01016,3392284,78.68830,4311040
1061,mmamczur,438,0.01016,3392722,78.69846,4311040
1062,Joseph-Irving,437,0.01014,3393159,78.70859,4311040
1063,krmichel,435,0.01009,3393594,78.71869,4311040
1064,apricote,434,0.01007,3394028,78.72875,4311040
1065,mfanjie,433,0.01004,3394461,78.73880,4311040
1066,yissachar,433,0.01004,3394894,78.74884,4311040
1067,dominicgunn,432,0.01002,3395326,78.75886,4311040
1068,benluddy,431,0.01000,3395757,78.76886,4311040
1069,frankbu,431,0.01000,3396188,78.77886,4311040
1070,asalkeld,429,0.00995,3396617,78.78881,4311040
1071,myan9,429,0.00995,3397046,78.79876,4311040
1072,prafull01,428,0.00993,3397474,78.80869,4311040
1073,gaurav1086,427,0.00990,3397901,78.81859,4311040
1074,lucperkins,427,0.00990,3398328,78.82850,4311040
1075,Stono,426,0.00988,3398754,78.83838,4311040
1076,VivekThrivikraman-est,426,0.00988,3399180,78.84826,4311040
1077,a-mccarthy,425,0.00986,3399605,78.85812,4311040
1078,k4leung4,425,0.00986,3400030,78.86798,4311040
1079,mskrocki,425,0.00986,3400455,78.87783,4311040
1080,alenkacz,424,0.00984,3400879,78.88767,4311040
1081,charrywanganthony,424,0.00984,3401303,78.89751,4311040
1082,vbatts,424,0.00984,3401727,78.90734,4311040
1083,DiptoChakrabarty,421,0.00977,3402148,78.91711,4311040
1084,josedonizetti,421,0.00977,3402569,78.92687,4311040
1085,yanghaichao12,420,0.00974,3402989,78.93661,4311040
1086,balopat,419,0.00972,3403408,78.94633,4311040
1087,ksubrmnn,419,0.00972,3403827,78.95605,4311040
1088,mkorbi,419,0.00972,3404246,78.96577,4311040
1089,nabokihms,419,0.00972,3404665,78.97549,4311040
1090,screeley44,417,0.00967,3405082,78.98516,4311040
1091,aanm,416,0.00965,3405498,78.99481,4311040
1092,flaper87,416,0.00965,3405914,79.00446,4311040
1093,nan-yu,415,0.00963,3406329,79.01409,4311040
1094,dpasiukevich,413,0.00958,3406742,79.02367,4311040
1095,mcrute,412,0.00956,3407154,79.03323,4311040
1096,lauralorenz,410,0.00951,3407564,79.04274,4311040
1097,eloyekunle,409,0.00949,3407973,79.05222,4311040
1098,lingsamuel,409,0.00949,3408382,79.06171,4311040
1099,hantaowang,408,0.00946,3408790,79.07118,4311040
1100,pswica,407,0.00944,3409197,79.08062,4311040
1101,danielfm,406,0.00942,3409603,79.09003,4311040
1102,hickeyma,406,0.00942,3410009,79.09945,4311040
1103,vitaliy-leschenko,406,0.00942,3410415,79.10887,4311040
1104,tabbysable,405,0.00939,3410820,79.11826,4311040
1105,hpandeycodeit,404,0.00937,3411224,79.12764,4311040
1106,Xunzhuo,404,0.00937,3411628,79.13701,4311040
1107,pbetkier,403,0.00935,3412031,79.14635,4311040
1108,hase1128,402,0.00932,3412433,79.15568,4311040
1109,Cynerva,401,0.00930,3412834,79.16498,4311040
1110,iamemilio,401,0.00930,3413235,79.17428,4311040
1111,kaslin,401,0.00930,3413636,79.18358,4311040
1112,mayankshah1607,401,0.00930,3414037,79.19289,4311040
1113,jyotimahapatra,400,0.00928,3414437,79.20216,4311040
1114,bishal7679,399,0.00926,3414836,79.21142,4311040
1115,JeremyOT,399,0.00926,3415235,79.22068,4311040
1116,AndiDog,397,0.00921,3415632,79.22988,4311040
1117,leblancd,397,0.00921,3416029,79.23909,4311040
1118,chenyw1990,395,0.00916,3416424,79.24826,4311040
1119,zhiguo-lu,393,0.00912,3416817,79.25737,4311040
1120,mooncak,392,0.00909,3417209,79.26646,4311040
1121,niuzhenguo,391,0.00907,3417600,79.27553,4311040
1122,ptux,391,0.00907,3417991,79.28460,4311040
1123,zhanggbj,391,0.00907,3418382,79.29367,4311040
1124,johanneswuerbach,387,0.00898,3418769,79.30265,4311040
1125,mbbroberg,387,0.00898,3419156,79.31163,4311040
1126,qingsenLi,387,0.00898,3419543,79.32060,4311040
1127,klausenbusk,386,0.00895,3419929,79.32956,4311040
1128,LappleApple,386,0.00895,3420315,79.33851,4311040
1129,blueorangutan,385,0.00893,3420700,79.34744,4311040
1130,richardchen331,385,0.00893,3421085,79.35637,4311040
1131,Colstuwjx,384,0.00891,3421469,79.36528,4311040
1132,jingax10,383,0.00888,3421852,79.37416,4311040
1133,voelzmo,383,0.00888,3422235,79.38305,4311040
1134,baude,382,0.00886,3422617,79.39191,4311040
1135,Danil-Grigorev,382,0.00886,3422999,79.40077,4311040
1136,BenHall,381,0.00884,3423380,79.40961,4311040
1137,diazjf,381,0.00884,3423761,79.41845,4311040
1138,kbasv,379,0.00879,3424140,79.42724,4311040
1139,vishakhanihore,379,0.00879,3424519,79.43603,4311040
1140,geetikabatra,378,0.00877,3424897,79.44480,4311040
1141,HanFa,378,0.00877,3425275,79.45357,4311040
1142,kisieland,378,0.00877,3425653,79.46233,4311040
1143,SomtochiAma,378,0.00877,3426031,79.47110,4311040
1144,craigbox,377,0.00874,3426408,79.47985,4311040
1145,rajatjindal,377,0.00874,3426785,79.48859,4311040
1146,kcmartin,376,0.00872,3427161,79.49731,4311040
1147,kkkkun,376,0.00872,3427537,79.50604,4311040
1148,Madhu-1,376,0.00872,3427913,79.51476,4311040
1149,kmova,375,0.00870,3428288,79.52346,4311040
1150,nunnatsa,374,0.00868,3428662,79.53213,4311040
1151,alisondy,373,0.00865,3429035,79.54078,4311040
1152,huang195,373,0.00865,3429408,79.54944,4311040
1153,dnardo,372,0.00863,3429780,79.55806,4311040
1154,drubin,372,0.00863,3430152,79.56669,4311040
1155,jackgr,372,0.00863,3430524,79.57532,4311040
1156,liangyuanpeng,372,0.00863,3430896,79.58395,4311040
1157,Rajalakshmi-Girish,372,0.00863,3431268,79.59258,4311040
1158,nnmin-aws,371,0.00861,3431639,79.60119,4311040
1159,sohankunkerkar,371,0.00861,3432010,79.60979,4311040
1160,bharath-123,369,0.00856,3432379,79.61835,4311040
1161,makkes,369,0.00856,3432748,79.62691,4311040
1162,mk46,369,0.00856,3433117,79.63547,4311040
1163,mars1024,368,0.00854,3433485,79.64401,4311040
1164,monotek,368,0.00854,3433853,79.65254,4311040
1165,alejandroEsc,367,0.00851,3434220,79.66106,4311040
1166,moshe010,367,0.00851,3434587,79.66957,4311040
1167,Sarsate,367,0.00851,3434954,79.67808,4311040
1168,fanzhangio,366,0.00849,3435320,79.68657,4311040
1169,claurence,365,0.00847,3435685,79.69504,4311040
1170,jlbutler,365,0.00847,3436050,79.70351,4311040
1171,kmala,365,0.00847,3436415,79.71197,4311040
1172,michaelbeaumont,365,0.00847,3436780,79.72044,4311040
1173,copejon,364,0.00844,3437144,79.72888,4311040
1174,csbell,364,0.00844,3437508,79.73733,4311040
1175,yussufsh,364,0.00844,3437872,79.74577,4311040
1176,sarahnovotny,363,0.00842,3438235,79.75419,4311040
1177,schylek,363,0.00842,3438598,79.76261,4311040
1178,abgworrall,362,0.00840,3438960,79.77101,4311040
1179,pbarker,362,0.00840,3439322,79.77940,4311040
1180,abiogenesis-now,361,0.00837,3439683,79.78778,4311040
1181,fturib,361,0.00837,3440044,79.79615,4311040
1182,jayantjain93,361,0.00837,3440405,79.80453,4311040
1183,zehuaiWANG,361,0.00837,3440766,79.81290,4311040
1184,HaiyangDING,360,0.00835,3441126,79.82125,4311040
1185,imkin,360,0.00835,3441486,79.82960,4311040
1186,mittalyashu,360,0.00835,3441846,79.83795,4311040
1187,pontiyaraja,360,0.00835,3442206,79.84630,4311040
1188,AmarNathChary,359,0.00833,3442565,79.85463,4311040
1189,ambiknai,359,0.00833,3442924,79.86296,4311040
1190,yibozhuang,359,0.00833,3443283,79.87128,4311040
1191,lintongj,358,0.00830,3443641,79.87959,4311040
1192,mattmoor,358,0.00830,3443999,79.88789,4311040
1193,shivramsrivastava,358,0.00830,3444357,79.89620,4311040
1194,abrarshivani,357,0.00828,3444714,79.90448,4311040
1195,shurup,357,0.00828,3445071,79.91276,4311040
1196,bparees,356,0.00826,3445427,79.92102,4311040
1197,nak3,356,0.00826,3445783,79.92927,4311040
1198,yujunz,356,0.00826,3446139,79.93753,4311040
1199,rashmigottipati,355,0.00823,3446494,79.94577,4311040
1200,hprateek43,354,0.00821,3446848,79.95398,4311040
1201,ziyi-xie,354,0.00821,3447202,79.96219,4311040
1202,judemars,353,0.00819,3447555,79.97038,4311040
1203,katcosgrove,352,0.00817,3447907,79.97854,4311040
1204,mweibel,352,0.00817,3448259,79.98671,4311040
1205,negz,352,0.00817,3448611,79.99487,4311040
1206,huangyuqi,351,0.00814,3448962,80.00302,4311040
1207,ianychoi,351,0.00814,3449313,80.01116,4311040
1208,tomplus,351,0.00814,3449664,80.01930,4311040
1209,damdo,350,0.00812,3450014,80.02742,4311040
1210,sidharthsurana,350,0.00812,3450364,80.03554,4311040
1211,bg-chun,349,0.00810,3450713,80.04363,4311040
1212,johnsonj,349,0.00810,3451062,80.05173,4311040
1213,davidewatson,348,0.00807,3451410,80.05980,4311040
1214,lukemarsden,348,0.00807,3451758,80.06787,4311040
1215,sathieu,348,0.00807,3452106,80.07594,4311040
1216,smg247,348,0.00807,3452454,80.08402,4311040
1217,MarkThink,347,0.00805,3452801,80.09207,4311040
1218,ravigadde,347,0.00805,3453148,80.10012,4311040
1219,rekcah78,347,0.00805,3453495,80.10816,4311040
1220,sylr,346,0.00803,3453841,80.11619,4311040
1221,levikobi,345,0.00800,3454186,80.12419,4311040
1222,pospispa,345,0.00800,3454531,80.13220,4311040
1223,jayesh-srivastava,344,0.00798,3454875,80.14017,4311040
1224,satyasm,344,0.00798,3455219,80.14815,4311040
1225,zhaoxpZTE,344,0.00798,3455563,80.15613,4311040
1226,chuckbutler,343,0.00796,3455906,80.16409,4311040
1227,daixiang0,343,0.00796,3456249,80.17205,4311040
1228,andronat,341,0.00791,3456590,80.17996,4311040
1229,bsdnet,341,0.00791,3456931,80.18787,4311040
1230,midnightconman,340,0.00789,3457271,80.19575,4311040
1231,medinatiger,339,0.00786,3457610,80.20362,4311040
1232,mvladev,339,0.00786,3457949,80.21148,4311040
1233,supereagle,339,0.00786,3458288,80.21934,4311040
1234,dshulyak,338,0.00784,3458626,80.22718,4311040
1235,dtzar,338,0.00784,3458964,80.23502,4311040
1236,emedina,338,0.00784,3459302,80.24286,4311040
1237,mickeyboxell,338,0.00784,3459640,80.25071,4311040
1238,hanlins,337,0.00782,3459977,80.25852,4311040
1239,kkmsft,337,0.00782,3460314,80.26634,4311040
1240,skriss,337,0.00782,3460651,80.27416,4311040
1241,jianhuiz,336,0.00779,3460987,80.28195,4311040
1242,mucahitkurt,336,0.00779,3461323,80.28974,4311040
1243,pierreprinetti,336,0.00779,3461659,80.29754,4311040
1244,xieyanker,336,0.00779,3461995,80.30533,4311040
1245,batikanu,335,0.00777,3462330,80.31310,4311040
1246,matchstick,334,0.00775,3462664,80.32085,4311040
1247,rtheis,334,0.00775,3462998,80.32860,4311040
1248,skilxn-go,334,0.00775,3463332,80.33635,4311040
1249,jlewi,332,0.00770,3463664,80.34405,4311040
1250,BinacsLee,331,0.00768,3463995,80.35172,4311040
1251,bugoverdose,331,0.00768,3464326,80.35940,4311040
1252,taragu,331,0.00768,3464657,80.36708,4311040
1253,davidjumani,330,0.00765,3464987,80.37474,4311040
1254,rohityadavcloud,330,0.00765,3465317,80.38239,4311040
1255,alrs,329,0.00763,3465646,80.39002,4311040
1256,mtougeron,329,0.00763,3465975,80.39765,4311040
1257,paulangton,329,0.00763,3466304,80.40529,4311040
1258,truongnh1992,329,0.00763,3466633,80.41292,4311040
1259,javadoors,328,0.00761,3466961,80.42052,4311040
1260,npolshakova,328,0.00761,3467289,80.42813,4311040
1261,dongsupark,327,0.00759,3467616,80.43572,4311040
1262,Miciah,327,0.00759,3467943,80.44330,4311040
1263,EleanorRigby,326,0.00756,3468269,80.45087,4311040
1264,nodo,326,0.00756,3468595,80.45843,4311040
1265,Ethyling,325,0.00754,3468920,80.46597,4311040
1266,ruquanzhao,325,0.00754,3469245,80.47351,4311040
1267,Evalle,324,0.00752,3469569,80.48102,4311040
1268,MaxRink,324,0.00752,3469893,80.48854,4311040
1269,KobayashiD27,323,0.00749,3470216,80.49603,4311040
1270,cadmuxe,322,0.00747,3470538,80.50350,4311040
1271,chrismetz09,322,0.00747,3470860,80.51097,4311040
1272,heqg,322,0.00747,3471182,80.51844,4311040
1273,jiatongw,322,0.00747,3471504,80.52591,4311040
1274,jingyih,322,0.00747,3471826,80.53337,4311040
1275,asifdxtreme,321,0.00745,3472147,80.54082,4311040
1276,kairen,321,0.00745,3472468,80.54827,4311040
1277,VineethReddy02,321,0.00745,3472789,80.55571,4311040
1278,colhom,320,0.00742,3473109,80.56314,4311040
1279,guoshimin,320,0.00742,3473429,80.57056,4311040
1280,jcjesus,320,0.00742,3473749,80.57798,4311040
1281,cmurphy,319,0.00740,3474068,80.58538,4311040
1282,MikaelCluseau,319,0.00740,3474387,80.59278,4311040
1283,rmohr,319,0.00740,3474706,80.60018,4311040
1284,alexbrand,318,0.00738,3475024,80.60756,4311040
1285,hughdanliu,318,0.00738,3475342,80.61493,4311040
1286,wahyuoi,318,0.00738,3475660,80.62231,4311040
1287,daschott,317,0.00735,3475977,80.62966,4311040
1288,mikkeloscar,317,0.00735,3476294,80.63702,4311040
1289,bmelbourne,316,0.00733,3476610,80.64435,4311040
1290,2rs2ts,315,0.00731,3476925,80.65165,4311040
1291,mxinden,315,0.00731,3477240,80.65896,4311040
1292,sbangari,315,0.00731,3477555,80.66627,4311040
1293,jinzhejz,314,0.00728,3477869,80.67355,4311040
1294,mattmoyer,314,0.00728,3478183,80.68083,4311040
1295,Cweiping,313,0.00726,3478496,80.68809,4311040
1296,ktsakalozos,313,0.00726,3478809,80.69535,4311040
1297,sboeuf,313,0.00726,3479122,80.70261,4311040
1298,costinm,312,0.00724,3479434,80.70985,4311040
1299,johannesfrey,312,0.00724,3479746,80.71709,4311040
1300,whereisaaron,312,0.00724,3480058,80.72433,4311040
1301,Klaven,311,0.00721,3480369,80.73154,4311040
1302,erinboyd,310,0.00719,3480679,80.73873,4311040
1303,liranp,310,0.00719,3480989,80.74592,4311040
1304,thejoycekung,310,0.00719,3481299,80.75311,4311040
1305,alaypatel07,308,0.00714,3481607,80.76026,4311040
1306,tfogo,308,0.00714,3481915,80.76740,4311040
1307,adrianchiris,306,0.00710,3482221,80.77450,4311040
1308,agradouski,306,0.00710,3482527,80.78160,4311040
1309,lubinsz,306,0.00710,3482833,80.78870,4311040
1310,mdshuai,305,0.00707,3483138,80.79577,4311040
1311,oz123,305,0.00707,3483443,80.80285,4311040
1312,vdhanan,305,0.00707,3483748,80.80992,4311040
1313,Bryce-Soghigian,304,0.00705,3484052,80.81697,4311040
1314,cndoit18,304,0.00705,3484356,80.82402,4311040
1315,mrthinger,304,0.00705,3484660,80.83108,4311040
1316,Pensu,304,0.00705,3484964,80.83813,4311040
1317,rpothier,304,0.00705,3485268,80.84518,4311040
1318,adelton,303,0.00703,3485571,80.85221,4311040
1319,arahamad,303,0.00703,3485874,80.85924,4311040
1320,devkid,302,0.00701,3486176,80.86624,4311040
1321,IanLewis,302,0.00701,3486478,80.87325,4311040
1322,mrgiles,302,0.00701,3486780,80.88025,4311040
1323,adilGhaffarDev,301,0.00698,3487081,80.88723,4311040
1324,cnmcavoy,301,0.00698,3487382,80.89422,4311040
1325,faiq,301,0.00698,3487683,80.90120,4311040
1326,granular-ryanbonham,301,0.00698,3487984,80.90818,4311040
1327,huchengze,301,0.00698,3488285,80.91516,4311040
1328,jweite-amazon,301,0.00698,3488586,80.92214,4311040
1329,radhikapc,301,0.00698,3488887,80.92913,4311040
1330,ibzib,300,0.00696,3489187,80.93609,4311040
1331,ScorpioCPH,299,0.00694,3489486,80.94302,4311040
1332,drekle,298,0.00691,3489784,80.94993,4311040
1333,rutsky,298,0.00691,3490082,80.95685,4311040
1334,chenhuan12,297,0.00689,3490379,80.96373,4311040
1335,fatsheep9146,297,0.00689,3490676,80.97062,4311040
1336,abhgupta,296,0.00687,3490972,80.97749,4311040
1337,navidshaikh,296,0.00687,3491268,80.98436,4311040
1338,shekhar-rajak,296,0.00687,3491564,80.99122,4311040
1339,wozniakjan,296,0.00687,3491860,80.99809,4311040
1340,zhan849,296,0.00687,3492156,81.00495,4311040
1341,zioproto,296,0.00687,3492452,81.01182,4311040
1342,chenxuc,295,0.00684,3492747,81.01866,4311040
1343,maisem,295,0.00684,3493042,81.02551,4311040
1344,mitar,295,0.00684,3493337,81.03235,4311040
1345,nhlfr,295,0.00684,3493632,81.03919,4311040
1346,tonglil,294,0.00682,3493926,81.04601,4311040
1347,blueelvis,293,0.00680,3494219,81.05281,4311040
1348,simon3z,293,0.00680,3494512,81.05961,4311040
1349,tcharding,293,0.00680,3494805,81.06640,4311040
1350,nebril,292,0.00677,3495097,81.07317,4311040
1351,nolancon,292,0.00677,3495389,81.07995,4311040
1352,hafe,291,0.00675,3495680,81.08670,4311040
1353,jmrodri,291,0.00675,3495971,81.09345,4311040
1354,Quentin-M,291,0.00675,3496262,81.10020,4311040
1355,arghya88,290,0.00673,3496552,81.10693,4311040
1356,bpineau,290,0.00673,3496842,81.11365,4311040
1357,NicolasT,290,0.00673,3497132,81.12038,4311040
1358,nixpanic,290,0.00673,3497422,81.12711,4311040
1359,uluyol,290,0.00673,3497712,81.13383,4311040
1360,voor,290,0.00673,3498002,81.14056,4311040
1361,cji,289,0.00670,3498291,81.14726,4311040
1362,luthermonson,289,0.00670,3498580,81.15397,4311040
1363,makoscafee,289,0.00670,3498869,81.16067,4311040
1364,michaelmdresser,289,0.00670,3499158,81.16737,4311040
1365,agau4779,288,0.00668,3499446,81.17406,4311040
1366,ErikJiang,288,0.00668,3499734,81.18074,4311040
1367,procrypt,288,0.00668,3500022,81.18742,4311040
1368,arjunrn,287,0.00666,3500309,81.19407,4311040
1369,laozc,287,0.00666,3500596,81.20073,4311040
1370,soggiest,287,0.00666,3500883,81.20739,4311040
1371,Vyom-Yadav,287,0.00666,3501170,81.21405,4311040
1372,djsly,285,0.00661,3501455,81.22066,4311040
1373,gianarb,285,0.00661,3501740,81.22727,4311040
1374,laxmikantbpandhare,285,0.00661,3502025,81.23388,4311040
1375,ronnielai,285,0.00661,3502310,81.24049,4311040
1376,sugangli,285,0.00661,3502595,81.24710,4311040
1377,AnanyaKumar,284,0.00659,3502879,81.25369,4311040
1378,xiaoanyunfei,284,0.00659,3503163,81.26028,4311040
1379,yosshy,284,0.00659,3503447,81.26686,4311040
1380,aniruddha2000,283,0.00656,3503730,81.27343,4311040
1381,Crazykev,283,0.00656,3504013,81.27999,4311040
1382,dntosas,283,0.00656,3504296,81.28656,4311040
1383,hchenxa,283,0.00656,3504579,81.29312,4311040
1384,borgerli,282,0.00654,3504861,81.29966,4311040
1385,fabxc,282,0.00654,3505143,81.30620,4311040
1386,MikeJeffrey,282,0.00654,3505425,81.31275,4311040
1387,camilb,281,0.00652,3505706,81.31926,4311040
1388,chelseychen,281,0.00652,3505987,81.32578,4311040
1389,Fale,281,0.00652,3506268,81.33230,4311040
1390,jiangyaoguo,281,0.00652,3506549,81.33882,4311040
1391,tghartland,281,0.00652,3506830,81.34534,4311040
1392,VojtechVitek,281,0.00652,3507111,81.35185,4311040
1393,yanggangtony,281,0.00652,3507392,81.35837,4311040
1394,Affan-7,280,0.00649,3507672,81.36487,4311040
1395,helight,280,0.00649,3507952,81.37136,4311040
1396,jwforres,280,0.00649,3508232,81.37786,4311040
1397,TBBle,280,0.00649,3508512,81.38435,4311040
1398,javidiaz,279,0.00647,3508791,81.39082,4311040
1399,lixiang233,279,0.00647,3509070,81.39730,4311040
1400,mbssaiakhil,279,0.00647,3509349,81.40377,4311040
1401,n4j,279,0.00647,3509628,81.41024,4311040
1402,zorro786,279,0.00647,3509907,81.41671,4311040
1403,hmrm,278,0.00645,3510185,81.42316,4311040
1404,imroc,278,0.00645,3510463,81.42961,4311040
1405,ipochi,278,0.00645,3510741,81.43606,4311040
1406,jay-lau,278,0.00645,3511019,81.44251,4311040
1407,marcosdiez,278,0.00645,3511297,81.44895,4311040
1408,jiaj12,277,0.00643,3511574,81.45538,4311040
1409,qiujian16,277,0.00643,3511851,81.46181,4311040
1410,rdpsin,277,0.00643,3512128,81.46823,4311040
1411,14rcole,276,0.00640,3512404,81.47463,4311040
1412,bavarianbidi,276,0.00640,3512680,81.48103,4311040
1413,george-angel,275,0.00638,3512955,81.48741,4311040
1414,liyinan926,275,0.00638,3513230,81.49379,4311040
1415,mrkm4ntr,275,0.00638,3513505,81.50017,4311040
1416,ZhiFeng1993,275,0.00638,3513780,81.50655,4311040
1417,cahillsf,274,0.00636,3514054,81.51291,4311040
1418,elezar,274,0.00636,3514328,81.51926,4311040
1419,aronchick,273,0.00633,3514601,81.52559,4311040
1420,whitlockjc,273,0.00633,3514874,81.53193,4311040
1421,thecrudge,272,0.00631,3515146,81.53824,4311040
1422,astefanutti,271,0.00629,3515417,81.54452,4311040
1423,gbraad,271,0.00629,3515688,81.55081,4311040
1424,yulng,271,0.00629,3515959,81.55710,4311040
1425,Fish-pro,270,0.00626,3516229,81.56336,4311040
1426,MarcelMue,270,0.00626,3516499,81.56962,4311040
1427,mloskot,270,0.00626,3516769,81.57588,4311040
1428,ibabou,269,0.00624,3517038,81.58212,4311040
1429,timyinshi,269,0.00624,3517307,81.58836,4311040
1430,vivekbagade,269,0.00624,3517576,81.59460,4311040
1431,dcantah,268,0.00622,3517844,81.60082,4311040
1432,lwander,268,0.00622,3518112,81.60704,4311040
1433,Mr-Linus,268,0.00622,3518380,81.61325,4311040
1434,sheerun,268,0.00622,3518648,81.61947,4311040
1435,utam0k,268,0.00622,3518916,81.62569,4311040
1436,lodrem,267,0.00619,3519183,81.63188,4311040
1437,paalkr,267,0.00619,3519450,81.63807,4311040
1438,rickypai,267,0.00619,3519717,81.64427,4311040
1439,adshmh,266,0.00617,3519983,81.65044,4311040
1440,gianrubio,266,0.00617,3520249,81.65661,4311040
1441,krishchow,265,0.00615,3520514,81.66275,4311040
1442,wenlxie,265,0.00615,3520779,81.66890,4311040
1443,zerkms,265,0.00615,3521044,81.67505,4311040
1444,allencloud,264,0.00612,3521308,81.68117,4311040
1445,jasonbraganza,264,0.00612,3521572,81.68730,4311040
1446,lcfang,264,0.00612,3521836,81.69342,4311040
1447,mainred,264,0.00612,3522100,81.69954,4311040
1448,maplain,264,0.00612,3522364,81.70567,4311040
1449,SaranBalaji90,264,0.00612,3522628,81.71179,4311040
1450,Hui-Zhi,262,0.00608,3522890,81.71787,4311040
1451,kflynn,262,0.00608,3523152,81.72395,4311040
1452,qingling128,262,0.00608,3523414,81.73002,4311040
1453,aaroniscode,261,0.00605,3523675,81.73608,4311040
1454,dholbach,261,0.00605,3523936,81.74213,4311040
1455,dipankardas011,261,0.00605,3524197,81.74819,4311040
1456,vrothberg,261,0.00605,3524458,81.75424,4311040
1457,ahmad-diaa,260,0.00603,3524718,81.76027,4311040
1458,femrtnz,260,0.00603,3524978,81.76630,4311040
1459,jingyuanliang,260,0.00603,3525238,81.77233,4311040
1460,lizhuqi,260,0.00603,3525498,81.77836,4311040
1461,ellistarn,259,0.00601,3525757,81.78437,4311040
1462,likakuli,259,0.00601,3526016,81.79038,4311040
1463,vpickard,259,0.00601,3526275,81.79639,4311040
1464,frittentheke,258,0.00598,3526533,81.80237,4311040
1465,goodluckbot,258,0.00598,3526791,81.80836,4311040
1466,gyohuangxin,258,0.00598,3527049,81.81434,4311040
1467,itowlson,258,0.00598,3527307,81.82033,4311040
1468,Sakuralbj,258,0.00598,3527565,81.82631,4311040
1469,yuswift,258,0.00598,3527823,81.83230,4311040
1470,gkarthiks,257,0.00596,3528080,81.83826,4311040
1471,michelleN,257,0.00596,3528337,81.84422,4311040
1472,onyiny-ang,257,0.00596,3528594,81.85018,4311040
1473,changshuchao,256,0.00594,3528850,81.85612,4311040
1474,mkibbe1993,256,0.00594,3529106,81.86206,4311040
1475,shuheiktgw,255,0.00592,3529361,81.86797,4311040
1476,YuxiJin-tobeyjin,255,0.00592,3529616,81.87389,4311040
1477,inteon,254,0.00589,3529870,81.87978,4311040
1478,joejulian,254,0.00589,3530124,81.88567,4311040
1479,s-ito-ts,254,0.00589,3530378,81.89156,4311040
1480,XudongLiuHarold,254,0.00589,3530632,81.89745,4311040
1481,zmalik,254,0.00589,3530886,81.90335,4311040
1482,alok87,253,0.00587,3531139,81.90921,4311040
1483,containscafeine,253,0.00587,3531392,81.91508,4311040
1484,Dyanngg,253,0.00587,3531645,81.92095,4311040
1485,jzhoucliqr,253,0.00587,3531898,81.92682,4311040
1486,meirf,253,0.00587,3532151,81.93269,4311040
1487,verma-kunal,253,0.00587,3532404,81.93856,4311040
1488,achernevskii,252,0.00585,3532656,81.94440,4311040
1489,keithmattix,252,0.00585,3532908,81.95025,4311040
1490,madhanrm,252,0.00585,3533160,81.95609,4311040
1491,naveensrinivasan,252,0.00585,3533412,81.96194,4311040
1492,frobware,251,0.00582,3533663,81.96776,4311040
1493,qmfrederik,251,0.00582,3533914,81.97358,4311040
1494,sakshamsharma,251,0.00582,3534165,81.97941,4311040
1495,lixiaobing10051267,250,0.00580,3534415,81.98521,4311040
1496,masap,250,0.00580,3534665,81.99100,4311040
1497,ydcool,250,0.00580,3534915,81.99680,4311040
1498,phoenixking25,248,0.00575,3535163,82.00256,4311040
1499,rkouj,248,0.00575,3535411,82.00831,4311040
1500,timebertt,248,0.00575,3535659,82.01406,4311040
1501,Dingshujie,247,0.00573,3535906,82.01979,4311040
1502,arun-gupta,246,0.00571,3536152,82.02550,4311040
1503,cailynse,246,0.00571,3536398,82.03120,4311040
1504,jianzhangbjz,246,0.00571,3536644,82.03691,4311040
1505,PurelyApplied,246,0.00571,3536890,82.04262,4311040
1506,ahmetalpbalkan,245,0.00568,3537135,82.04830,4311040
1507,metral,245,0.00568,3537380,82.05398,4311040
1508,mrhillsman,245,0.00568,3537625,82.05967,4311040
1509,aayushrangwala,244,0.00566,3537869,82.06533,4311040
1510,lmdaly,244,0.00566,3538113,82.07099,4311040
1511,LorbusChris,244,0.00566,3538357,82.07665,4311040
1512,martinmaly,244,0.00566,3538601,82.08230,4311040
1513,amygdala,243,0.00564,3538844,82.08794,4311040
1514,jan-est,243,0.00564,3539087,82.09358,4311040
1515,songjiaxun,243,0.00564,3539330,82.09922,4311040
1516,tanjing2020,243,0.00564,3539573,82.10485,4311040
1517,abhiraut,242,0.00561,3539815,82.11047,4311040
1518,heartlock,242,0.00561,3540057,82.11608,4311040
1519,houjun41544,242,0.00561,3540299,82.12169,4311040
1520,MarkusTeufelberger,242,0.00561,3540541,82.12731,4311040
1521,nehaLohia27,242,0.00561,3540783,82.13292,4311040
1522,nvtkaszpir,242,0.00561,3541025,82.13853,4311040
1523,sanjaypujare,242,0.00561,3541267,82.14415,4311040
1524,ferhatelmas,241,0.00559,3541508,82.14974,4311040
1525,h3poteto,241,0.00559,3541749,82.15533,4311040
1526,marckhouzam,241,0.00559,3541990,82.16092,4311040
1527,zhangqx2010,241,0.00559,3542231,82.16651,4311040
1528,pegasas,240,0.00557,3542471,82.17207,4311040
1529,tokers,240,0.00557,3542711,82.17764,4311040
1530,e-blackwelder,239,0.00554,3542950,82.18319,4311040
1531,javier-b-perez,239,0.00554,3543189,82.18873,4311040
1532,reetasingh,239,0.00554,3543428,82.19427,4311040
1533,thisisharrsh,239,0.00554,3543667,82.19982,4311040
1534,bjhaid,238,0.00552,3543905,82.20534,4311040
1535,d-nishi,238,0.00552,3544143,82.21086,4311040
1536,hi-rustin,238,0.00552,3544381,82.21638,4311040
1537,iaguis,238,0.00552,3544619,82.22190,4311040
1538,abonas,237,0.00550,3544856,82.22740,4311040
1539,robinpercy,237,0.00550,3545093,82.23290,4311040
1540,sieben,237,0.00550,3545330,82.23839,4311040
1541,tnir,237,0.00550,3545567,82.24389,4311040
1542,guettli,236,0.00547,3545803,82.24936,4311040
1543,shawn-hurley,236,0.00547,3546039,82.25484,4311040
1544,joekr,235,0.00545,3546274,82.26029,4311040
1545,liuxu623,235,0.00545,3546509,82.26574,4311040
1546,CriaHu,234,0.00543,3546743,82.27117,4311040
1547,dlapcevic,234,0.00543,3546977,82.27660,4311040
1548,riita10069,234,0.00543,3547211,82.28202,4311040
1549,runseb,234,0.00543,3547445,82.28745,4311040
1550,Michelle951,233,0.00540,3547678,82.29286,4311040
1551,ShwethaKumbla,233,0.00540,3547911,82.29826,4311040
1552,karuppiah7890,232,0.00538,3548143,82.30364,4311040
1553,dhirajh,231,0.00536,3548374,82.30900,4311040
1554,jhvhs,231,0.00536,3548605,82.31436,4311040
1555,relyt0925,231,0.00536,3548836,82.31972,4311040
1556,yugui,231,0.00536,3549067,82.32508,4311040
1557,bruceauyeung,230,0.00534,3549297,82.33041,4311040
1558,dobesv,230,0.00534,3549527,82.33575,4311040
1559,huzhengchuan,230,0.00534,3549757,82.34108,4311040
1560,Namanl2001,230,0.00534,3549987,82.34642,4311040
1561,rahulkjoshi,230,0.00534,3550217,82.35175,4311040
1562,weiling61,230,0.00534,3550447,82.35709,4311040
1563,JieJhih,229,0.00531,3550676,82.36240,4311040
1564,NoicFank,229,0.00531,3550905,82.36771,4311040
1565,tukwila,229,0.00531,3551134,82.37302,4311040
1566,bep,228,0.00529,3551362,82.37831,4311040
1567,cimomo,228,0.00529,3551590,82.38360,4311040
1568,dkoshkin,228,0.00529,3551818,82.38889,4311040
1569,mkjelland,228,0.00529,3552046,82.39418,4311040
1570,AndiLi99,227,0.00527,3552273,82.39944,4311040
1571,deepak-vij,227,0.00527,3552500,82.40471,4311040
1572,evankanderson,227,0.00527,3552727,82.40998,4311040
1573,gcs278,227,0.00527,3552954,82.41524,4311040
1574,bene2k1,226,0.00524,3553180,82.42048,4311040
1575,chenhonggc,226,0.00524,3553406,82.42573,4311040
1576,hsadoyan,226,0.00524,3553632,82.43097,4311040
1577,MaxymVlasov,226,0.00524,3553858,82.43621,4311040
1578,amy,225,0.00522,3554083,82.44143,4311040
1579,ngtuna,225,0.00522,3554308,82.44665,4311040
1580,ryanmcginnis,225,0.00522,3554533,82.45187,4311040
1581,ahrtr,224,0.00520,3554757,82.45706,4311040
1582,steuhs,224,0.00520,3554981,82.46226,4311040
1583,xsgordon,224,0.00520,3555205,82.46746,4311040
1584,rfranzke,223,0.00517,3555428,82.47263,4311040
1585,santachopa,223,0.00517,3555651,82.47780,4311040
1586,subramanian-neelakantan,223,0.00517,3555874,82.48297,4311040
1587,yodahekinsew,223,0.00517,3556097,82.48815,4311040
1588,ajaeger,222,0.00515,3556319,82.49330,4311040
1589,jeremyeder,222,0.00515,3556541,82.49845,4311040
1590,moficodes,222,0.00515,3556763,82.50360,4311040
1591,harshitasao,221,0.00513,3556984,82.50872,4311040
1592,mcbenjemaa,221,0.00513,3557205,82.51385,4311040
1593,yqwang-ms,221,0.00513,3557426,82.51897,4311040
1594,dthorsen,220,0.00510,3557646,82.52408,4311040
1595,fasaxc,220,0.00510,3557866,82.52918,4311040
1596,iterion,220,0.00510,3558086,82.53428,4311040
1597,npu21,220,0.00510,3558306,82.53939,4311040
1598,yuga711,220,0.00510,3558526,82.54449,4311040
1599,campoy,219,0.00508,3558745,82.54957,4311040
1600,gaorong,219,0.00508,3558964,82.55465,4311040
1601,matti,219,0.00508,3559183,82.55973,4311040
1602,nprokopic,219,0.00508,3559402,82.56481,4311040
1603,pierewoj,219,0.00508,3559621,82.56989,4311040
1604,prateekgogia,219,0.00508,3559840,82.57497,4311040
1605,AvineshTripathi,218,0.00506,3560058,82.58003,4311040
1606,easeway,218,0.00506,3560276,82.58508,4311040
1607,gaoguangze111,218,0.00506,3560494,82.59014,4311040
1608,hypnoglow,218,0.00506,3560712,82.59520,4311040
1609,lukaszgryglicki,218,0.00506,3560930,82.60025,4311040
1610,beautytiger,217,0.00503,3561147,82.60529,4311040
1611,cbandy,217,0.00503,3561364,82.61032,4311040
1612,dsyer,216,0.00501,3561580,82.61533,4311040
1613,rojkov,216,0.00501,3561796,82.62034,4311040
1614,gnossen,215,0.00499,3562011,82.62533,4311040
1615,huang-jy,215,0.00499,3562226,82.63032,4311040
1616,jacksontj,215,0.00499,3562441,82.63530,4311040
1617,marpaia,215,0.00499,3562656,82.64029,4311040
1618,RyanAoh,215,0.00499,3562871,82.64528,4311040
1619,snowplayfire,215,0.00499,3563086,82.65027,4311040
1620,gomesjason,214,0.00496,3563300,82.65523,4311040
1621,mnaser,214,0.00496,3563514,82.66019,4311040
1622,phsiao,214,0.00496,3563728,82.66516,4311040
1623,rajatchopra,214,0.00496,3563942,82.67012,4311040
1624,shuaijinchao,214,0.00496,3564156,82.67509,4311040
1625,valaparthvi,214,0.00496,3564370,82.68005,4311040
1626,haoruan,213,0.00494,3564583,82.68499,4311040
1627,josiahbjorgaard,213,0.00494,3564796,82.68993,4311040
1628,saurav-agarwalla,213,0.00494,3565009,82.69487,4311040
1629,TinySong,213,0.00494,3565222,82.69981,4311040
1630,BlaineEXE,212,0.00492,3565434,82.70473,4311040
1631,tashimi,212,0.00492,3565646,82.70965,4311040
1632,angao,211,0.00489,3565857,82.71454,4311040
1633,jarrpa,211,0.00489,3566068,82.71944,4311040
1634,jyz0309,211,0.00489,3566279,82.72433,4311040
1635,mlbiam,211,0.00489,3566490,82.72923,4311040
1636,stephenfin,211,0.00489,3566701,82.73412,4311040
1637,xuzhenglun,211,0.00489,3566912,82.73901,4311040
1638,aryan9600,210,0.00487,3567122,82.74389,4311040
1639,butuzov,210,0.00487,3567332,82.74876,4311040
1640,holmsten,210,0.00487,3567542,82.75363,4311040
1641,olagacek,210,0.00487,3567752,82.75850,4311040
1642,pawbana,210,0.00487,3567962,82.76337,4311040
1643,akshaymankar,209,0.00485,3568171,82.76822,4311040
1644,ComradeProgrammer,209,0.00485,3568380,82.77307,4311040
1645,grantr,209,0.00485,3568589,82.77791,4311040
1646,lucab,209,0.00485,3568798,82.78276,4311040
1647,nikinath,209,0.00485,3569007,82.78761,4311040
1648,poothia,209,0.00485,3569216,82.79246,4311040
1649,tylerschultz,209,0.00485,3569425,82.79731,4311040
1650,coolguyhong,208,0.00482,3569633,82.80213,4311040
1651,itskingori,208,0.00482,3569841,82.80696,4311040
1652,pranav-pandey0804,208,0.00482,3570049,82.81178,4311040
1653,sanchezl,208,0.00482,3570257,82.81661,4311040
1654,adityakali,207,0.00480,3570464,82.82141,4311040
1655,JohnRusk,207,0.00480,3570671,82.82621,4311040
1656,MaysaMacedo,207,0.00480,3570878,82.83101,4311040
1657,prometherion,207,0.00480,3571085,82.83581,4311040
1658,raesene,207,0.00480,3571292,82.84061,4311040
1659,SaiHarshaK,207,0.00480,3571499,82.84542,4311040
1660,zgfh,207,0.00480,3571706,82.85022,4311040
1661,bhack,206,0.00478,3571912,82.85500,4311040
1662,davidxia,206,0.00478,3572118,82.85977,4311040
1663,jrsapi,206,0.00478,3572324,82.86455,4311040
1664,kgrygiel,206,0.00478,3572530,82.86933,4311040
1665,mauilion,206,0.00478,3572736,82.87411,4311040
1666,sarveshkaushal,206,0.00478,3572942,82.87889,4311040
1667,ttakahashi21,206,0.00478,3573148,82.88367,4311040
1668,Argh4k,205,0.00476,3573353,82.88842,4311040
1669,mark-church,205,0.00476,3573558,82.89318,4311040
1670,TristonianJones,205,0.00476,3573763,82.89793,4311040
1671,woodcockjosh,205,0.00476,3573968,82.90269,4311040
1672,dankohn,204,0.00473,3574172,82.90742,4311040
1673,darkowlzz,203,0.00471,3574375,82.91213,4311040
1674,princepereira,202,0.00469,3574577,82.91681,4311040
1675,ajitak,201,0.00466,3574778,82.92148,4311040
1676,chalin,201,0.00466,3574979,82.92614,4311040
1677,lixiaobing1,201,0.00466,3575180,82.93080,4311040
1678,pigmej,201,0.00466,3575381,82.93546,4311040
1679,huangjiuyuan,200,0.00464,3575581,82.94010,4311040
1680,JiaoDean,200,0.00464,3575781,82.94474,4311040
1681,MalloZup,200,0.00464,3575981,82.94938,4311040
1682,abursavich,199,0.00462,3576180,82.95400,4311040
1683,craiglpeters,199,0.00462,3576379,82.95861,4311040
1684,dhawal55,199,0.00462,3576578,82.96323,4311040
1685,doublerr,199,0.00462,3576777,82.96785,4311040
1686,obnoxxx,199,0.00462,3576976,82.97246,4311040
1687,cbf123,198,0.00459,3577174,82.97705,4311040
1688,jkroepke,198,0.00459,3577372,82.98165,4311040
1689,jorge07,198,0.00459,3577570,82.98624,4311040
1690,npinaeva,198,0.00459,3577768,82.99083,4311040
1691,Sn0rt,198,0.00459,3577966,82.99543,4311040
1692,AlexNPavel,197,0.00457,3578163,83.00000,4311040
1693,chrisdoherty4,197,0.00457,3578360,83.00457,4311040
1694,ipuustin,197,0.00457,3578557,83.00913,4311040
1695,rdodev,197,0.00457,3578754,83.01370,4311040
1696,techtonik,197,0.00457,3578951,83.01827,4311040
1697,afirth,196,0.00455,3579147,83.02282,4311040
1698,mmerkes,196,0.00455,3579343,83.02737,4311040
1699,Aresforchina,195,0.00452,3579538,83.03189,4311040
1700,FengyunPan2,195,0.00452,3579733,83.03641,4311040
1701,maelk,195,0.00452,3579928,83.04094,4311040
1702,mjlshen,195,0.00452,3580123,83.04546,4311040
1703,nyaxt,195,0.00452,3580318,83.04998,4311040
1704,xialonglee,195,0.00452,3580513,83.05451,4311040
1705,zhangguanzhang,195,0.00452,3580708,83.05903,4311040
1706,Potapy4,194,0.00450,3580902,83.06353,4311040
1707,jackkleeman,193,0.00448,3581095,83.06801,4311040
1708,magicwang-cn,193,0.00448,3581288,83.07248,4311040
1709,medmedchiheb,193,0.00448,3581481,83.07696,4311040
1710,mazzy89,192,0.00445,3581673,83.08141,4311040
1711,nirarg,192,0.00445,3581865,83.08587,4311040
1712,ShivamTyagi12345,192,0.00445,3582057,83.09032,4311040
1713,sstarcher,192,0.00445,3582249,83.09478,4311040
1714,tuminoid,192,0.00445,3582441,83.09923,4311040
1715,yu-kasuya,192,0.00445,3582633,83.10368,4311040
1716,aartij17,191,0.00443,3582824,83.10811,4311040
1717,fedepaol,191,0.00443,3583015,83.11254,4311040
1718,jonschoning,191,0.00443,3583206,83.11697,4311040
1719,sjug,191,0.00443,3583397,83.12140,4311040
1720,chancez,190,0.00441,3583587,83.12581,4311040
1721,jellonek,190,0.00441,3583777,83.13022,4311040
1722,jjhuff,190,0.00441,3583967,83.13463,4311040
1723,MarcusNoble,190,0.00441,3584157,83.13903,4311040
1724,qiutongs,190,0.00441,3584347,83.14344,4311040
1725,ringtail,190,0.00441,3584537,83.14785,4311040
1726,weinong,190,0.00441,3584727,83.15226,4311040
1727,z1cheng,190,0.00441,3584917,83.15666,4311040
1728,chr15p,189,0.00438,3585106,83.16105,4311040
1729,jimmycuadra,189,0.00438,3585295,83.16543,4311040
1730,lovejoy,189,0.00438,3585484,83.16982,4311040
1731,obitech,189,0.00438,3585673,83.17420,4311040
1732,samos123,189,0.00438,3585862,83.17858,4311040
1733,shavidissa,189,0.00438,3586051,83.18297,4311040
1734,xiaosuiba,189,0.00438,3586240,83.18735,4311040
1735,whites11,188,0.00436,3586428,83.19171,4311040
1736,yashvardhan-kukreja,188,0.00436,3586616,83.19607,4311040
1737,lledru,187,0.00434,3586803,83.20041,4311040
1738,msedzins,187,0.00434,3586990,83.20475,4311040
1739,simonswine,187,0.00434,3587177,83.20909,4311040
1740,Smana,187,0.00434,3587364,83.21342,4311040
1741,gabbifish,186,0.00431,3587550,83.21774,4311040
1742,Haleygo,186,0.00431,3587736,83.22205,4311040
1743,michaelkolber,186,0.00431,3587922,83.22637,4311040
1744,okartau,186,0.00431,3588108,83.23068,4311040
1745,sadysnaat,186,0.00431,3588294,83.23500,4311040
1746,smileusd,186,0.00431,3588480,83.23931,4311040
1747,felipejfc,185,0.00429,3588665,83.24360,4311040
1748,josh-ferrell,185,0.00429,3588850,83.24789,4311040
1749,AllenZMC,184,0.00427,3589034,83.25216,4311040
1750,Bubblemelon,184,0.00427,3589218,83.25643,4311040
1751,CKchen0726,184,0.00427,3589402,83.26070,4311040
1752,Divya063,184,0.00427,3589586,83.26497,4311040
1753,eero-t,184,0.00427,3589770,83.26923,4311040
1754,H13m0n,184,0.00427,3589954,83.27350,4311040
1755,hfzqls,184,0.00427,3590138,83.27777,4311040
1756,oussemos,184,0.00427,3590322,83.28204,4311040
1757,qabpea,184,0.00427,3590506,83.28631,4311040
1758,rajula96reddy,184,0.00427,3590690,83.29057,4311040
1759,tangwz,184,0.00427,3590874,83.29484,4311040
1760,Bessonov,183,0.00424,3591057,83.29909,4311040
1761,dbenque,183,0.00424,3591240,83.30333,4311040
1762,macsux,183,0.00424,3591423,83.30758,4311040
1763,max-rocket-internet,183,0.00424,3591606,83.31182,4311040
1764,nicks,183,0.00424,3591789,83.31607,4311040
1765,rhcarvalho,183,0.00424,3591972,83.32031,4311040
1766,ionutbalutoiu,182,0.00422,3592154,83.32453,4311040
1767,jsoref,182,0.00422,3592336,83.32876,4311040
1768,lsm5,182,0.00422,3592518,83.33298,4311040
1769,okamototk,182,0.00422,3592700,83.33720,4311040
1770,Serializator,182,0.00422,3592882,83.34142,4311040
1771,dagnello,181,0.00420,3593063,83.34562,4311040
1772,mirandachrist,181,0.00420,3593244,83.34982,4311040
1773,sshukun,181,0.00420,3593425,83.35402,4311040
1774,wangchen615,181,0.00420,3593606,83.35822,4311040
1775,akankshakumari393,180,0.00418,3593786,83.36239,4311040
1776,holser,180,0.00418,3593966,83.36657,4311040
1777,n0npax,180,0.00418,3594146,83.37074,4311040
1778,anusha94,179,0.00415,3594325,83.37489,4311040
1779,brtknr,179,0.00415,3594504,83.37905,4311040
1780,flyingcougar,179,0.00415,3594683,83.38320,4311040
1781,khteh,179,0.00415,3594862,83.38735,4311040
1782,knightXun,179,0.00415,3595041,83.39150,4311040
1783,kpucynski,179,0.00415,3595220,83.39565,4311040
1784,mrIncompetent,179,0.00415,3595399,83.39981,4311040
1785,phenixblue,179,0.00415,3595578,83.40396,4311040
1786,wilsonwu,179,0.00415,3595757,83.40811,4311040
1787,YuPengZTE,179,0.00415,3595936,83.41226,4311040
1788,yuvipanda,179,0.00415,3596115,83.41641,4311040
1789,atosatto,178,0.00413,3596293,83.42054,4311040
1790,ichekrygin,178,0.00413,3596471,83.42467,4311040
1791,joshbranham,178,0.00413,3596649,83.42880,4311040
1792,kensipe,178,0.00413,3596827,83.43293,4311040
1793,oilbeater,178,0.00413,3597005,83.43706,4311040
1794,zhijianli88,178,0.00413,3597183,83.44119,4311040
1795,BLasan,177,0.00411,3597360,83.44529,4311040
1796,ChiefAlexander,177,0.00411,3597537,83.44940,4311040
1797,gouyang,177,0.00411,3597714,83.45351,4311040
1798,perriea,177,0.00411,3597891,83.45761,4311040
1799,bl0m1,176,0.00408,3598067,83.46169,4311040
1800,shawnhanx,176,0.00408,3598243,83.46578,4311040
1801,xianlubird,176,0.00408,3598419,83.46986,4311040
1802,benhxy,175,0.00406,3598594,83.47392,4311040
1803,bhcleek,175,0.00406,3598769,83.47798,4311040
1804,Bobgy,175,0.00406,3598944,83.48204,4311040
1805,prydonius,175,0.00406,3599119,83.48610,4311040
1806,rothgar,175,0.00406,3599294,83.49016,4311040
1807,zhangmingld,175,0.00406,3599469,83.49421,4311040
1808,chendotjs,174,0.00404,3599643,83.49825,4311040
1809,irozzo-1A,174,0.00404,3599817,83.50229,4311040
1810,rayandas,174,0.00404,3599991,83.50632,4311040
1811,vincent-pli,174,0.00404,3600165,83.51036,4311040
1812,XsWack,174,0.00404,3600339,83.51440,4311040
1813,cezaryzukowski,173,0.00401,3600512,83.51841,4311040
1814,Dentrax,173,0.00401,3600685,83.52242,4311040
1815,geekygirldawn,173,0.00401,3600858,83.52643,4311040
1816,Iceber,173,0.00401,3601031,83.53045,4311040
1817,mikejoh,173,0.00401,3601204,83.53446,4311040
1818,pablochacin,173,0.00401,3601377,83.53847,4311040
1819,rajdeepd,173,0.00401,3601550,83.54249,4311040
1820,sanchita-07,173,0.00401,3601723,83.54650,4311040
1821,tomkerkhove,173,0.00401,3601896,83.55051,4311040
1822,davidstack,172,0.00399,3602068,83.55450,4311040
1823,MasayaAoyama,172,0.00399,3602240,83.55849,4311040
1824,psschwei,172,0.00399,3602412,83.56248,4311040
1825,wallrj,172,0.00399,3602584,83.56647,4311040
1826,ashishranjan738,171,0.00397,3602755,83.57044,4311040
1827,eriknelson,171,0.00397,3602926,83.57440,4311040
1828,mitch000001,171,0.00397,3603097,83.57837,4311040
1829,Rajat-0,171,0.00397,3603268,83.58234,4311040
1830,sandipanpanda,171,0.00397,3603439,83.58630,4311040
1831,stefwalter,171,0.00397,3603610,83.59027,4311040
1832,championshuttler,170,0.00394,3603780,83.59421,4311040
1833,chenchun,170,0.00394,3603950,83.59816,4311040
1834,claire921,170,0.00394,3604120,83.60210,4311040
1835,coder12git,170,0.00394,3604290,83.60604,4311040
1836,emaildanwilson,170,0.00394,3604460,83.60999,4311040
1837,jasonkuhrt,170,0.00394,3604630,83.61393,4311040
1838,mcshooter,170,0.00394,3604800,83.61787,4311040
1839,mtrmac,170,0.00394,3604970,83.62182,4311040
1840,openstacker,170,0.00394,3605140,83.62576,4311040
1841,vainu-arto,170,0.00394,3605310,83.62970,4311040
1842,b01901143,169,0.00392,3605479,83.63362,4311040
1843,chapsuk,169,0.00392,3605648,83.63754,4311040
1844,esigo,169,0.00392,3605817,83.64146,4311040
1845,harsh-px,169,0.00392,3605986,83.64538,4311040
1846,heybronson,169,0.00392,3606155,83.64931,4311040
1847,sambdavidson,169,0.00392,3606324,83.65323,4311040
1848,shuzokato,169,0.00392,3606493,83.65715,4311040
1849,Kashomon,168,0.00390,3606661,83.66104,4311040
1850,luomiao,168,0.00390,3606829,83.66494,4311040
1851,mook-as,168,0.00390,3606997,83.66884,4311040
1852,SD-13,168,0.00390,3607165,83.67273,4311040
1853,frodenas,167,0.00387,3607332,83.67661,4311040
1854,hrak,167,0.00387,3607499,83.68048,4311040
1855,mirake,167,0.00387,3607666,83.68435,4311040
1856,netroby,167,0.00387,3607833,83.68823,4311040
1857,supriya-premkumar,167,0.00387,3608000,83.69210,4311040
1858,uthark,167,0.00387,3608167,83.69598,4311040
1859,derekparker,166,0.00385,3608333,83.69983,4311040
1860,h4ghhh,166,0.00385,3608499,83.70368,4311040
1861,soulxu,166,0.00385,3608665,83.70753,4311040
1862,YoyinZyc,166,0.00385,3608831,83.71138,4311040
1863,zuzzas,166,0.00385,3608997,83.71523,4311040
1864,bjrara,165,0.00383,3609162,83.71906,4311040
1865,gautierdelorme,165,0.00383,3609327,83.72288,4311040
1866,ottoyiu,165,0.00383,3609492,83.72671,4311040
1867,pancernik,165,0.00383,3609657,83.73054,4311040
1868,squat,165,0.00383,3609822,83.73437,4311040
1869,jawnsy,164,0.00380,3609986,83.73817,4311040
1870,nimbinatus,164,0.00380,3610150,83.74197,4311040
1871,silasbw,164,0.00380,3610314,83.74578,4311040
1872,actions-user,163,0.00378,3610477,83.74956,4311040
1873,adammw,163,0.00378,3610640,83.75334,4311040
1874,animeshk08,163,0.00378,3610803,83.75712,4311040
1875,AWKIF,163,0.00378,3610966,83.76090,4311040
1876,mikebryant,163,0.00378,3611129,83.76468,4311040
1877,SubhasmitaSw,163,0.00378,3611292,83.76846,4311040
1878,abhay-krishna,162,0.00376,3611454,83.77222,4311040
1879,aslafy-z,162,0.00376,3611616,83.77598,4311040
1880,djzager,162,0.00376,3611778,83.77974,4311040
1881,harshavardhana,162,0.00376,3611940,83.78350,4311040
1882,macaptain,162,0.00376,3612102,83.78725,4311040
1883,piotrmiskiewicz,162,0.00376,3612264,83.79101,4311040
1884,pskrzyns,162,0.00376,3612426,83.79477,4311040
1885,SanikaGawhane,162,0.00376,3612588,83.79853,4311040
1886,weiwei04,162,0.00376,3612750,83.80228,4311040
1887,xinydev,162,0.00376,3612912,83.80604,4311040
1888,lovebaby979,161,0.00373,3613073,83.80978,4311040
1889,mohammedzee1000,161,0.00373,3613234,83.81351,4311040
1890,adampl,160,0.00371,3613394,83.81722,4311040
1891,alijahnas,160,0.00371,3613554,83.82093,4311040
1892,bhavyachoudhary,160,0.00371,3613714,83.82465,4311040
1893,coufon,160,0.00371,3613874,83.82836,4311040
1894,JorritSalverda,160,0.00371,3614034,83.83207,4311040
1895,JulienBalestra,160,0.00371,3614194,83.83578,4311040
1896,nelcy,160,0.00371,3614354,83.83949,4311040
1897,YoubingLi,160,0.00371,3614514,83.84320,4311040
1898,44past4,159,0.00369,3614673,83.84689,4311040
1899,bcbroussard,159,0.00369,3614832,83.85058,4311040
1900,hormes,159,0.00369,3614991,83.85427,4311040
1901,jgrumboe,159,0.00369,3615150,83.85796,4311040
1902,marcoceppi,159,0.00369,3615309,83.86164,4311040
1903,nitishfy,159,0.00369,3615468,83.86533,4311040
1904,aknuds1,158,0.00367,3615626,83.86900,4311040
1905,alexgervais,158,0.00367,3615784,83.87266,4311040
1906,Monokaix,158,0.00367,3615942,83.87633,4311040
1907,RyanDevlin,158,0.00367,3616100,83.87999,4311040
1908,andrewmyhre,157,0.00364,3616257,83.88363,4311040
1909,ankon,157,0.00364,3616414,83.88728,4311040
1910,anshulahuja98,157,0.00364,3616571,83.89092,4311040
1911,ashutosh887,157,0.00364,3616728,83.89456,4311040
1912,brendanburns,157,0.00364,3616885,83.89820,4311040
1913,chardch,157,0.00364,3617042,83.90184,4311040
1914,Damans227,157,0.00364,3617199,83.90548,4311040
1915,Dragoncell,157,0.00364,3617356,83.90913,4311040
1916,hvaara,157,0.00364,3617513,83.91277,4311040
1917,m-messiah,157,0.00364,3617670,83.91641,4311040
1918,tombarron,157,0.00364,3617827,83.92005,4311040
1919,edisonxiang,156,0.00362,3617983,83.92367,4311040
1920,hw-qiaolei,156,0.00362,3618139,83.92729,4311040
1921,tkellen,156,0.00362,3618295,83.93091,4311040
1922,alebedev87,155,0.00360,3618450,83.93450,4311040
1923,fabianvf,155,0.00360,3618605,83.93810,4311040
1924,gliush,155,0.00360,3618760,83.94169,4311040
1925,joonas,155,0.00360,3618915,83.94529,4311040
1926,sivchari,155,0.00360,3619070,83.94888,4311040
1927,wyyxd2017,155,0.00360,3619225,83.95248,4311040
1928,caarlos0,154,0.00357,3619379,83.95605,4311040
1929,CIPHERTron,154,0.00357,3619533,83.95962,4311040
1930,gerred,154,0.00357,3619687,83.96320,4311040
1931,ibrasho,154,0.00357,3619841,83.96677,4311040
1932,markmc,154,0.00357,3619995,83.97034,4311040
1933,rmenn,154,0.00357,3620149,83.97391,4311040
1934,sjpotter,154,0.00357,3620303,83.97749,4311040
1935,ArchiFleKs,153,0.00355,3620456,83.98103,4311040
1936,bmelville,153,0.00355,3620609,83.98458,4311040
1937,mac-chaffee,153,0.00355,3620762,83.98813,4311040
1938,nstogner,153,0.00355,3620915,83.99168,4311040
1939,sethmccombs,153,0.00355,3621068,83.99523,4311040
1940,vanou,153,0.00355,3621221,83.99878,4311040
1941,alexkursell,152,0.00353,3621373,84.00231,4311040
1942,jai,152,0.00353,3621525,84.00583,4311040
1943,sladyn98,152,0.00353,3621677,84.00936,4311040
1944,Starefossen,152,0.00353,3621829,84.01288,4311040
1945,thesuperzapper,152,0.00353,3621981,84.01641,4311040
1946,huggsboson,151,0.00350,3622132,84.01991,4311040
1947,kiwik,151,0.00350,3622283,84.02341,4311040
1948,liyanhui1228,151,0.00350,3622434,84.02692,4311040
1949,sozercan,151,0.00350,3622585,84.03042,4311040
1950,yamt,151,0.00350,3622736,84.03392,4311040
1951,zhlhahaha,151,0.00350,3622887,84.03742,4311040
1952,azhao155,150,0.00348,3623037,84.04090,4311040
1953,jcmoraisjr,150,0.00348,3623187,84.04438,4311040
1954,jpedro1992,150,0.00348,3623337,84.04786,4311040
1955,kirkonru,150,0.00348,3623487,84.05134,4311040
1956,LinshanYu,150,0.00348,3623637,84.05482,4311040
1957,raffaelespazzoli,150,0.00348,3623787,84.05830,4311040
1958,rajathagasthya,150,0.00348,3623937,84.06178,4311040
1959,yuchen-sun,150,0.00348,3624087,84.06526,4311040
1960,2uasimojo,149,0.00346,3624236,84.06872,4311040
1961,fgimenez,149,0.00346,3624385,84.07217,4311040
1962,jonathanrainer,149,0.00346,3624534,84.07563,4311040
1963,KeithTt,149,0.00346,3624683,84.07909,4311040
1964,mbruzek,149,0.00346,3624832,84.08254,4311040
1965,MPV,149,0.00346,3624981,84.08600,4311040
1966,tkulczynski,149,0.00346,3625130,84.08945,4311040
1967,DreadPirateShawn,148,0.00343,3625278,84.09289,4311040
1968,jailton,148,0.00343,3625426,84.09632,4311040
1969,JeanMertz,148,0.00343,3625574,84.09975,4311040
1970,juan-lee,148,0.00343,3625722,84.10319,4311040
1971,kenden,148,0.00343,3625870,84.10662,4311040
1972,rjeberhard,148,0.00343,3626018,84.11005,4311040
1973,sudeshsh,148,0.00343,3626166,84.11349,4311040
1974,TerryHowe,148,0.00343,3626314,84.11692,4311040
1975,928234269,147,0.00341,3626461,84.12033,4311040
1976,bacongobbler,147,0.00341,3626608,84.12374,4311040
1977,cmoulliard,147,0.00341,3626755,84.12715,4311040
1978,ms4720,147,0.00341,3626902,84.13056,4311040
1979,puja108,147,0.00341,3627049,84.13397,4311040
1980,RyanStan,147,0.00341,3627196,84.13738,4311040
1981,ScrapCodes,147,0.00341,3627343,84.14079,4311040
1982,strigazi,147,0.00341,3627490,84.14420,4311040
1983,aermakov-zalando,146,0.00339,3627636,84.14758,4311040
1984,A-Hilaly,146,0.00339,3627782,84.15097,4311040
1985,Darshnadas,146,0.00339,3627928,84.15436,4311040
1986,liubin,146,0.00339,3628074,84.15774,4311040
1987,miry,146,0.00339,3628220,84.16113,4311040
1988,noamran,146,0.00339,3628366,84.16452,4311040
1989,parul5sahoo,146,0.00339,3628512,84.16790,4311040
1990,sunny0826,146,0.00339,3628658,84.17129,4311040
1991,gottwald,145,0.00336,3628803,84.17465,4311040
1992,kopiczko,145,0.00336,3628948,84.17802,4311040
1993,primeroz,145,0.00336,3629093,84.18138,4311040
1994,ricky1993,145,0.00336,3629238,84.18474,4311040
1995,xrl,145,0.00336,3629383,84.18811,4311040
1996,cmssczy,144,0.00334,3629527,84.19145,4311040
1997,dhiller,144,0.00334,3629671,84.19479,4311040
1998,edevil,144,0.00334,3629815,84.19813,4311040
1999,Garrybest,144,0.00334,3629959,84.20147,4311040
2000,ike-ma,144,0.00334,3630103,84.20481,4311040
2001,jonathan-kosgei,144,0.00334,3630247,84.20815,4311040
2002,lsytj0413,144,0.00334,3630391,84.21149,4311040
2003,mindw,144,0.00334,3630535,84.21483,4311040
2004,MrDXY,144,0.00334,3630679,84.21817,4311040
2005,mylesagray,144,0.00334,3630823,84.22151,4311040
2006,Pluies,144,0.00334,3630967,84.22485,4311040
2007,tehcyx,144,0.00334,3631111,84.22819,4311040
2008,yiqinguo,144,0.00334,3631255,84.23153,4311040
2009,adidenko,143,0.00332,3631398,84.23485,4311040
2010,alegrey91,143,0.00332,3631541,84.23817,4311040
2011,daehyeok,143,0.00332,3631684,84.24148,4311040
2012,jpmcb,143,0.00332,3631827,84.24480,4311040
2013,mwringe,143,0.00332,3631970,84.24812,4311040
2014,PriyanshuAhlawat,143,0.00332,3632113,84.25143,4311040
2015,sayboras,143,0.00332,3632256,84.25475,4311040
2016,tatsuhiro-t,143,0.00332,3632399,84.25807,4311040
2017,uruddarraju,143,0.00332,3632542,84.26138,4311040
2018,yashbhutwala,143,0.00332,3632685,84.26470,4311040
2019,filmil,142,0.00329,3632827,84.26800,4311040
2020,rahulii,142,0.00329,3632969,84.27129,4311040
2021,rajaskakodkar,142,0.00329,3633111,84.27458,4311040
2022,silenceper,142,0.00329,3633253,84.27788,4311040
2023,suigh,142,0.00329,3633395,84.28117,4311040
2024,hyperbolic2346,141,0.00327,3633536,84.28444,4311040
2025,james-callahan,141,0.00327,3633677,84.28771,4311040
2026,joe-atzinger,141,0.00327,3633818,84.29098,4311040
2027,mcristina422,141,0.00327,3633959,84.29425,4311040
2028,MengZn,141,0.00327,3634100,84.29752,4311040
2029,mourya007,141,0.00327,3634241,84.30080,4311040
2030,pchan,141,0.00327,3634382,84.30407,4311040
2031,ramnar,141,0.00327,3634523,84.30734,4311040
2032,thandayuthapani,141,0.00327,3634664,84.31061,4311040
2033,wernight,141,0.00327,3634805,84.31388,4311040
2034,xrstf,141,0.00327,3634946,84.31715,4311040
2035,destijl,140,0.00325,3635086,84.32040,4311040
2036,elsonrodriguez,140,0.00325,3635226,84.32364,4311040
2037,halfcrazy,140,0.00325,3635366,84.32689,4311040
2038,namnx228,140,0.00325,3635506,84.33014,4311040
2039,vinny-sabatini,140,0.00325,3635646,84.33339,4311040
2040,bketelsen,139,0.00322,3635785,84.33661,4311040
2041,crandles,139,0.00322,3635924,84.33983,4311040
2042,davidkarlsen,139,0.00322,3636063,84.34306,4311040
2043,erismaster,139,0.00322,3636202,84.34628,4311040
2044,f-higashi,139,0.00322,3636341,84.34951,4311040
2045,Garima-Negi,139,0.00322,3636480,84.35273,4311040
2046,G-Harmon,139,0.00322,3636619,84.35596,4311040
2047,isaacdorfman,139,0.00322,3636758,84.35918,4311040
2048,maleck13,139,0.00322,3636897,84.36240,4311040
2049,nlandolfi,139,0.00322,3637036,84.36563,4311040
2050,ryanmcnamara,139,0.00322,3637175,84.36885,4311040
2051,umangachapagain,139,0.00322,3637314,84.37208,4311040
2052,vefimova,139,0.00322,3637453,84.37530,4311040
2053,Abhik1998,138,0.00320,3637591,84.37850,4311040
2054,aodinokov,138,0.00320,3637729,84.38170,4311040
2055,chenzhiwei,138,0.00320,3637867,84.38490,4311040
2056,jhonmike,138,0.00320,3638005,84.38811,4311040
2057,m1kola,138,0.00320,3638143,84.39131,4311040
2058,markusthoemmes,138,0.00320,3638281,84.39451,4311040
2059,mrajashree,138,0.00320,3638419,84.39771,4311040
2060,pietern,138,0.00320,3638557,84.40091,4311040
2061,wu8685,138,0.00320,3638695,84.40411,4311040
2062,dannyk81,137,0.00318,3638832,84.40729,4311040
2063,ensonic,137,0.00318,3638969,84.41047,4311040
2064,ethan-daocloud,137,0.00318,3639106,84.41364,4311040
2065,matthiasr,137,0.00318,3639243,84.41682,4311040
2066,simonleung8,137,0.00318,3639380,84.42000,4311040
2067,xigang,137,0.00318,3639517,84.42318,4311040
2068,basantsa1989,136,0.00315,3639653,84.42633,4311040
2069,chrissound,136,0.00315,3639789,84.42949,4311040
2070,devaips,136,0.00315,3639925,84.43264,4311040
2071,jeffmaury,136,0.00315,3640061,84.43580,4311040
2072,kadern0,136,0.00315,3640197,84.43895,4311040
2073,sachinkumarsingh092,136,0.00315,3640333,84.44211,4311040
2074,tmjd,136,0.00315,3640469,84.44526,4311040
2075,Aisuko,135,0.00313,3640604,84.44839,4311040
2076,brandond,135,0.00313,3640739,84.45152,4311040
2077,foxyriver,135,0.00313,3640874,84.45466,4311040
2078,hasbro17,135,0.00313,3641009,84.45779,4311040
2079,jianzzha,135,0.00313,3641144,84.46092,4311040
2080,liyuerich,135,0.00313,3641279,84.46405,4311040
2081,mmerrill3,135,0.00313,3641414,84.46718,4311040
2082,rainest,135,0.00313,3641549,84.47031,4311040
2083,sakeven,135,0.00313,3641684,84.47344,4311040
2084,tsuna,135,0.00313,3641819,84.47658,4311040
2085,ApsOps,134,0.00311,3641953,84.47968,4311040
2086,farodin91,134,0.00311,3642087,84.48279,4311040
2087,jakobmoellersap,134,0.00311,3642221,84.48590,4311040
2088,jtslear,134,0.00311,3642355,84.48901,4311040
2089,komljen,134,0.00311,3642489,84.49212,4311040
2090,m3ngyang,134,0.00311,3642623,84.49523,4311040
2091,matthchr,134,0.00311,3642757,84.49833,4311040
2092,miteshskj,134,0.00311,3642891,84.50144,4311040
2093,pcm32,134,0.00311,3643025,84.50455,4311040
2094,sameshai,134,0.00311,3643159,84.50766,4311040
2095,yeya24,134,0.00311,3643293,84.51077,4311040
2096,ytsarev,134,0.00311,3643427,84.51388,4311040
2097,antoooks,133,0.00309,3643560,84.51696,4311040
2098,databus23,133,0.00309,3643693,84.52005,4311040
2099,embano1,133,0.00309,3643826,84.52313,4311040
2100,panpan0000,133,0.00309,3643959,84.52622,4311040
2101,richardmarshall,133,0.00309,3644092,84.52930,4311040
2102,StevenACoffman,133,0.00309,3644225,84.53239,4311040
2103,yanniszark,133,0.00309,3644358,84.53547,4311040
2104,DylanBLE,132,0.00306,3644490,84.53853,4311040
2105,enriquebelarte,132,0.00306,3644622,84.54160,4311040
2106,NeilW,132,0.00306,3644754,84.54466,4311040
2107,STRRL,132,0.00306,3644886,84.54772,4311040
2108,VibhorChinda,132,0.00306,3645018,84.55078,4311040
2109,Yamagami-Takuma,132,0.00306,3645150,84.55384,4311040
2110,armstrongli,131,0.00304,3645281,84.55688,4311040
2111,chaunceyjiang,131,0.00304,3645412,84.55992,4311040
2112,Gurpartap,131,0.00304,3645543,84.56296,4311040
2113,ibihim,131,0.00304,3645674,84.56600,4311040
2114,johnwilkes,131,0.00304,3645805,84.56904,4311040
2115,kokhang,131,0.00304,3645936,84.57208,4311040
2116,mattkelly,131,0.00304,3646067,84.57511,4311040
2117,mritunjaysharma394,131,0.00304,3646198,84.57815,4311040
2118,nrb,131,0.00304,3646329,84.58119,4311040
2119,scottslowe,131,0.00304,3646460,84.58423,4311040
2120,songxiao-wang87,131,0.00304,3646591,84.58727,4311040
2121,windayski,131,0.00304,3646722,84.59031,4311040
2122,yutongz,131,0.00304,3646853,84.59335,4311040
2123,27149chen,130,0.00302,3646983,84.59636,4311040
2124,dcowden,130,0.00302,3647113,84.59938,4311040
2125,edithturn,130,0.00302,3647243,84.60239,4311040
2126,eduartua,130,0.00302,3647373,84.60541,4311040
2127,jepio,130,0.00302,3647503,84.60842,4311040
2128,mateuszlitwin,130,0.00302,3647633,84.61144,4311040
2129,mbert,130,0.00302,3647763,84.61445,4311040
2130,silveryfu,130,0.00302,3647893,84.61747,4311040
2131,vorburger,130,0.00302,3648023,84.62049,4311040
2132,willzhang,130,0.00302,3648153,84.62350,4311040
2133,kaisoz,129,0.00299,3648282,84.62649,4311040
2134,kenji-cloudnatix,129,0.00299,3648411,84.62949,4311040
2135,kwilczynski,129,0.00299,3648540,84.63248,4311040
2136,mksalawa,129,0.00299,3648669,84.63547,4311040
2137,rakshitgondwal,129,0.00299,3648798,84.63846,4311040
2138,vantuvt,129,0.00299,3648927,84.64146,4311040
2139,ahakanbaba,128,0.00297,3649055,84.64442,4311040
2140,AuraSinis,128,0.00297,3649183,84.64739,4311040
2141,fykaa,128,0.00297,3649311,84.65036,4311040
2142,kushthedude,128,0.00297,3649439,84.65333,4311040
2143,naseemkullah,128,0.00297,3649567,84.65630,4311040
2144,tizhou86,128,0.00297,3649695,84.65927,4311040
2145,TommyLike,128,0.00297,3649823,84.66224,4311040
2146,wccsama,128,0.00297,3649951,84.66521,4311040
2147,YanzhaoLi,128,0.00297,3650079,84.66818,4311040
2148,zhanw15,128,0.00297,3650207,84.67115,4311040
2149,Zheaoli,128,0.00297,3650335,84.67412,4311040
2150,agile6v,127,0.00295,3650462,84.67706,4311040
2151,ashish-jaiswar,127,0.00295,3650589,84.68001,4311040
2152,consideRatio,127,0.00295,3650716,84.68295,4311040
2153,fenglixa,127,0.00295,3650843,84.68590,4311040
2154,pieterlange,127,0.00295,3650970,84.68885,4311040
2155,robszumski,127,0.00295,3651097,84.69179,4311040
2156,toumorokoshi,127,0.00295,3651224,84.69474,4311040
2157,abhiTamrakar,126,0.00292,3651350,84.69766,4311040
2158,arunmk,126,0.00292,3651476,84.70058,4311040
2159,bilalcaliskan,126,0.00292,3651602,84.70351,4311040
2160,briantopping,126,0.00292,3651728,84.70643,4311040
2161,caiyixiang,126,0.00292,3651854,84.70935,4311040
2162,piontec,126,0.00292,3651980,84.71227,4311040
2163,vbmade2000,126,0.00292,3652106,84.71520,4311040
2164,anencore94,125,0.00290,3652231,84.71810,4311040
2165,Ark-kun,125,0.00290,3652356,84.72100,4311040
2166,ditsuke,125,0.00290,3652481,84.72389,4311040
2167,fntlnz,125,0.00290,3652606,84.72679,4311040
2168,lblackstone,125,0.00290,3652731,84.72969,4311040
2169,Madhur97,125,0.00290,3652856,84.73259,4311040
2170,realshuting,125,0.00290,3652981,84.73549,4311040
2171,xens,125,0.00290,3653106,84.73839,4311040
2172,Zyqsempai,125,0.00290,3653231,84.74129,4311040
2173,danielhelfand,124,0.00288,3653355,84.74417,4311040
2174,danninov,124,0.00288,3653479,84.74704,4311040
2175,FriedrichWilken,124,0.00288,3653603,84.74992,4311040
2176,jhohertz,124,0.00288,3653727,84.75280,4311040
2177,liucimin,124,0.00288,3653851,84.75567,4311040
2178,ludusrusso,124,0.00288,3653975,84.75855,4311040
2179,moonek,124,0.00288,3654099,84.76143,4311040
2180,nashasha1,124,0.00288,3654223,84.76430,4311040
2181,navist2020,124,0.00288,3654347,84.76718,4311040
2182,PaulFurtado,124,0.00288,3654471,84.77006,4311040
2183,roffe,124,0.00288,3654595,84.77293,4311040
2184,cchengleo,123,0.00285,3654718,84.77578,4311040
2185,cdenneen,123,0.00285,3654841,84.77864,4311040
2186,dddddai,123,0.00285,3654964,84.78149,4311040
2187,developer-guy,123,0.00285,3655087,84.78434,4311040
2188,haoshuwei,123,0.00285,3655210,84.78720,4311040
2189,jchauncey,123,0.00285,3655333,84.79005,4311040
2190,JohnTitor,123,0.00285,3655456,84.79290,4311040
2191,rafael,123,0.00285,3655579,84.79576,4311040
2192,reylejano-rxm,123,0.00285,3655702,84.79861,4311040
2193,SupriyaSirbi,123,0.00285,3655825,84.80146,4311040
2194,tony-yang,123,0.00285,3655948,84.80432,4311040
2195,viniciusbds,123,0.00285,3656071,84.80717,4311040
2196,akshitgrover,122,0.00283,3656193,84.81000,4311040
2197,astrieanna,122,0.00283,3656315,84.81283,4311040
2198,danielromlein,122,0.00283,3656437,84.81566,4311040
2199,Globegitter,122,0.00283,3656559,84.81849,4311040
2200,ihcsim,122,0.00283,3656681,84.82132,4311040
2201,JayBeale,122,0.00283,3656803,84.82415,4311040
2202,liqlin2015,122,0.00283,3656925,84.82698,4311040
2203,markllama,122,0.00283,3657047,84.82981,4311040
2204,maruina,122,0.00283,3657169,84.83264,4311040
2205,mhamdisemah,122,0.00283,3657291,84.83547,4311040
2206,nmiculinic,122,0.00283,3657413,84.83830,4311040
2207,qlijin,122,0.00283,3657535,84.84113,4311040
2208,rbtcollins,122,0.00283,3657657,84.84396,4311040
2209,sfowl,122,0.00283,3657779,84.84679,4311040
2210,shouri007,122,0.00283,3657901,84.84962,4311040
2211,slintes,122,0.00283,3658023,84.85245,4311040
2212,swastik959,122,0.00283,3658145,84.85528,4311040
2213,wasylkowski,122,0.00283,3658267,84.85811,4311040
2214,bzub,121,0.00281,3658388,84.86092,4311040
2215,Cryptophobia,121,0.00281,3658509,84.86372,4311040
2216,fancc,121,0.00281,3658630,84.86653,4311040
2217,frankfarzan,121,0.00281,3658751,84.86934,4311040
2218,iMartyn,121,0.00281,3658872,84.87214,4311040
2219,mboukhalfa,121,0.00281,3658993,84.87495,4311040
2220,mhausenblas,121,0.00281,3659114,84.87776,4311040
2221,michalschott,121,0.00281,3659235,84.88056,4311040
2222,RichardoC,121,0.00281,3659356,84.88337,4311040
2223,sbs2001,121,0.00281,3659477,84.88618,4311040
2224,scottrigby,121,0.00281,3659598,84.88898,4311040
2225,sding3,121,0.00281,3659719,84.89179,4311040
2226,sergeyshevch,121,0.00281,3659840,84.89460,4311040
2227,shashank0202,121,0.00281,3659961,84.89740,4311040
2228,slaskawi,121,0.00281,3660082,84.90021,4311040
2229,zhoumingcheng,121,0.00281,3660203,84.90302,4311040
2230,alban,120,0.00278,3660323,84.90580,4311040
2231,dinever,120,0.00278,3660443,84.90858,4311040
2232,evillgenius75,120,0.00278,3660563,84.91137,4311040
2233,hobti01,120,0.00278,3660683,84.91415,4311040
2234,laverya,120,0.00278,3660803,84.91693,4311040
2235,mattf,120,0.00278,3660923,84.91972,4311040
2236,pokoli,120,0.00278,3661043,84.92250,4311040
2237,ravilr,120,0.00278,3661163,84.92528,4311040
2238,travisghansen,120,0.00278,3661283,84.92807,4311040
2239,wanghh2000,120,0.00278,3661403,84.93085,4311040
2240,yurrriq,120,0.00278,3661523,84.93364,4311040
2241,11janci,119,0.00276,3661642,84.93640,4311040
2242,alena1108,119,0.00276,3661761,84.93916,4311040
2243,anthonydahanne,119,0.00276,3661880,84.94192,4311040
2244,daniel-hutao,119,0.00276,3661999,84.94468,4311040
2245,ianlewis,119,0.00276,3662118,84.94744,4311040
2246,jralmaraz,119,0.00276,3662237,84.95020,4311040
2247,mikeshng,119,0.00276,3662356,84.95296,4311040
2248,saiyan86,119,0.00276,3662475,84.95572,4311040
2249,sub-mod,119,0.00276,3662594,84.95848,4311040
2250,cartyc,118,0.00274,3662712,84.96122,4311040
2251,Dm3Ch,118,0.00274,3662830,84.96395,4311040
2252,Git-Jiro,118,0.00274,3662948,84.96669,4311040
2253,gtirloni,118,0.00274,3663066,84.96943,4311040
2254,hardikdr,118,0.00274,3663184,84.97216,4311040
2255,kadisi,118,0.00274,3663302,84.97490,4311040
2256,mightyguava,118,0.00274,3663420,84.97764,4311040
2257,rajibmitra,118,0.00274,3663538,84.98038,4311040
2258,shyamradhakrishnan,118,0.00274,3663656,84.98311,4311040
2259,stephenrlouie,118,0.00274,3663774,84.98585,4311040
2260,toredash,118,0.00274,3663892,84.98859,4311040
2261,wwentland,118,0.00274,3664010,84.99132,4311040
2262,aglitke,117,0.00271,3664127,84.99404,4311040
2263,frankgreco,117,0.00271,3664244,84.99675,4311040
2264,HongjiangHuang,117,0.00271,3664361,84.99947,4311040
2265,hs0210,117,0.00271,3664478,85.00218,4311040
2266,jagosan,117,0.00271,3664595,85.00489,4311040
2267,jrnt30,117,0.00271,3664712,85.00761,4311040
2268,moshevayner,117,0.00271,3664829,85.01032,4311040
2269,qianlei90,117,0.00271,3664946,85.01304,4311040
2270,romlein,117,0.00271,3665063,85.01575,4311040
2271,tech-geek29,117,0.00271,3665180,85.01846,4311040
2272,tparikh,117,0.00271,3665297,85.02118,4311040
2273,vielmetti,117,0.00271,3665414,85.02389,4311040
2274,aarnaud,116,0.00269,3665530,85.02658,4311040
2275,abitrolly,116,0.00269,3665646,85.02927,4311040
2276,bmoyles0117,116,0.00269,3665762,85.03196,4311040
2277,celanthe,116,0.00269,3665878,85.03466,4311040
2278,quinton-hoole-2,116,0.00269,3665994,85.03735,4311040
2279,ReSearchITEng,116,0.00269,3666110,85.04004,4311040
2280,tintoy,116,0.00269,3666226,85.04273,4311040
2281,wgahnagl,116,0.00269,3666342,85.04542,4311040
2282,wwgfhf,116,0.00269,3666458,85.04811,4311040
2283,agonzalezro,115,0.00267,3666573,85.05078,4311040
2284,avalluri,115,0.00267,3666688,85.05344,4311040
2285,davidgamero,115,0.00267,3666803,85.05611,4311040
2286,Draveness,115,0.00267,3666918,85.05878,4311040
2287,jmhbnz,115,0.00267,3667033,85.06145,4311040
2288,linzichang,115,0.00267,3667148,85.06411,4311040
2289,nguyenkndinh,115,0.00267,3667263,85.06678,4311040
2290,ricolin,115,0.00267,3667378,85.06945,4311040
2291,scjane,115,0.00267,3667493,85.07212,4311040
2292,tuxtof,115,0.00267,3667608,85.07478,4311040
2293,ecordell,114,0.00264,3667722,85.07743,4311040
2294,galexrt,114,0.00264,3667836,85.08007,4311040
2295,int128,114,0.00264,3667950,85.08272,4311040
2296,konryd,114,0.00264,3668064,85.08536,4311040
2297,ledroide,114,0.00264,3668178,85.08801,4311040
2298,njuicsgz,114,0.00264,3668292,85.09065,4311040
2299,pnovotnak,114,0.00264,3668406,85.09330,4311040
2300,Porges,114,0.00264,3668520,85.09594,4311040
2301,rewanth1997,114,0.00264,3668634,85.09858,4311040
2302,rkojedzinszky,114,0.00264,3668748,85.10123,4311040
2303,ruifaling,114,0.00264,3668862,85.10387,4311040
2304,smreed,114,0.00264,3668976,85.10652,4311040
2305,staticdev,114,0.00264,3669090,85.10916,4311040
2306,tazjin,114,0.00264,3669204,85.11181,4311040
2307,calvin0327,113,0.00262,3669317,85.11443,4311040
2308,dharmab,113,0.00262,3669430,85.11705,4311040
2309,donbowman,113,0.00262,3669543,85.11967,4311040
2310,jlamillan,113,0.00262,3669656,85.12229,4311040
2311,kashifest,113,0.00262,3669769,85.12491,4311040
2312,kdada,113,0.00262,3669882,85.12753,4311040
2313,khrisrichardson,113,0.00262,3669995,85.13015,4311040
2314,zroubalik,113,0.00262,3670108,85.13278,4311040
2315,ajatprabha,112,0.00260,3670220,85.13537,4311040
2316,arkbriar,112,0.00260,3670332,85.13797,4311040
2317,hoskeri,112,0.00260,3670444,85.14057,4311040
2318,liangchenye,112,0.00260,3670556,85.14317,4311040
2319,marcushyungseoklee,112,0.00260,3670668,85.14577,4311040
2320,MeinhardZhou,112,0.00260,3670780,85.14836,4311040
2321,mkulke,112,0.00260,3670892,85.15096,4311040
2322,nayihz,112,0.00260,3671004,85.15356,4311040
2323,sadlil,112,0.00260,3671116,85.15616,4311040
2324,srampal,112,0.00260,3671228,85.15876,4311040
2325,zhaojizhuang,112,0.00260,3671340,85.16135,4311040
2326,AntonioMeireles,111,0.00257,3671451,85.16393,4311040
2327,austbot,111,0.00257,3671562,85.16650,4311040
2328,fengjingchao,111,0.00257,3671673,85.16908,4311040
2329,GunaKKIBM,111,0.00257,3671784,85.17165,4311040
2330,gurvindersingh,111,0.00257,3671895,85.17423,4311040
2331,igorpeshansky,111,0.00257,3672006,85.17680,4311040
2332,kassarl,111,0.00257,3672117,85.17938,4311040
2333,larivierec,111,0.00257,3672228,85.18195,4311040
2334,ostromart,111,0.00257,3672339,85.18453,4311040
2335,stafot,111,0.00257,3672450,85.18710,4311040
2336,carlisia,110,0.00255,3672560,85.18965,4311040
2337,dr0pdb,110,0.00255,3672670,85.19220,4311040
2338,elementyang,110,0.00255,3672780,85.19476,4311040
2339,glo-pena,110,0.00255,3672890,85.19731,4311040
2340,gtank,110,0.00255,3673000,85.19986,4311040
2341,hanikesn,110,0.00255,3673110,85.20241,4311040
2342,JacobTanenbaum,110,0.00255,3673220,85.20496,4311040
2343,lvlv,110,0.00255,3673330,85.20751,4311040
2344,morvencao,110,0.00255,3673440,85.21007,4311040
2345,silenceshell,110,0.00255,3673550,85.21262,4311040
2346,verwilst,110,0.00255,3673660,85.21517,4311040
2347,abdennour,109,0.00253,3673769,85.21770,4311040
2348,CallMeFoxie,109,0.00253,3673878,85.22023,4311040
2349,caruccio,109,0.00253,3673987,85.22275,4311040
2350,chrisleck,109,0.00253,3674096,85.22528,4311040
2351,d-kuro,109,0.00253,3674205,85.22781,4311040
2352,eratnch,109,0.00253,3674314,85.23034,4311040
2353,fuweid,109,0.00253,3674423,85.23287,4311040
2354,jasonbrooks,109,0.00253,3674532,85.23540,4311040
2355,nickchase,109,0.00253,3674641,85.23792,4311040
2356,rbitia,109,0.00253,3674750,85.24045,4311040
2357,roytman,109,0.00253,3674859,85.24298,4311040
2358,takaf04,109,0.00253,3674968,85.24551,4311040
2359,tsandall,109,0.00253,3675077,85.24804,4311040
2360,yuyiying,109,0.00253,3675186,85.25057,4311040
2361,briantkennedy,108,0.00251,3675294,85.25307,4311040
2362,clamoriniere,108,0.00251,3675402,85.25558,4311040
2363,croomes,108,0.00251,3675510,85.25808,4311040
2364,kenan435,108,0.00251,3675618,85.26059,4311040
2365,oulinbao,108,0.00251,3675726,85.26309,4311040
2366,patsevanton,108,0.00251,3675834,85.26560,4311040
2367,qedrakmar,108,0.00251,3675942,85.26810,4311040
2368,rthallisey,108,0.00251,3676050,85.27061,4311040
2369,AartiJivrajani,107,0.00248,3676157,85.27309,4311040
2370,foxylion,107,0.00248,3676264,85.27557,4311040
2371,GeoBK,107,0.00248,3676371,85.27805,4311040
2372,hello2mao,107,0.00248,3676478,85.28054,4311040
2373,hikkie3110,107,0.00248,3676585,85.28302,4311040
2374,jaehnri,107,0.00248,3676692,85.28550,4311040
2375,jeffbean,107,0.00248,3676799,85.28798,4311040
2376,jiachengxu,107,0.00248,3676906,85.29046,4311040
2377,orainxiong,107,0.00248,3677013,85.29295,4311040
2378,osherdp,107,0.00248,3677120,85.29543,4311040
2379,rlarocque2,107,0.00248,3677227,85.29791,4311040
2380,vinu2003,107,0.00248,3677334,85.30039,4311040
2381,willthames,107,0.00248,3677441,85.30287,4311040
2382,AryanSharma9917,106,0.00246,3677547,85.30533,4311040
2383,chemikadze,106,0.00246,3677653,85.30779,4311040
2384,gamba47,106,0.00246,3677759,85.31025,4311040
2385,gliptak,106,0.00246,3677865,85.31271,4311040
2386,GrigoriyMikhalkin,106,0.00246,3677971,85.31517,4311040
2387,iXinqi,106,0.00246,3678077,85.31763,4311040
2388,muzi502,106,0.00246,3678183,85.32009,4311040
2389,nishipy,106,0.00246,3678289,85.32254,4311040
2390,ptabor,106,0.00246,3678395,85.32500,4311040
2391,sdowell,106,0.00246,3678501,85.32746,4311040
2392,alonyb,105,0.00244,3678606,85.32990,4311040
2393,ashetty1,105,0.00244,3678711,85.33233,4311040
2394,cpuguy83,105,0.00244,3678816,85.33477,4311040
2395,farcaller,105,0.00244,3678921,85.33720,4311040
2396,iranzo,105,0.00244,3679026,85.33964,4311040
2397,JiangtianLi,105,0.00244,3679131,85.34208,4311040
2398,jonasrosland,105,0.00244,3679236,85.34451,4311040
2399,KarolKraskiewicz,105,0.00244,3679341,85.34695,4311040
2400,KKtheGhost,105,0.00244,3679446,85.34938,4311040
2401,Nefelim4ag,105,0.00244,3679551,85.35182,4311040
2402,nlamirault,105,0.00244,3679656,85.35425,4311040
2403,tombokombo,105,0.00244,3679761,85.35669,4311040
2404,xychu,105,0.00244,3679866,85.35912,4311040
2405,ymmt2005,105,0.00244,3679971,85.36156,4311040
2406,carlosedp,104,0.00241,3680075,85.36397,4311040
2407,cosmincojocar,104,0.00241,3680179,85.36638,4311040
2408,iT2afL0rd,104,0.00241,3680283,85.36880,4311040
2409,jmillikin-stripe,104,0.00241,3680387,85.37121,4311040
2410,kazegusuri,104,0.00241,3680491,85.37362,4311040
2411,matthias50,104,0.00241,3680595,85.37603,4311040
2412,MaXinjian,104,0.00241,3680699,85.37845,4311040
2413,rmb938,104,0.00241,3680803,85.38086,4311040
2414,seanknox,104,0.00241,3680907,85.38327,4311040
2415,shamil,104,0.00241,3681011,85.38568,4311040
2416,Treenhan,104,0.00241,3681115,85.38810,4311040
2417,edouardKaiser,103,0.00239,3681218,85.39049,4311040
2418,fate-grand-order,103,0.00239,3681321,85.39288,4311040
2419,iancoolidge,103,0.00239,3681424,85.39526,4311040
2420,jklaw90,103,0.00239,3681527,85.39765,4311040
2421,k0da,103,0.00239,3681630,85.40004,4311040
2422,kbeecher,103,0.00239,3681733,85.40243,4311040
2423,lou-lan,103,0.00239,3681836,85.40482,4311040
2424,Morriz,103,0.00239,3681939,85.40721,4311040
2425,sunlintong,103,0.00239,3682042,85.40960,4311040
2426,TamalSaha,103,0.00239,3682145,85.41199,4311040
2427,titilambert,103,0.00239,3682248,85.41438,4311040
2428,vfreex,103,0.00239,3682351,85.41677,4311040
2429,avoidik,102,0.00237,3682453,85.41913,4311040
2430,catblade,102,0.00237,3682555,85.42150,4311040
2431,gaocegege,102,0.00237,3682657,85.42387,4311040
2432,innovia,102,0.00237,3682759,85.42623,4311040
2433,kshafiee,102,0.00237,3682861,85.42860,4311040
2434,lobziik,102,0.00237,3682963,85.43096,4311040
2435,qw1mb0,102,0.00237,3683065,85.43333,4311040
2436,WillemMali,102,0.00237,3683167,85.43570,4311040
2437,zegl,102,0.00237,3683269,85.43806,4311040
2438,AlainRoy,101,0.00234,3683370,85.44040,4311040
2439,bryantbiggs,101,0.00234,3683471,85.44275,4311040
2440,dustymabe,101,0.00234,3683572,85.44509,4311040
2441,h0tbird,101,0.00234,3683673,85.44743,4311040
2442,jcassee,101,0.00234,3683774,85.44978,4311040
2443,jimdaga,101,0.00234,3683875,85.45212,4311040
2444,jiulongzaitian,101,0.00234,3683976,85.45446,4311040
2445,jurgenweber,101,0.00234,3684077,85.45680,4311040
2446,kmuto,101,0.00234,3684178,85.45915,4311040
2447,MaxFedotov,101,0.00234,3684279,85.46149,4311040
2448,MeenuyD,101,0.00234,3684380,85.46383,4311040
2449,Spazzy757,101,0.00234,3684481,85.46618,4311040
2450,brasmith-ms,100,0.00232,3684581,85.46849,4311040
2451,clyang82,100,0.00232,3684681,85.47081,4311040
2452,dolftax,100,0.00232,3684781,85.47313,4311040
2453,gosharplite,100,0.00232,3684881,85.47545,4311040
2454,ijc,100,0.00232,3684981,85.47777,4311040
2455,jbpratt,100,0.00232,3685081,85.48009,4311040
2456,llamahunter,100,0.00232,3685181,85.48241,4311040
2457,lukehinds,100,0.00232,3685281,85.48473,4311040
2458,rsokolowski,100,0.00232,3685381,85.48705,4311040
2459,scollier,100,0.00232,3685481,85.48937,4311040
2460,suyogbarve,100,0.00232,3685581,85.49169,4311040
2461,VirrageS,100,0.00232,3685681,85.49401,4311040
2462,viviyww,100,0.00232,3685781,85.49633,4311040
2463,zoidbergwill,100,0.00232,3685881,85.49865,4311040
2464,aiyijing,99,0.00230,3685980,85.50095,4311040
2465,austinmoore-,99,0.00230,3686079,85.50324,4311040
2466,darkn3rd,99,0.00230,3686178,85.50554,4311040
2467,ghostsquad,99,0.00230,3686277,85.50784,4311040
2468,hj-johannes-lee,99,0.00230,3686376,85.51013,4311040
2469,jzhupup,99,0.00230,3686475,85.51243,4311040
2470,lorenz,99,0.00230,3686574,85.51472,4311040
2471,mithrav,99,0.00230,3686673,85.51702,4311040
2472,Praveenrajmani,99,0.00230,3686772,85.51932,4311040
2473,PurneswarPrasad,99,0.00230,3686871,85.52161,4311040
2474,sfzylad,99,0.00230,3686970,85.52391,4311040
2475,spothanis,99,0.00230,3687069,85.52621,4311040
2476,adityadani,98,0.00227,3687167,85.52848,4311040
2477,bobbyrullo,98,0.00227,3687265,85.53075,4311040
2478,bradhoekstra,98,0.00227,3687363,85.53303,4311040
2479,busser,98,0.00227,3687461,85.53530,4311040
2480,czybjtu,98,0.00227,3687559,85.53757,4311040
2481,dmathieu,98,0.00227,3687657,85.53985,4311040
2482,huguesalary,98,0.00227,3687755,85.54212,4311040
2483,huynguyennovem,98,0.00227,3687853,85.54439,4311040
2484,jessehu,98,0.00227,3687951,85.54667,4311040
2485,julia-stripe,98,0.00227,3688049,85.54894,4311040
2486,like-inspur,98,0.00227,3688147,85.55121,4311040
2487,mikebz,98,0.00227,3688245,85.55349,4311040
2488,ncopa,98,0.00227,3688343,85.55576,4311040
2489,PiotrDabkowski,98,0.00227,3688441,85.55803,4311040
2490,rawkode,98,0.00227,3688539,85.56031,4311040
2491,rkamudhan,98,0.00227,3688637,85.56258,4311040
2492,rumstead,98,0.00227,3688735,85.56485,4311040
2493,shadycuz,98,0.00227,3688833,85.56713,4311040
2494,tharun208,98,0.00227,3688931,85.56940,4311040
2495,wstrange,98,0.00227,3689029,85.57167,4311040
2496,yarntime,98,0.00227,3689127,85.57395,4311040
2497,alexlarsson,97,0.00225,3689224,85.57620,4311040
2498,ayushpateria,97,0.00225,3689321,85.57845,4311040
2499,bsteciuk,97,0.00225,3689418,85.58070,4311040
2500,coulof,97,0.00225,3689515,85.58295,4311040
2501,drmorr0,97,0.00225,3689612,85.58520,4311040
2502,GheRivero,97,0.00225,3689709,85.58745,4311040
2503,haripriya9647,97,0.00225,3689806,85.58970,4311040
2504,hiyokotaisa,97,0.00225,3689903,85.59195,4311040
2505,kciredor,97,0.00225,3690000,85.59420,4311040
2506,MQasimSarfraz,97,0.00225,3690097,85.59645,4311040
2507,reegnz,97,0.00225,3690194,85.59870,4311040
2508,Sharpz7,97,0.00225,3690291,85.60095,4311040
2509,sigma,97,0.00225,3690388,85.60320,4311040
2510,victorgp,97,0.00225,3690485,85.60545,4311040
2511,binchenX,96,0.00223,3690581,85.60767,4311040
2512,cgwalters,96,0.00223,3690677,85.60990,4311040
2513,cristiklein,96,0.00223,3690773,85.61213,4311040
2514,hodovska,96,0.00223,3690869,85.61435,4311040
2515,inercia,96,0.00223,3690965,85.61658,4311040
2516,jeremyd,96,0.00223,3691061,85.61881,4311040
2517,QiWang19,96,0.00223,3691157,85.62103,4311040
2518,sandys,96,0.00223,3691253,85.62326,4311040
2519,wangxiyuan,96,0.00223,3691349,85.62549,4311040
2520,wenjun93,96,0.00223,3691445,85.62771,4311040
2521,asm582,95,0.00220,3691540,85.62992,4311040
2522,burmanm,95,0.00220,3691635,85.63212,4311040
2523,gjcarneiro,95,0.00220,3691730,85.63432,4311040
2524,jcpunk,95,0.00220,3691825,85.63653,4311040
2525,Jerry-Ge,95,0.00220,3691920,85.63873,4311040
2526,KlavsKlavsen,95,0.00220,3692015,85.64094,4311040
2527,MnrGreg,95,0.00220,3692110,85.64314,4311040
2528,murali-reddy,95,0.00220,3692205,85.64534,4311040
2529,presztak,95,0.00220,3692300,85.64755,4311040
2530,renukamanavalan,95,0.00220,3692395,85.64975,4311040
2531,rimusz,95,0.00220,3692490,85.65195,4311040
2532,whypro,95,0.00220,3692585,85.65416,4311040
2533,wilmardo,95,0.00220,3692680,85.65636,4311040
2534,abansal4032,94,0.00218,3692774,85.65854,4311040
2535,alfred-huangjian,94,0.00218,3692868,85.66072,4311040
2536,Amey-D,94,0.00218,3692962,85.66290,4311040
2537,gouthampacha,94,0.00218,3693056,85.66508,4311040
2538,joshua-bone,94,0.00218,3693150,85.66726,4311040
2539,joshuacox,94,0.00218,3693244,85.66944,4311040
2540,mihivagyok,94,0.00218,3693338,85.67162,4311040
2541,nameYULI,94,0.00218,3693432,85.67380,4311040
2542,ryanzidago,94,0.00218,3693526,85.67599,4311040
2543,sfxworks,94,0.00218,3693620,85.67817,4311040
2544,vishesh92,94,0.00218,3693714,85.68035,4311040
2545,whalecold,94,0.00218,3693808,85.68253,4311040
2546,yselkowitz,94,0.00218,3693902,85.68471,4311040
2547,abhinavdahiya,93,0.00216,3693995,85.68686,4311040
2548,agilgur5,93,0.00216,3694088,85.68902,4311040
2549,bodgit,93,0.00216,3694181,85.69118,4311040
2550,cyril-corbon,93,0.00216,3694274,85.69334,4311040
2551,drbugfinder-work,93,0.00216,3694367,85.69549,4311040
2552,happinesstaker,93,0.00216,3694460,85.69765,4311040
2553,jainvipin,93,0.00216,3694553,85.69981,4311040
2554,jfoy,93,0.00216,3694646,85.70197,4311040
2555,jmhodges,93,0.00216,3694739,85.70412,4311040
2556,minbaev,93,0.00216,3694832,85.70628,4311040
2557,phyber,93,0.00216,3694925,85.70844,4311040
2558,StudyNick,93,0.00216,3695018,85.71059,4311040
2559,u2takey,93,0.00216,3695111,85.71275,4311040
2560,wayilau,93,0.00216,3695204,85.71491,4311040
2561,2opremio,92,0.00213,3695296,85.71704,4311040
2562,able8,92,0.00213,3695388,85.71918,4311040
2563,adeniyistephen,92,0.00213,3695480,85.72131,4311040
2564,ajohnstone,92,0.00213,3695572,85.72344,4311040
2565,aniket-s-kulkarni,92,0.00213,3695664,85.72558,4311040
2566,chlunde,92,0.00213,3695756,85.72771,4311040
2567,dmvolod,92,0.00213,3695848,85.72985,4311040
2568,dvaldivia,92,0.00213,3695940,85.73198,4311040
2569,eminaktas,92,0.00213,3696032,85.73412,4311040
2570,Evesy,92,0.00213,3696124,85.73625,4311040
2571,hanumanthan,92,0.00213,3696216,85.73838,4311040
2572,jglick,92,0.00213,3696308,85.74052,4311040
2573,jijiew,92,0.00213,3696400,85.74265,4311040
2574,KielChan,92,0.00213,3696492,85.74479,4311040
2575,lzang,92,0.00213,3696584,85.74692,4311040
2576,mra-ruiz,92,0.00213,3696676,85.74905,4311040
2577,olalonde,92,0.00213,3696768,85.75119,4311040
2578,shenlanse,92,0.00213,3696860,85.75332,4311040
2579,terinjokes,92,0.00213,3696952,85.75546,4311040
2580,vhosakot,92,0.00213,3697044,85.75759,4311040
2581,wattsteve,92,0.00213,3697136,85.75972,4311040
2582,andreykurilin,91,0.00211,3697227,85.76183,4311040
2583,antoninbas,91,0.00211,3697318,85.76395,4311040
2584,Dean-Coakley,91,0.00211,3697409,85.76606,4311040
2585,dtaniwaki,91,0.00211,3697500,85.76817,4311040
2586,fanux,91,0.00211,3697591,85.77028,4311040
2587,gonzolino,91,0.00211,3697682,85.77239,4311040
2588,JoeWrightss,91,0.00211,3697773,85.77450,4311040
2589,joshmsamuels,91,0.00211,3697864,85.77661,4311040
2590,Mashimiao,91,0.00211,3697955,85.77872,4311040
2591,maxlaverse,91,0.00211,3698046,85.78083,4311040
2592,mayocream,91,0.00211,3698137,85.78294,4311040
2593,pierreozoux,91,0.00211,3698228,85.78505,4311040
2594,tsaarni,91,0.00211,3698319,85.78717,4311040
2595,ainmosni,90,0.00209,3698409,85.78925,4311040
2596,Dmitry1987,90,0.00209,3698499,85.79134,4311040
2597,FrenchBen,90,0.00209,3698589,85.79343,4311040
2598,karenhchu,90,0.00209,3698679,85.79552,4311040
2599,kosehy,90,0.00209,3698769,85.79760,4311040
2600,krunaljain,90,0.00209,3698859,85.79969,4311040
2601,maclof,90,0.00209,3698949,85.80178,4311040
2602,metal3d,90,0.00209,3699039,85.80387,4311040
2603,miff2000,90,0.00209,3699129,85.80595,4311040
2604,onsi,90,0.00209,3699219,85.80804,4311040
2605,povsister,90,0.00209,3699309,85.81013,4311040
2606,ragnard,90,0.00209,3699399,85.81222,4311040
2607,tgelter,90,0.00209,3699489,85.81430,4311040
2608,wwwtyro,90,0.00209,3699579,85.81639,4311040
2609,xrmzju,90,0.00209,3699669,85.81848,4311040
2610,ArchangelSDY,89,0.00206,3699758,85.82054,4311040
2611,ceshihao,89,0.00206,3699847,85.82261,4311040
2612,cheyang,89,0.00206,3699936,85.82467,4311040
2613,davideimola,89,0.00206,3700025,85.82674,4311040
2614,grzesuav,89,0.00206,3700114,85.82880,4311040
2615,HecarimV,89,0.00206,3700203,85.83087,4311040
2616,louyihua,89,0.00206,3700292,85.83293,4311040
2617,magicsong,89,0.00206,3700381,85.83500,4311040
2618,mxey,89,0.00206,3700470,85.83706,4311040
2619,sc68cal,89,0.00206,3700559,85.83912,4311040
2620,Shnatsel,89,0.00206,3700648,85.84119,4311040
2621,spartacus06,89,0.00206,3700737,85.84325,4311040
2622,thaJeztah,89,0.00206,3700826,85.84532,4311040
2623,tvi,89,0.00206,3700915,85.84738,4311040
2624,zadjadr,89,0.00206,3701004,85.84945,4311040
2625,austince,88,0.00204,3701092,85.85149,4311040
2626,bharathi-tenneti,88,0.00204,3701180,85.85353,4311040
2627,bronger,88,0.00204,3701268,85.85557,4311040
2628,cathyhongzhang,88,0.00204,3701356,85.85761,4311040
2629,drinktee,88,0.00204,3701444,85.85965,4311040
2630,evalsocket,88,0.00204,3701532,85.86169,4311040
2631,furukawa3,88,0.00204,3701620,85.86374,4311040
2632,gandhipr,88,0.00204,3701708,85.86578,4311040
2633,interma,88,0.00204,3701796,85.86782,4311040
2634,kd7lxl,88,0.00204,3701884,85.86986,4311040
2635,leseb,88,0.00204,3701972,85.87190,4311040
2636,shiyan2016,88,0.00204,3702060,85.87394,4311040
2637,stantonxu,88,0.00204,3702148,85.87598,4311040
2638,varunmar,88,0.00204,3702236,85.87802,4311040
2639,WeixuZhuang,88,0.00204,3702324,85.88007,4311040
2640,wnxn,88,0.00204,3702412,85.88211,4311040
2641,ae6rt,87,0.00202,3702499,85.88413,4311040
2642,alinbalutoiu,87,0.00202,3702586,85.88614,4311040
2643,cnwalker,87,0.00202,3702673,85.88816,4311040
2644,DavidSpek,87,0.00202,3702760,85.89018,4311040
2645,discostur,87,0.00202,3702847,85.89220,4311040
2646,fudali113,87,0.00202,3702934,85.89422,4311040
2647,langyenan,87,0.00202,3703021,85.89623,4311040
2648,liangwenguo,87,0.00202,3703108,85.89825,4311040
2649,pengx17,87,0.00202,3703195,85.90027,4311040
2650,supirman,87,0.00202,3703282,85.90229,4311040
2651,uniemimu,87,0.00202,3703369,85.90431,4311040
2652,vsxen,87,0.00202,3703456,85.90632,4311040
2653,Ahmed-Aghadi,86,0.00199,3703542,85.90832,4311040
2654,ari-becker,86,0.00199,3703628,85.91031,4311040
2655,bagnaram,86,0.00199,3703714,85.91231,4311040
2656,bradmccoydev,86,0.00199,3703800,85.91430,4311040
2657,ccding,86,0.00199,3703886,85.91630,4311040
2658,cclauss,86,0.00199,3703972,85.91829,4311040
2659,FabianKramm,86,0.00199,3704058,85.92029,4311040
2660,galthaus,86,0.00199,3704144,85.92228,4311040
2661,gtaylor,86,0.00199,3704230,85.92428,4311040
2662,iciclespider,86,0.00199,3704316,85.92627,4311040
2663,jbornemann,86,0.00199,3704402,85.92827,4311040
2664,povilasv,86,0.00199,3704488,85.93026,4311040
2665,schollii,86,0.00199,3704574,85.93226,4311040
2666,seanzatzdev-amazon,86,0.00199,3704660,85.93425,4311040
2667,sunnybhambhani,86,0.00199,3704746,85.93625,4311040
2668,swghosh,86,0.00199,3704832,85.93824,4311040
2669,t0rr3sp3dr0,86,0.00199,3704918,85.94024,4311040
2670,tiloso,86,0.00199,3705004,85.94223,4311040
2671,wayt,86,0.00199,3705090,85.94423,4311040
2672,akamalov,85,0.00197,3705175,85.94620,4311040
2673,bcorijn,85,0.00197,3705260,85.94817,4311040
2674,cben,85,0.00197,3705345,85.95014,4311040
2675,danmcp,85,0.00197,3705430,85.95211,4311040
2676,drewwells,85,0.00197,3705515,85.95409,4311040
2677,guessi,85,0.00197,3705600,85.95606,4311040
2678,iwankgb,85,0.00197,3705685,85.95803,4311040
2679,jicowan,85,0.00197,3705770,85.96000,4311040
2680,jijun2,85,0.00197,3705855,85.96197,4311040
2681,jtblin,85,0.00197,3705940,85.96394,4311040
2682,kiall,85,0.00197,3706025,85.96592,4311040
2683,lack,85,0.00197,3706110,85.96789,4311040
2684,luncj,85,0.00197,3706195,85.96986,4311040
2685,michaelajr,85,0.00197,3706280,85.97183,4311040
2686,mytunguyen,85,0.00197,3706365,85.97380,4311040
2687,peay,85,0.00197,3706450,85.97577,4311040
2688,pymander,85,0.00197,3706535,85.97775,4311040
2689,Rajpratik71,85,0.00197,3706620,85.97972,4311040
2690,trierra,85,0.00197,3706705,85.98169,4311040
2691,yanghesong,85,0.00197,3706790,85.98366,4311040
2692,alex1989hu,84,0.00195,3706874,85.98561,4311040
2693,alexellis,84,0.00195,3706958,85.98756,4311040
2694,cwrau,84,0.00195,3707042,85.98951,4311040
2695,dalehamel,84,0.00195,3707126,85.99145,4311040
2696,DaviMatheus,84,0.00195,3707210,85.99340,4311040
2697,erhudy,84,0.00195,3707294,85.99535,4311040
2698,harryge00,84,0.00195,3707378,85.99730,4311040
2699,hunshcn,84,0.00195,3707462,85.99925,4311040
2700,jpds,84,0.00195,3707546,86.00120,4311040
2701,jw-s,84,0.00195,3707630,86.00315,4311040
2702,lichen2013,84,0.00195,3707714,86.00509,4311040
2703,lucacome,84,0.00195,3707798,86.00704,4311040
2704,mathu97,84,0.00195,3707882,86.00899,4311040
2705,max8899,84,0.00195,3707966,86.01094,4311040
2706,mrmcmuffinz,84,0.00195,3708050,86.01289,4311040
2707,namrata-ibm,84,0.00195,3708134,86.01484,4311040
2708,prachirp,84,0.00195,3708218,86.01678,4311040
2709,totherme,84,0.00195,3708302,86.01873,4311040
2710,towolf,84,0.00195,3708386,86.02068,4311040
2711,tydra-wang,84,0.00195,3708470,86.02263,4311040
2712,wlq1212,84,0.00195,3708554,86.02458,4311040
2713,xuhuilong,84,0.00195,3708638,86.02653,4311040
2714,zrdaley,84,0.00195,3708722,86.02848,4311040
2715,akshay196,83,0.00193,3708805,86.03040,4311040
2716,ashnehete,83,0.00193,3708888,86.03233,4311040
2717,atombender,83,0.00193,3708971,86.03425,4311040
2718,darkgaro,83,0.00193,3709054,86.03618,4311040
2719,dennisme,83,0.00193,3709137,86.03810,4311040
2720,dohnto,83,0.00193,3709220,86.04003,4311040
2721,edsantiago,83,0.00193,3709303,86.04195,4311040
2722,huangqg,83,0.00193,3709386,86.04388,4311040
2723,kidlj,83,0.00193,3709469,86.04580,4311040
2724,mauriciovasquezbernal,83,0.00193,3709552,86.04773,4311040
2725,miguelbernadi,83,0.00193,3709635,86.04965,4311040
2726,olekzabl,83,0.00193,3709718,86.05158,4311040
2727,prateekpandey14,83,0.00193,3709801,86.05350,4311040
2728,r4f4,83,0.00193,3709884,86.05543,4311040
2729,RealHarshThakur,83,0.00193,3709967,86.05736,4311040
2730,rficcaglia,83,0.00193,3710050,86.05928,4311040
2731,rodrigc,83,0.00193,3710133,86.06121,4311040
2732,sarab97,83,0.00193,3710216,86.06313,4311040
2733,thatsmydoing,83,0.00193,3710299,86.06506,4311040
2734,weikinhuang,83,0.00193,3710382,86.06698,4311040
2735,x1957,83,0.00193,3710465,86.06891,4311040
2736,artmello,82,0.00190,3710547,86.07081,4311040
2737,bakins,82,0.00190,3710629,86.07271,4311040
2738,brb,82,0.00190,3710711,86.07461,4311040
2739,chenliu1993,82,0.00190,3710793,86.07652,4311040
2740,danports,82,0.00190,3710875,86.07842,4311040
2741,dfang,82,0.00190,3710957,86.08032,4311040
2742,fujitatomoya,82,0.00190,3711039,86.08222,4311040
2743,jmcmeek,82,0.00190,3711121,86.08412,4311040
2744,johnharris85,82,0.00190,3711203,86.08603,4311040
2745,jollinshead,82,0.00190,3711285,86.08793,4311040
2746,mattlandis,82,0.00190,3711367,86.08983,4311040
2747,MIBc,82,0.00190,3711449,86.09173,4311040
2748,noqcks,82,0.00190,3711531,86.09363,4311040
2749,paulgmiller,82,0.00190,3711613,86.09554,4311040
2750,rvrignaud,82,0.00190,3711695,86.09744,4311040
2751,uroy-personal,82,0.00190,3711777,86.09934,4311040
2752,viglesiasce,82,0.00190,3711859,86.10124,4311040
2753,viveksyngh,82,0.00190,3711941,86.10314,4311040
2754,YashPimple,82,0.00190,3712023,86.10505,4311040
2755,bmcstdio,81,0.00188,3712104,86.10693,4311040
2756,caniszczyk,81,0.00188,3712185,86.10880,4311040
2757,dbonfigli,81,0.00188,3712266,86.11068,4311040
2758,e0ne,81,0.00188,3712347,86.11256,4311040
2759,elweb9858,81,0.00188,3712428,86.11444,4311040
2760,fatedier,81,0.00188,3712509,86.11632,4311040
2761,glerchundi,81,0.00188,3712590,86.11820,4311040
2762,henriquetruta,81,0.00188,3712671,86.12008,4311040
2763,hezhizhen,81,0.00188,3712752,86.12196,4311040
2764,jasiu001,81,0.00188,3712833,86.12384,4311040
2765,JESWINKNINAN,81,0.00188,3712914,86.12571,4311040
2766,joshrosso,81,0.00188,3712995,86.12759,4311040
2767,MaGaroo,81,0.00188,3713076,86.12947,4311040
2768,MAKOSCAFEE,81,0.00188,3713157,86.13135,4311040
2769,micnncim,81,0.00188,3713238,86.13323,4311040
2770,nkwangleiGIT,81,0.00188,3713319,86.13511,4311040
2771,paskal,81,0.00188,3713400,86.13699,4311040
2772,pdecat,81,0.00188,3713481,86.13887,4311040
2773,qqshfox,81,0.00188,3713562,86.14075,4311040
2774,r0bj,81,0.00188,3713643,86.14262,4311040
2775,rocketraman,81,0.00188,3713724,86.14450,4311040
2776,sb1975,81,0.00188,3713805,86.14638,4311040
2777,sheldonkwok,81,0.00188,3713886,86.14826,4311040
2778,snoby,81,0.00188,3713967,86.15014,4311040
2779,so0k,81,0.00188,3714048,86.15202,4311040
2780,ss104301,81,0.00188,3714129,86.15390,4311040
2781,tgraf,81,0.00188,3714210,86.15578,4311040
2782,ulucinar,81,0.00188,3714291,86.15766,4311040
2783,vishjain,81,0.00188,3714372,86.15953,4311040
2784,Aayush987,80,0.00186,3714452,86.16139,4311040
2785,akram,80,0.00186,3714532,86.16325,4311040
2786,anderseknert,80,0.00186,3714612,86.16510,4311040
2787,anvithks,80,0.00186,3714692,86.16696,4311040
2788,benbjohnson,80,0.00186,3714772,86.16881,4311040
2789,carlossg,80,0.00186,3714852,86.17067,4311040
2790,chavafg,80,0.00186,3714932,86.17252,4311040
2791,commonlisp,80,0.00186,3715012,86.17438,4311040
2792,danderson,80,0.00186,3715092,86.17624,4311040
2793,dineshgovindasamy,80,0.00186,3715172,86.17809,4311040
2794,GreenApple10,80,0.00186,3715252,86.17995,4311040
2795,hkamel,80,0.00186,3715332,86.18180,4311040
2796,iamneha,80,0.00186,3715412,86.18366,4311040
2797,ihoegen,80,0.00186,3715492,86.18551,4311040
2798,javisabalete,80,0.00186,3715572,86.18737,4311040
2799,JuleeB1,80,0.00186,3715652,86.18923,4311040
2800,kcoronado,80,0.00186,3715732,86.19108,4311040
2801,qaifshaikh,80,0.00186,3715812,86.19294,4311040
2802,r0b2g1t,80,0.00186,3715892,86.19479,4311040
2803,ripta,80,0.00186,3715972,86.19665,4311040
2804,spurin,80,0.00186,3716052,86.19850,4311040
2805,stbenjam,80,0.00186,3716132,86.20036,4311040
2806,abhat,79,0.00183,3716211,86.20219,4311040
2807,adamschaub,79,0.00183,3716290,86.20403,4311040
2808,AndrewSav,79,0.00183,3716369,86.20586,4311040
2809,annapendleton,79,0.00183,3716448,86.20769,4311040
2810,arianvp,79,0.00183,3716527,86.20952,4311040
2811,eumel8,79,0.00183,3716606,86.21136,4311040
2812,freddie400,79,0.00183,3716685,86.21319,4311040
2813,freeformz,79,0.00183,3716764,86.21502,4311040
2814,imoisharma,79,0.00183,3716843,86.21685,4311040
2815,ivan-cai,79,0.00183,3716922,86.21869,4311040
2816,iyear,79,0.00183,3717001,86.22052,4311040
2817,jonathanbeber,79,0.00183,3717080,86.22235,4311040
2818,jwhonce,79,0.00183,3717159,86.22418,4311040
2819,kferrone,79,0.00183,3717238,86.22602,4311040
2820,kolorful,79,0.00183,3717317,86.22785,4311040
2821,kragniz,79,0.00183,3717396,86.22968,4311040
2822,mindscratch,79,0.00183,3717475,86.23151,4311040
2823,pineking,79,0.00183,3717554,86.23335,4311040
2824,stefanlasiewski,79,0.00183,3717633,86.23518,4311040
2825,webwurst,79,0.00183,3717712,86.23701,4311040
2826,YiannisGkoufas,79,0.00183,3717791,86.23884,4311040
2827,anish,78,0.00181,3717869,86.24065,4311040
2828,audip,78,0.00181,3717947,86.24246,4311040
2829,c3y1huang,78,0.00181,3718025,86.24427,4311040
2830,chestack,78,0.00181,3718103,86.24608,4311040
2831,DaiHao,78,0.00181,3718181,86.24789,4311040
2832,d-goro,78,0.00181,3718259,86.24970,4311040
2833,erain,78,0.00181,3718337,86.25151,4311040
2834,erikerlandson,78,0.00181,3718415,86.25332,4311040
2835,fritchie,78,0.00181,3718493,86.25513,4311040
2836,guymguym,78,0.00181,3718571,86.25694,4311040
2837,integrii,78,0.00181,3718649,86.25874,4311040
2838,karthequian,78,0.00181,3718727,86.26055,4311040
2839,Krishnamohan-Yerrabilli,78,0.00181,3718805,86.26236,4311040
2840,liorokman,78,0.00181,3718883,86.26417,4311040
2841,mnshaw,78,0.00181,3718961,86.26598,4311040
2842,Payback159,78,0.00181,3719039,86.26779,4311040
2843,rajguptavm,78,0.00181,3719117,86.26960,4311040
2844,rtnpro,78,0.00181,3719195,86.27141,4311040
2845,SEJeff,78,0.00181,3719273,86.27322,4311040
2846,tobad357,78,0.00181,3719351,86.27503,4311040
2847,zhxcai,78,0.00181,3719429,86.27684,4311040
2848,afritzler,77,0.00179,3719506,86.27862,4311040
2849,ahawkins,77,0.00179,3719583,86.28041,4311040
2850,almos98,77,0.00179,3719660,86.28220,4311040
2851,amirrmonfared,77,0.00179,3719737,86.28398,4311040
2852,bradfitz,77,0.00179,3719814,86.28577,4311040
2853,Eddman,77,0.00179,3719891,86.28755,4311040
2854,fleeto,77,0.00179,3719968,86.28934,4311040
2855,ikeeip,77,0.00179,3720045,86.29113,4311040
2856,JoshuaAndrew,77,0.00179,3720122,86.29291,4311040
2857,mgoodness,77,0.00179,3720199,86.29470,4311040
2858,tdihp,77,0.00179,3720276,86.29649,4311040
2859,victor-sudakov,77,0.00179,3720353,86.29827,4311040
2860,yan234280533,77,0.00179,3720430,86.30006,4311040
2861,aasmall,76,0.00176,3720506,86.30182,4311040
2862,aubm,76,0.00176,3720582,86.30358,4311040
2863,Bo0km4n,76,0.00176,3720658,86.30535,4311040
2864,cyberblack28,76,0.00176,3720734,86.30711,4311040
2865,dawidmalina,76,0.00176,3720810,86.30887,4311040
2866,fungusakafungus,76,0.00176,3720886,86.31064,4311040
2867,fzu-huang,76,0.00176,3720962,86.31240,4311040
2868,itaysk,76,0.00176,3721038,86.31416,4311040
2869,jacekn,76,0.00176,3721114,86.31592,4311040
2870,jbhurat,76,0.00176,3721190,86.31769,4311040
2871,jjo,76,0.00176,3721266,86.31945,4311040
2872,KentaTada,76,0.00176,3721342,86.32121,4311040
2873,miekg,76,0.00176,3721418,86.32298,4311040
2874,milesbxf,76,0.00176,3721494,86.32474,4311040
2875,PrasadG193,76,0.00176,3721570,86.32650,4311040
2876,redhatlinux10,76,0.00176,3721646,86.32826,4311040
2877,sc250024,76,0.00176,3721722,86.33003,4311040
2878,zengchen1024,76,0.00176,3721798,86.33179,4311040
2879,zytek,76,0.00176,3721874,86.33355,4311040
2880,alfredkrohmer,75,0.00174,3721949,86.33529,4311040
2881,apyrgio,75,0.00174,3722024,86.33703,4311040
2882,BSWANG,75,0.00174,3722099,86.33877,4311040
2883,crixo,75,0.00174,3722174,86.34051,4311040
2884,encodeflush,75,0.00174,3722249,86.34225,4311040
2885,ezYakaEagle442,75,0.00174,3722324,86.34399,4311040
2886,ggaaooppeenngg,75,0.00174,3722399,86.34573,4311040
2887,ilackarms,75,0.00174,3722474,86.34747,4311040
2888,liubog2008,75,0.00174,3722549,86.34921,4311040
2889,MikeZappa87,75,0.00174,3722624,86.35095,4311040
2890,mozhuli,75,0.00174,3722699,86.35269,4311040
2891,mYmNeo,75,0.00174,3722774,86.35443,4311040
2892,neha-viswanathan,75,0.00174,3722849,86.35617,4311040
2893,pvanderlinden,75,0.00174,3722924,86.35791,4311040
2894,rajatgupta24,75,0.00174,3722999,86.35965,4311040
2895,TerraTech,75,0.00174,3723074,86.36139,4311040
2896,timothyclarke,75,0.00174,3723149,86.36313,4311040
2897,unixfox,75,0.00174,3723224,86.36487,4311040
2898,vijaykatam,75,0.00174,3723299,86.36661,4311040
2899,calind,74,0.00172,3723373,86.36832,4311040
2900,dhellmann,74,0.00172,3723447,86.37004,4311040
2901,fatih,74,0.00172,3723521,86.37176,4311040
2902,ibotty,74,0.00172,3723595,86.37347,4311040
2903,jamesgoodhouse,74,0.00172,3723669,86.37519,4311040
2904,jonjohnsonjr,74,0.00172,3723743,86.37691,4311040
2905,jterry75,74,0.00172,3723817,86.37862,4311040
2906,kingdonb,74,0.00172,3723891,86.38034,4311040
2907,lenartj,74,0.00172,3723965,86.38206,4311040
2908,lippertmarkus,74,0.00172,3724039,86.38377,4311040
2909,MaxRenaud,74,0.00172,3724113,86.38549,4311040
2910,mcwumbly,74,0.00172,3724187,86.38721,4311040
2911,momom-i,74,0.00172,3724261,86.38892,4311040
2912,namreg,74,0.00172,3724335,86.39064,4311040
2913,PierluigiLenociAkelius,74,0.00172,3724409,86.39236,4311040
2914,samsabed,74,0.00172,3724483,86.39407,4311040
2915,satyamz,74,0.00172,3724557,86.39579,4311040
2916,sergeylanzman,74,0.00172,3724631,86.39751,4311040
2917,shaardie,74,0.00172,3724705,86.39922,4311040
2918,timja,74,0.00172,3724779,86.40094,4311040
2919,tsupertramp,74,0.00172,3724853,86.40265,4311040
2920,unai-ttxu,74,0.00172,3724927,86.40437,4311040
2921,Vikash-8090-Yadav,74,0.00172,3725001,86.40609,4311040
2922,vkamra,74,0.00172,3725075,86.40780,4311040
2923,YaoZengzeng,74,0.00172,3725149,86.40952,4311040
2924,ashish-billore,73,0.00169,3725222,86.41121,4311040
2925,chenkaiyue,73,0.00169,3725295,86.41291,4311040
2926,flx42,73,0.00169,3725368,86.41460,4311040
2927,HaibaraAi96,73,0.00169,3725441,86.41629,4311040
2928,Hellcatlk,73,0.00169,3725514,86.41799,4311040
2929,jialaijun,73,0.00169,3725587,86.41968,4311040
2930,luisdavim,73,0.00169,3725660,86.42137,4311040
2931,mahdix,73,0.00169,3725733,86.42307,4311040
2932,manics,73,0.00169,3725806,86.42476,4311040
2933,olegshaldybin,73,0.00169,3725879,86.42645,4311040
2934,omerlh,73,0.00169,3725952,86.42815,4311040
2935,qmloong,73,0.00169,3726025,86.42984,4311040
2936,sharjeelaziz,73,0.00169,3726098,86.43153,4311040
2937,spacewander,73,0.00169,3726171,86.43323,4311040
2938,streamnsight,73,0.00169,3726244,86.43492,4311040
2939,translucens,73,0.00169,3726317,86.43661,4311040
2940,wedaly,73,0.00169,3726390,86.43831,4311040
2941,xiaoping378,73,0.00169,3726463,86.44000,4311040
2942,Calpicow,72,0.00167,3726535,86.44167,4311040
2943,CaptTofu,72,0.00167,3726607,86.44334,4311040
2944,changyaowei,72,0.00167,3726679,86.44501,4311040
2945,chirangaalwis,72,0.00167,3726751,86.44668,4311040
2946,du2016,72,0.00167,3726823,86.44835,4311040
2947,ESWZY,72,0.00167,3726895,86.45002,4311040
2948,fentas,72,0.00167,3726967,86.45169,4311040
2949,Fsero,72,0.00167,3727039,86.45336,4311040
2950,georgebuckerfield,72,0.00167,3727111,86.45503,4311040
2951,joaquimrocha,72,0.00167,3727183,86.45670,4311040
2952,johnzheng1975,72,0.00167,3727255,86.45837,4311040
2953,jseguillon,72,0.00167,3727327,86.46004,4311040
2954,kiich,72,0.00167,3727399,86.46171,4311040
2955,larsks,72,0.00167,3727471,86.46338,4311040
2956,LilyFaFa,72,0.00167,3727543,86.46505,4311040
2957,lubinszARM,72,0.00167,3727615,86.46672,4311040
2958,marccampbell,72,0.00167,3727687,86.46839,4311040
2959,mitake,72,0.00167,3727759,86.47006,4311040
2960,mprimeaux,72,0.00167,3727831,86.47173,4311040
2961,Nivedita-coder,72,0.00167,3727903,86.47340,4311040
2962,Nowaker,72,0.00167,3727975,86.47507,4311040
2963,patricklundquist,72,0.00167,3728047,86.47674,4311040
2964,svanharmelen,72,0.00167,3728119,86.47841,4311040
2965,adambkaplan,71,0.00165,3728190,86.48006,4311040
2966,a-hilaly,71,0.00165,3728261,86.48171,4311040
2967,Biswajit-Mohapatra2,71,0.00165,3728332,86.48335,4311040
2968,cezarsa,71,0.00165,3728403,86.48500,4311040
2969,daizuozhuo,71,0.00165,3728474,86.48665,4311040
2970,dinhxuanvu,71,0.00165,3728545,86.48830,4311040
2971,dmcnaught,71,0.00165,3728616,86.48994,4311040
2972,flyboarder,71,0.00165,3728687,86.49159,4311040
2973,honkiko,71,0.00165,3728758,86.49324,4311040
2974,jieyu,71,0.00165,3728829,86.49488,4311040
2975,jimmyseto,71,0.00165,3728900,86.49653,4311040
2976,jzelinskie,71,0.00165,3728971,86.49818,4311040
2977,khareyash05,71,0.00165,3729042,86.49982,4311040
2978,mcandre,71,0.00165,3729113,86.50147,4311040
2979,meghanajangi,71,0.00165,3729184,86.50312,4311040
2980,onorua,71,0.00165,3729255,86.50476,4311040
2981,rabi,71,0.00165,3729326,86.50641,4311040
2982,runzexia,71,0.00165,3729397,86.50806,4311040
2983,sxd,71,0.00165,3729468,86.50971,4311040
2984,tcolgate,71,0.00165,3729539,86.51135,4311040
2985,vcaputo,71,0.00165,3729610,86.51300,4311040
2986,Vrtak-CZ,71,0.00165,3729681,86.51465,4311040
2987,abithap,70,0.00162,3729751,86.51627,4311040
2988,akitok,70,0.00162,3729821,86.51789,4311040
2989,anubhakushwaha,70,0.00162,3729891,86.51952,4311040
2990,apilloud,70,0.00162,3729961,86.52114,4311040
2991,carsonoid,70,0.00162,3730031,86.52276,4311040
2992,cenkalti,70,0.00162,3730101,86.52439,4311040
2993,chotiwat,70,0.00162,3730171,86.52601,4311040
2994,christianang,70,0.00162,3730241,86.52764,4311040
2995,didier-durand,70,0.00162,3730311,86.52926,4311040
2996,DjangoPeng,70,0.00162,3730381,86.53088,4311040
2997,flah00,70,0.00162,3730451,86.53251,4311040
2998,hailkomputer,70,0.00162,3730521,86.53413,4311040
2999,irbekrm,70,0.00162,3730591,86.53575,4311040
3000,jordanjennings,70,0.00162,3730661,86.53738,4311040
3001,jroden,70,0.00162,3730731,86.53900,4311040
3002,mattnworb,70,0.00162,3730801,86.54063,4311040
3003,mkurylec,70,0.00162,3730871,86.54225,4311040
3004,patrocinio,70,0.00162,3730941,86.54387,4311040
3005,paulfantom,70,0.00162,3731011,86.54550,4311040
3006,shihan9,70,0.00162,3731081,86.54712,4311040
3007,smira,70,0.00162,3731151,86.54874,4311040
3008,technosophos,70,0.00162,3731221,86.55037,4311040
3009,tomasaschan,70,0.00162,3731291,86.55199,4311040
3010,toonsevrin,70,0.00162,3731361,86.55362,4311040
3011,workhardcc,70,0.00162,3731431,86.55524,4311040
3012,AlbeeSo,69,0.00160,3731500,86.55684,4311040
3013,bgrant0607-nocc,69,0.00160,3731569,86.55844,4311040
3014,budhrg,69,0.00160,3731638,86.56004,4311040
3015,cantbewong,69,0.00160,3731707,86.56164,4311040
3016,crmejia,69,0.00160,3731776,86.56324,4311040
3017,davidhao3300,69,0.00160,3731845,86.56484,4311040
3018,dimm0,69,0.00160,3731914,86.56644,4311040
3019,diversario,69,0.00160,3731983,86.56804,4311040
3020,DominicGunn,69,0.00160,3732052,86.56964,4311040
3021,dzoeteman,69,0.00160,3732121,86.57124,4311040
3022,ese,69,0.00160,3732190,86.57285,4311040
3023,felipeweb,69,0.00160,3732259,86.57445,4311040
3024,fred-vogt,69,0.00160,3732328,86.57605,4311040
3025,georgettica,69,0.00160,3732397,86.57765,4311040
3026,GregSilverman,69,0.00160,3732466,86.57925,4311040
3027,hangscer8,69,0.00160,3732535,86.58085,4311040
3028,jacksgt,69,0.00160,3732604,86.58245,4311040
3029,jaredallard,69,0.00160,3732673,86.58405,4311040
3030,justinblalock87,69,0.00160,3732742,86.58565,4311040
3031,konghui,69,0.00160,3732811,86.58725,4311040
3032,lijianfeng1993,69,0.00160,3732880,86.58885,4311040
3033,micheleberardi,69,0.00160,3732949,86.59045,4311040
3034,Rajadeepan,69,0.00160,3733018,86.59205,4311040
3035,raravena80,69,0.00160,3733087,86.59365,4311040
3036,sgreene570,69,0.00160,3733156,86.59525,4311040
3037,shay-berman,69,0.00160,3733225,86.59685,4311040
3038,Songjoy,69,0.00160,3733294,86.59845,4311040
3039,suonto,69,0.00160,3733363,86.60005,4311040
3040,Symmetric,69,0.00160,3733432,86.60166,4311040
3041,timmysilv,69,0.00160,3733501,86.60326,4311040
3042,torvitas,69,0.00160,3733570,86.60486,4311040
3043,willise,69,0.00160,3733639,86.60646,4311040
3044,abdasgupta,68,0.00158,3733707,86.60803,4311040
3045,AtzeDeVries,68,0.00158,3733775,86.60961,4311040
3046,bassam,68,0.00158,3733843,86.61119,4311040
3047,datosh,68,0.00158,3733911,86.61277,4311040
3048,denverdino,68,0.00158,3733979,86.61434,4311040
3049,dungeonmaster18,68,0.00158,3734047,86.61592,4311040
3050,iobuf,68,0.00158,3734115,86.61750,4311040
3051,jfelten,68,0.00158,3734183,86.61908,4311040
3052,kaitoii11,68,0.00158,3734251,86.62065,4311040
3053,KIVagant,68,0.00158,3734319,86.62223,4311040
3054,lhuard1A,68,0.00158,3734387,86.62381,4311040
3055,linfan,68,0.00158,3734455,86.62539,4311040
3056,LucaLanziani,68,0.00158,3734523,86.62696,4311040
3057,mlushpenko,68,0.00158,3734591,86.62854,4311040
3058,okzhchy,68,0.00158,3734659,86.63012,4311040
3059,oldthreefeng,68,0.00158,3734727,86.63169,4311040
3060,oxr463,68,0.00158,3734795,86.63327,4311040
3061,patrickshan,68,0.00158,3734863,86.63485,4311040
3062,pedro-r-marques,68,0.00158,3734931,86.63643,4311040
3063,ReillyBrogan,68,0.00158,3734999,86.63800,4311040
3064,rifung,68,0.00158,3735067,86.63958,4311040
3065,ronaldpetty,68,0.00158,3735135,86.64116,4311040
3066,rustyrobot,68,0.00158,3735203,86.64274,4311040
3067,ryanjbaxter,68,0.00158,3735271,86.64431,4311040
3068,serbrech,68,0.00158,3735339,86.64589,4311040
3069,shavo007,68,0.00158,3735407,86.64747,4311040
3070,stan-sz,68,0.00158,3735475,86.64905,4311040
3071,tobegit3hub,68,0.00158,3735543,86.65062,4311040
3072,vicentefb,68,0.00158,3735611,86.65220,4311040
3073,adrienjt,67,0.00155,3735678,86.65375,4311040
3074,barakmich,67,0.00155,3735745,86.65531,4311040
3075,Betula-L,67,0.00155,3735812,86.65686,4311040
3076,bmwiedemann,67,0.00155,3735879,86.65842,4311040
3077,Ch00k,67,0.00155,3735946,86.65997,4311040
3078,cscetbon,67,0.00155,3736013,86.66152,4311040
3079,grahamhayes,67,0.00155,3736080,86.66308,4311040
3080,jaygorrell,67,0.00155,3736147,86.66463,4311040
3081,JorTurFer,67,0.00155,3736214,86.66619,4311040
3082,kksriram,67,0.00155,3736281,86.66774,4311040
3083,mad01,67,0.00155,3736348,86.66930,4311040
3084,mhmxs,67,0.00155,3736415,86.67085,4311040
3085,Miyurz,67,0.00155,3736482,86.67240,4311040
3086,moonming,67,0.00155,3736549,86.67396,4311040
3087,muvaf,67,0.00155,3736616,86.67551,4311040
3088,obeattie,67,0.00155,3736683,86.67707,4311040
3089,praveenkumar,67,0.00155,3736750,86.67862,4311040
3090,r7vme,67,0.00155,3736817,86.68017,4311040
3091,ramnes,67,0.00155,3736884,86.68173,4311040
3092,remoe,67,0.00155,3736951,86.68328,4311040
3093,robertojrojas,67,0.00155,3737018,86.68484,4311040
3094,saravanan30erd,67,0.00155,3737085,86.68639,4311040
3095,sayanchowdhury,67,0.00155,3737152,86.68795,4311040
3096,tcordeu,67,0.00155,3737219,86.68950,4311040
3097,thomastaylor312,67,0.00155,3737286,86.69105,4311040
3098,tlereste,67,0.00155,3737353,86.69261,4311040
3099,ttonline6,67,0.00155,3737420,86.69416,4311040
3100,typeid,67,0.00155,3737487,86.69572,4311040
3101,valentin2105,67,0.00155,3737554,86.69727,4311040
3102,abhinavnagaraj,66,0.00153,3737620,86.69880,4311040
3103,adobley,66,0.00153,3737686,86.70033,4311040
3104,adrianchung,66,0.00153,3737752,86.70186,4311040
3105,bang9211,66,0.00153,3737818,86.70339,4311040
3106,Bledai,66,0.00153,3737884,86.70493,4311040
3107,chrismarino,66,0.00153,3737950,86.70646,4311040
3108,countspongebob,66,0.00153,3738016,86.70799,4311040
3109,cr7258,66,0.00153,3738082,86.70952,4311040
3110,dmatch01,66,0.00153,3738148,86.71105,4311040
3111,dongwangdw,66,0.00153,3738214,86.71258,4311040
3112,fookenc,66,0.00153,3738280,86.71411,4311040
3113,hamzazafar,66,0.00153,3738346,86.71564,4311040
3114,hierynomus,66,0.00153,3738412,86.71717,4311040
3115,ibuildthecloud,66,0.00153,3738478,86.71870,4311040
3116,JaysonRaymond,66,0.00153,3738544,86.72023,4311040
3117,kaovilai,66,0.00153,3738610,86.72177,4311040
3118,kbreit,66,0.00153,3738676,86.72330,4311040
3119,khatrig,66,0.00153,3738742,86.72483,4311040
3120,Levovar,66,0.00153,3738808,86.72636,4311040
3121,lxpollitt,66,0.00153,3738874,86.72789,4311040
3122,mitsutaka,66,0.00153,3738940,86.72942,4311040
3123,multi-io,66,0.00153,3739006,86.73095,4311040
3124,ntfrnzn,66,0.00153,3739072,86.73248,4311040
3125,onedr0p,66,0.00153,3739138,86.73401,4311040
3126,PatrickXYS,66,0.00153,3739204,86.73554,4311040
3127,pickledrick,66,0.00153,3739270,86.73708,4311040
3128,robbie-demuth,66,0.00153,3739336,86.73861,4311040
3129,rootsongjc,66,0.00153,3739402,86.74014,4311040
3130,runningman84,66,0.00153,3739468,86.74167,4311040
3131,thinpark,66,0.00153,3739534,86.74320,4311040
3132,tuibeovince,66,0.00153,3739600,86.74473,4311040
3133,VincentS,66,0.00153,3739666,86.74626,4311040
3134,wongearl,66,0.00153,3739732,86.74779,4311040
3135,xchapter7x,66,0.00153,3739798,86.74932,4311040
3136,zihaoyu,66,0.00153,3739864,86.75085,4311040
3137,AnishShah,65,0.00151,3739929,86.75236,4311040
3138,ashleyschuett,65,0.00151,3739994,86.75387,4311040
3139,awgreene,65,0.00151,3740059,86.75538,4311040
3140,BobVanB,65,0.00151,3740124,86.75688,4311040
3141,bwagner5,65,0.00151,3740189,86.75839,4311040
3142,casusbelli,65,0.00151,3740254,86.75990,4311040
3143,danielschonfeld,65,0.00151,3740319,86.76141,4311040
3144,davesargrad,65,0.00151,3740384,86.76292,4311040
3145,Fricounet,65,0.00151,3740449,86.76442,4311040
3146,guydog28,65,0.00151,3740514,86.76593,4311040
3147,jakobmoellerdev,65,0.00151,3740579,86.76744,4311040
3148,jfremy,65,0.00151,3740644,86.76895,4311040
3149,jpiper,65,0.00151,3740709,86.77045,4311040
3150,kachkaev,65,0.00151,3740774,86.77196,4311040
3151,morningspace,65,0.00151,3740839,86.77347,4311040
3152,mvle,65,0.00151,3740904,86.77498,4311040
3153,peter-wangxu,65,0.00151,3740969,86.77649,4311040
3154,pluttrell,65,0.00151,3741034,86.77799,4311040
3155,pravisankar,65,0.00151,3741099,86.77950,4311040
3156,Queuecumber,65,0.00151,3741164,86.78101,4311040
3157,recollir,65,0.00151,3741229,86.78252,4311040
3158,rochacon,65,0.00151,3741294,86.78402,4311040
3159,sagor999,65,0.00151,3741359,86.78553,4311040
3160,samuelkarp,65,0.00151,3741424,86.78704,4311040
3161,thotz,65,0.00151,3741489,86.78855,4311040
3162,TracyBin,65,0.00151,3741554,86.79006,4311040
3163,wangxf1987,65,0.00151,3741619,86.79156,4311040
3164,YTGhost,65,0.00151,3741684,86.79307,4311040
3165,amshuman-kr,64,0.00148,3741748,86.79456,4311040
3166,arthur0,64,0.00148,3741812,86.79604,4311040
3167,cjbottaro,64,0.00148,3741876,86.79752,4311040
3168,cuisongliu,64,0.00148,3741940,86.79901,4311040
3169,djkonro,64,0.00148,3742004,86.80049,4311040
3170,embik,64,0.00148,3742068,86.80198,4311040
3171,F21,64,0.00148,3742132,86.80346,4311040
3172,geekofalltrades,64,0.00148,3742196,86.80495,4311040
3173,gosoon,64,0.00148,3742260,86.80643,4311040
3174,jadarsie,64,0.00148,3742324,86.80792,4311040
3175,jojimt,64,0.00148,3742388,86.80940,4311040
3176,JordanP,64,0.00148,3742452,86.81089,4311040
3177,MaxHorstmann,64,0.00148,3742516,86.81237,4311040
3178,mrmassis,64,0.00148,3742580,86.81385,4311040
3179,necatican,64,0.00148,3742644,86.81534,4311040
3180,neith00,64,0.00148,3742708,86.81682,4311040
3181,nicoaragon,64,0.00148,3742772,86.81831,4311040
3182,nitkon,64,0.00148,3742836,86.81979,4311040
3183,niulechuan,64,0.00148,3742900,86.82128,4311040
3184,nowjean,64,0.00148,3742964,86.82276,4311040
3185,phil9909,64,0.00148,3743028,86.82425,4311040
3186,rhuss,64,0.00148,3743092,86.82573,4311040
3187,rithujohn191,64,0.00148,3743156,86.82722,4311040
3188,saturnism,64,0.00148,3743220,86.82870,4311040
3189,xh4n3,64,0.00148,3743284,86.83018,4311040
3190,abutcher,63,0.00146,3743347,86.83165,4311040
3191,anthr76,63,0.00146,3743410,86.83311,4311040
3192,clamoriniere1A,63,0.00146,3743473,86.83457,4311040
3193,deejross,63,0.00146,3743536,86.83603,4311040
3194,dilyevsky,63,0.00146,3743599,86.83749,4311040
3195,erkanerol,63,0.00146,3743662,86.83895,4311040
3196,fseldow,63,0.00146,3743725,86.84041,4311040
3197,grebois,63,0.00146,3743788,86.84188,4311040
3198,gregory-lyons,63,0.00146,3743851,86.84334,4311040
3199,joebowbeer,63,0.00146,3743914,86.84480,4311040
3200,jygastaud,63,0.00146,3743977,86.84626,4311040
3201,kellycampbell,63,0.00146,3744040,86.84772,4311040
3202,Ladicle,63,0.00146,3744103,86.84918,4311040
3203,liu-sheng,63,0.00146,3744166,86.85064,4311040
3204,LuBingtan,63,0.00146,3744229,86.85211,4311040
3205,MyannaHarris,63,0.00146,3744292,86.85357,4311040
3206,PhilipGough,63,0.00146,3744355,86.85503,4311040
3207,r0fls,63,0.00146,3744418,86.85649,4311040
3208,stpabhi,63,0.00146,3744481,86.85795,4311040
3209,takmatsu,63,0.00146,3744544,86.85941,4311040
3210,thebsdbox,63,0.00146,3744607,86.86087,4311040
3211,tomdee,63,0.00146,3744670,86.86233,4311040
3212,vendrov,63,0.00146,3744733,86.86380,4311040
3213,wangshiqi308,63,0.00146,3744796,86.86526,4311040
3214,weixiao-huang,63,0.00146,3744859,86.86672,4311040
3215,xinyanw409,63,0.00146,3744922,86.86818,4311040
3216,Yashks1994,63,0.00146,3744985,86.86964,4311040
3217,yiyangy,63,0.00146,3745048,86.87110,4311040
3218,007,62,0.00144,3745110,86.87254,4311040
3219,ailusazh,62,0.00144,3745172,86.87398,4311040
3220,AmanSarraf,62,0.00144,3745234,86.87542,4311040
3221,ankurshukla,62,0.00144,3745296,86.87686,4311040
3222,ChaitanyaKaranam,62,0.00144,3745358,86.87829,4311040
3223,cliveseldon,62,0.00144,3745420,86.87973,4311040
3224,DheerajSShetty,62,0.00144,3745482,86.88117,4311040
3225,estahn,62,0.00144,3745544,86.88261,4311040
3226,eytan-avisror,62,0.00144,3745606,86.88405,4311040
3227,fonsecas72,62,0.00144,3745668,86.88548,4311040
3228,IanColdwater,62,0.00144,3745730,86.88692,4311040
3229,immuzz,62,0.00144,3745792,86.88836,4311040
3230,jasongwartz,62,0.00144,3745854,86.88980,4311040
3231,JoaoBraveCoding,62,0.00144,3745916,86.89124,4311040
3232,julienemo,62,0.00144,3745978,86.89268,4311040
3233,Juneezee,62,0.00144,3746040,86.89411,4311040
3234,kirs,62,0.00144,3746102,86.89555,4311040
3235,lbogdan,62,0.00144,3746164,86.89699,4311040
3236,letmerecall,62,0.00144,3746226,86.89843,4311040
3237,LinuxSuRen,62,0.00144,3746288,86.89987,4311040
3238,malc0lm,62,0.00144,3746350,86.90130,4311040
3239,maria,62,0.00144,3746412,86.90274,4311040
3240,mark-nc,62,0.00144,3746474,86.90418,4311040
3241,mkutsevol,62,0.00144,3746536,86.90562,4311040
3242,pre,62,0.00144,3746598,86.90706,4311040
3243,ryanzhang-oss,62,0.00144,3746660,86.90850,4311040
3244,schweikert,62,0.00144,3746722,86.90993,4311040
3245,shouhong,62,0.00144,3746784,86.91137,4311040
3246,sym3tri,62,0.00144,3746846,86.91281,4311040
3247,Tej-Singh-Rana,62,0.00144,3746908,86.91425,4311040
3248,TGPSKI,62,0.00144,3746970,86.91569,4311040
3249,tksm,62,0.00144,3747032,86.91712,4311040
3250,venkatsc,62,0.00144,3747094,86.91856,4311040
3251,vineet-garg,62,0.00144,3747156,86.92000,4311040
3252,weibeld,62,0.00144,3747218,86.92144,4311040
3253,zc2638,62,0.00144,3747280,86.92288,4311040
3254,abserari,61,0.00141,3747341,86.92429,4311040
3255,alexzimmer96,61,0.00141,3747402,86.92571,4311040
3256,arcivanov,61,0.00141,3747463,86.92712,4311040
3257,awels,61,0.00141,3747524,86.92854,4311040
3258,coeki,61,0.00141,3747585,86.92995,4311040
3259,DazWilkin,61,0.00141,3747646,86.93137,4311040
3260,dippynark,61,0.00141,3747707,86.93278,4311040
3261,dpandhi-git,61,0.00141,3747768,86.93420,4311040
3262,EmilyM1,61,0.00141,3747829,86.93561,4311040
3263,fcgravalos,61,0.00141,3747890,86.93703,4311040
3264,gregory-m,61,0.00141,3747951,86.93844,4311040
3265,ieugen,61,0.00141,3748012,86.93986,4311040
3266,Jainbrt,61,0.00141,3748073,86.94127,4311040
3267,jasimmons,61,0.00141,3748134,86.94269,4311040
3268,LCaparelli,61,0.00141,3748195,86.94410,4311040
3269,mooperd,61,0.00141,3748256,86.94552,4311040
3270,onesolpark,61,0.00141,3748317,86.94693,4311040
3271,pasqualet,61,0.00141,3748378,86.94835,4311040
3272,Pothulapati,61,0.00141,3748439,86.94976,4311040
3273,rverma-nikiai,61,0.00141,3748500,86.95118,4311040
3274,shrinandj,61,0.00141,3748561,86.95259,4311040
3275,snehala27,61,0.00141,3748622,86.95401,4311040
3276,soniasingla,61,0.00141,3748683,86.95542,4311040
3277,steven-sheehy,61,0.00141,3748744,86.95684,4311040
3278,Xartos,61,0.00141,3748805,86.95825,4311040
3279,zjs,61,0.00141,3748866,86.95967,4311040
3280,abh,60,0.00139,3748926,86.96106,4311040
3281,adamzhoul,60,0.00139,3748986,86.96245,4311040
3282,adnavare,60,0.00139,3749046,86.96384,4311040
3283,apenney,60,0.00139,3749106,86.96523,4311040
3284,baomingwang,60,0.00139,3749166,86.96663,4311040
3285,bengentil,60,0.00139,3749226,86.96802,4311040
3286,benjamin-bergia,60,0.00139,3749286,86.96941,4311040
3287,bergwolf,60,0.00139,3749346,86.97080,4311040
3288,brutus333,60,0.00139,3749406,86.97219,4311040
3289,calvix,60,0.00139,3749466,86.97358,4311040
3290,caohe,60,0.00139,3749526,86.97498,4311040
3291,chen-anders,60,0.00139,3749586,86.97637,4311040
3292,chengzhang1016,60,0.00139,3749646,86.97776,4311040
3293,chipzoller,60,0.00139,3749706,86.97915,4311040
3294,cyang49,60,0.00139,3749766,86.98054,4311040
3295,dashanji,60,0.00139,3749826,86.98193,4311040
3296,davivcgarcia,60,0.00139,3749886,86.98333,4311040
3297,erez-rabih,60,0.00139,3749946,86.98472,4311040
3298,FingerLiu,60,0.00139,3750006,86.98611,4311040
3299,hmeng-19,60,0.00139,3750066,86.98750,4311040
3300,jeroenjacobs1205,60,0.00139,3750126,86.98889,4311040
3301,kewu1992,60,0.00139,3750186,86.99029,4311040
3302,maniSbindra,60,0.00139,3750246,86.99168,4311040
3303,marccarre,60,0.00139,3750306,86.99307,4311040
3304,MarSik,60,0.00139,3750366,86.99446,4311040
3305,m-Bilal,60,0.00139,3750426,86.99585,4311040
3306,Mikulas,60,0.00139,3750486,86.99724,4311040
3307,mitchellmaler,60,0.00139,3750546,86.99864,4311040
3308,m-yosefpor,60,0.00139,3750606,87.00003,4311040
3309,otterley,60,0.00139,3750666,87.00142,4311040
3310,pnbrown,60,0.00139,3750726,87.00281,4311040
3311,qinpingli,60,0.00139,3750786,87.00420,4311040
3312,sak0,60,0.00139,3750846,87.00559,4311040
3313,samip5,60,0.00139,3750906,87.00699,4311040
3314,shibumi,60,0.00139,3750966,87.00838,4311040
3315,slayer321,60,0.00139,3751026,87.00977,4311040
3316,thdrnsdk,60,0.00139,3751086,87.01116,4311040
3317,waynepeking348,60,0.00139,3751146,87.01255,4311040
3318,antoniaklja,59,0.00137,3751205,87.01392,4311040
3319,cgroschupp,59,0.00137,3751264,87.01529,4311040
3320,DerekV,59,0.00137,3751323,87.01666,4311040
3321,dmlb2000,59,0.00137,3751382,87.01803,4311040
3322,drigz,59,0.00137,3751441,87.01940,4311040
3323,hrittikhere,59,0.00137,3751500,87.02077,4311040
3324,imjasonh,59,0.00137,3751559,87.02213,4311040
3325,imjching,59,0.00137,3751618,87.02350,4311040
3326,knobunc,59,0.00137,3751677,87.02487,4311040
3327,mallow111,59,0.00137,3751736,87.02624,4311040
3328,matthewygf,59,0.00137,3751795,87.02761,4311040
3329,mxpv,59,0.00137,3751854,87.02898,4311040
3330,nickperry,59,0.00137,3751913,87.03035,4311040
3331,pentago,59,0.00137,3751972,87.03171,4311040
3332,pottekkat,59,0.00137,3752031,87.03308,4311040
3333,ruheenaansari34,59,0.00137,3752090,87.03445,4311040
3334,ryanwalls,59,0.00137,3752149,87.03582,4311040
3335,sarjeet2013,59,0.00137,3752208,87.03719,4311040
3336,sergelogvinov,59,0.00137,3752267,87.03856,4311040
3337,shvgn,59,0.00137,3752326,87.03993,4311040
3338,stephan2012,59,0.00137,3752385,87.04129,4311040
3339,wangkai1994,59,0.00137,3752444,87.04266,4311040
3340,zeborg,59,0.00137,3752503,87.04403,4311040
3341,anuraaga,58,0.00135,3752561,87.04538,4311040
3342,avidLearnerInProgress,58,0.00135,3752619,87.04672,4311040
3343,blaggacao,58,0.00135,3752677,87.04807,4311040
3344,cablespaghetti,58,0.00135,3752735,87.04941,4311040
3345,clkao,58,0.00135,3752793,87.05076,4311040
3346,coltonstapper,58,0.00135,3752851,87.05210,4311040
3347,ddgenome,58,0.00135,3752909,87.05345,4311040
3348,demisx,58,0.00135,3752967,87.05479,4311040
3349,DStorck,58,0.00135,3753025,87.05614,4311040
3350,eatwithforks,58,0.00135,3753083,87.05748,4311040
3351,guirish,58,0.00135,3753141,87.05883,4311040
3352,Harkishen-Singh,58,0.00135,3753199,87.06018,4311040
3353,hustcat,58,0.00135,3753257,87.06152,4311040
3354,IronPan,58,0.00135,3753315,87.06287,4311040
3355,javipolo,58,0.00135,3753373,87.06421,4311040
3356,jwcesign,58,0.00135,3753431,87.06556,4311040
3357,kesor,58,0.00135,3753489,87.06690,4311040
3358,krzykwas,58,0.00135,3753547,87.06825,4311040
3359,leileiwan,58,0.00135,3753605,87.06959,4311040
3360,liguangbo,58,0.00135,3753663,87.07094,4311040
3361,LJTian,58,0.00135,3753721,87.07228,4311040
3362,LKaemmerling,58,0.00135,3753779,87.07363,4311040
3363,nickschuch,58,0.00135,3753837,87.07497,4311040
3364,nirnanaaa,58,0.00135,3753895,87.07632,4311040
3365,qvicksilver,58,0.00135,3753953,87.07767,4311040
3366,renan,58,0.00135,3754011,87.07901,4311040
3367,shaloulcy,58,0.00135,3754069,87.08036,4311040
3368,tpounds,58,0.00135,3754127,87.08170,4311040
3369,tyranron,58,0.00135,3754185,87.08305,4311040
3370,xvzf,58,0.00135,3754243,87.08439,4311040
3371,yogeek,58,0.00135,3754301,87.08574,4311040
3372,zimmertr,58,0.00135,3754359,87.08708,4311040
3373,aallbrig,57,0.00132,3754416,87.08841,4311040
3374,achinthagunasekara,57,0.00132,3754473,87.08973,4311040
3375,activeshadow,57,0.00132,3754530,87.09105,4311040
3376,AkashSarda,57,0.00132,3754587,87.09237,4311040
3377,BinL233,57,0.00132,3754644,87.09369,4311040
3378,cgilmour,57,0.00132,3754701,87.09502,4311040
3379,Coderhypo,57,0.00132,3754758,87.09634,4311040
3380,EuricoAbreu,57,0.00132,3754815,87.09766,4311040
3381,Ghazgkull,57,0.00132,3754872,87.09898,4311040
3382,gy95,57,0.00132,3754929,87.10031,4311040
3383,Hyzhou,57,0.00132,3754986,87.10163,4311040
3384,JishanXing,57,0.00132,3755043,87.10295,4311040
3385,jkinkead,57,0.00132,3755100,87.10427,4311040
3386,jmreicha,57,0.00132,3755157,87.10559,4311040
3387,juliaferraioli,57,0.00132,3755214,87.10692,4311040
3388,kfirfer,57,0.00132,3755271,87.10824,4311040
3389,Lokicity,57,0.00132,3755328,87.10956,4311040
3390,ltagliamonte-dd,57,0.00132,3755385,87.11088,4311040
3391,mabushey,57,0.00132,3755442,87.11220,4311040
3392,maelvls,57,0.00132,3755499,87.11353,4311040
3393,marc-sensenich,57,0.00132,3755556,87.11485,4311040
3394,orsenthil,57,0.00132,3755613,87.11617,4311040
3395,PeWu,57,0.00132,3755670,87.11749,4311040
3396,remram44,57,0.00132,3755727,87.11882,4311040
3397,ritpanjw,57,0.00132,3755784,87.12014,4311040
3398,robdaemon,57,0.00132,3755841,87.12146,4311040
3399,sherifhmdy,57,0.00132,3755898,87.12278,4311040
3400,shixiuguo,57,0.00132,3755955,87.12410,4311040
3401,svoskobo-vmware-com,57,0.00132,3756012,87.12543,4311040
3402,trondhindenes,57,0.00132,3756069,87.12675,4311040
3403,tvansteenburgh,57,0.00132,3756126,87.12807,4311040
3404,vareti,57,0.00132,3756183,87.12939,4311040
3405,vikkyomkar,57,0.00132,3756240,87.13072,4311040
3406,vinicyusmacedo,57,0.00132,3756297,87.13204,4311040
3407,vjdhama,57,0.00132,3756354,87.13336,4311040
3408,yixin21,57,0.00132,3756411,87.13468,4311040
3409,zdj6373,57,0.00132,3756468,87.13600,4311040
3410,andrejvanderzee,56,0.00130,3756524,87.13730,4311040
3411,andrewlouis93,56,0.00130,3756580,87.13860,4311040
3412,aritraghosh,56,0.00130,3756636,87.13990,4311040
3413,brandoncole,56,0.00130,3756692,87.14120,4311040
3414,CamelCaseNotation,56,0.00130,3756748,87.14250,4311040
3415,christianh814,56,0.00130,3756804,87.14380,4311040
3416,chxchx,56,0.00130,3756860,87.14510,4311040
3417,cloudmelon,56,0.00130,3756916,87.14640,4311040
3418,codevulture,56,0.00130,3756972,87.14770,4311040
3419,dbaker-rh,56,0.00130,3757028,87.14899,4311040
3420,divyabhushan,56,0.00130,3757084,87.15029,4311040
3421,dkypuros,56,0.00130,3757140,87.15159,4311040
3422,drewhemm,56,0.00130,3757196,87.15289,4311040
3423,errm,56,0.00130,3757252,87.15419,4311040
3424,erwinvaneyk,56,0.00130,3757308,87.15549,4311040
3425,greghaynes,56,0.00130,3757364,87.15679,4311040
3426,jnardiello,56,0.00130,3757420,87.15809,4311040
3427,jsoriano,56,0.00130,3757476,87.15939,4311040
3428,kylehodgetts,56,0.00130,3757532,87.16069,4311040
3429,luck02,56,0.00130,3757588,87.16198,4311040
3430,luigi-riefolo,56,0.00130,3757644,87.16328,4311040
3431,matglas,56,0.00130,3757700,87.16458,4311040
3432,michaelgeorgeattard,56,0.00130,3757756,87.16588,4311040
3433,Mr-DG-Wick,56,0.00130,3757812,87.16718,4311040
3434,norshtein,56,0.00130,3757868,87.16848,4311040
3435,OlegLoewen,56,0.00130,3757924,87.16978,4311040
3436,outcoldman,56,0.00130,3757980,87.17108,4311040
3437,phantooom,56,0.00130,3758036,87.17238,4311040
3438,rhrazdil,56,0.00130,3758092,87.17368,4311040
3439,ringerc,56,0.00130,3758148,87.17497,4311040
3440,rsc,56,0.00130,3758204,87.17627,4311040
3441,simo5,56,0.00130,3758260,87.17757,4311040
3442,stanciuoctavian,56,0.00130,3758316,87.17887,4311040
3443,sukeesh,56,0.00130,3758372,87.18017,4311040
3444,sunya-ch,56,0.00130,3758428,87.18147,4311040
3445,theSinner,56,0.00130,3758484,87.18277,4311040
3446,thomas-riccardi,56,0.00130,3758540,87.18407,4311040
3447,vladwa,56,0.00130,3758596,87.18537,4311040
3448,yuripastushenko,56,0.00130,3758652,87.18666,4311040
3449,zigarn,56,0.00130,3758708,87.18796,4311040
3450,aabed,55,0.00128,3758763,87.18924,4311040
3451,ankitm123,55,0.00128,3758818,87.19052,4311040
3452,ariesliuwei,55,0.00128,3758873,87.19179,4311040
3453,aylei,55,0.00128,3758928,87.19307,4311040
3454,Benjile,55,0.00128,3758983,87.19434,4311040
3455,brdude,55,0.00128,3759038,87.19562,4311040
3456,caiweidongdongsuzhou,55,0.00128,3759093,87.19689,4311040
3457,captainshar,55,0.00128,3759148,87.19817,4311040
3458,chandankumar4,55,0.00128,3759203,87.19945,4311040
3459,draghuram,55,0.00128,3759258,87.20072,4311040
3460,EronWright,55,0.00128,3759313,87.20200,4311040
3461,fsouza,55,0.00128,3759368,87.20327,4311040
3462,H3rman8,55,0.00128,3759423,87.20455,4311040
3463,jenting,55,0.00128,3759478,87.20583,4311040
3464,JPRbrs,55,0.00128,3759533,87.20710,4311040
3465,kprobst,55,0.00128,3759588,87.20838,4311040
3466,marekschwarz,55,0.00128,3759643,87.20965,4311040
3467,markine,55,0.00128,3759698,87.21093,4311040
3468,mbrancato,55,0.00128,3759753,87.21220,4311040
3469,mjudeikis,55,0.00128,3759808,87.21348,4311040
3470,mpatlasov,55,0.00128,3759863,87.21476,4311040
3471,nvanheuverzwijn,55,0.00128,3759918,87.21603,4311040
3472,onitake,55,0.00128,3759973,87.21731,4311040
3473,ozbillwang,55,0.00128,3760028,87.21858,4311040
3474,payall4u,55,0.00128,3760083,87.21986,4311040
3475,pmundt,55,0.00128,3760138,87.22113,4311040
3476,pst,55,0.00128,3760193,87.22241,4311040
3477,rashansmith,55,0.00128,3760248,87.22369,4311040
3478,richstokes,55,0.00128,3760303,87.22496,4311040
3479,ricochet,55,0.00128,3760358,87.22624,4311040
3480,RonWeber,55,0.00128,3760413,87.22751,4311040
3481,rtreffer,55,0.00128,3760468,87.22879,4311040
3482,runewake2,55,0.00128,3760523,87.23007,4311040
3483,SebastianM,55,0.00128,3760578,87.23134,4311040
3484,seungkyua,55,0.00128,3760633,87.23262,4311040
3485,sslavic,55,0.00128,3760688,87.23389,4311040
3486,Tellz777,55,0.00128,3760743,87.23517,4311040
3487,timstoop,55,0.00128,3760798,87.23644,4311040
3488,tklauser,55,0.00128,3760853,87.23772,4311040
3489,tkrausjr,55,0.00128,3760908,87.23900,4311040
3490,vbannai,55,0.00128,3760963,87.24027,4311040
3491,zcahana,55,0.00128,3761018,87.24155,4311040
3492,zionwu,55,0.00128,3761073,87.24282,4311040
3493,Abdelsalam-Abbas,54,0.00125,3761127,87.24408,4311040
3494,AGMETEOR,54,0.00125,3761181,87.24533,4311040
3495,AlexLast,54,0.00125,3761235,87.24658,4311040
3496,alindeman,54,0.00125,3761289,87.24783,4311040
3497,bkeroackdsc,54,0.00125,3761343,87.24909,4311040
3498,BradErz,54,0.00125,3761397,87.25034,4311040
3499,cameronbrunner,54,0.00125,3761451,87.25159,4311040
3500,cw-sakamoto,54,0.00125,3761505,87.25284,4311040
3501,damienr74,54,0.00125,3761559,87.25410,4311040
3502,dguendisch,54,0.00125,3761613,87.25535,4311040
3503,Dirbaio,54,0.00125,3761667,87.25660,4311040
3504,FrederikNS,54,0.00125,3761721,87.25785,4311040
3505,gekart,54,0.00125,3761775,87.25911,4311040
3506,heschlie,54,0.00125,3761829,87.26036,4311040
3507,icy,54,0.00125,3761883,87.26161,4311040
3508,Invictus17,54,0.00125,3761937,87.26286,4311040
3509,jiaxunsongucb,54,0.00125,3761991,87.26412,4311040
3510,joaocc,54,0.00125,3762045,87.26537,4311040
3511,joe2far,54,0.00125,3762099,87.26662,4311040
3512,jonesbr17,54,0.00125,3762153,87.26788,4311040
3513,longkb,54,0.00125,3762207,87.26913,4311040
3514,marians,54,0.00125,3762261,87.27038,4311040
3515,matthewdupre,54,0.00125,3762315,87.27163,4311040
3516,mlevesquedion,54,0.00125,3762369,87.27289,4311040
3517,NissesSenap,54,0.00125,3762423,87.27414,4311040
3518,ntquyen,54,0.00125,3762477,87.27539,4311040
3519,pronix,54,0.00125,3762531,87.27664,4311040
3520,r4j4h,54,0.00125,3762585,87.27790,4311040
3521,SantoDE,54,0.00125,3762639,87.27915,4311040
3522,shigy123456,54,0.00125,3762693,87.28040,4311040
3523,shturec,54,0.00125,3762747,87.28165,4311040
3524,slimm609,54,0.00125,3762801,87.28291,4311040
3525,sudermanjr,54,0.00125,3762855,87.28416,4311040
3526,waprin,54,0.00125,3762909,87.28541,4311040
3527,xinxiaogang,54,0.00125,3762963,87.28666,4311040
3528,aldudko,53,0.00123,3763016,87.28789,4311040
3529,alexandrst88,53,0.00123,3763069,87.28912,4311040
3530,aogier,53,0.00123,3763122,87.29035,4311040
3531,asavov,53,0.00123,3763175,87.29158,4311040
3532,Avatat,53,0.00123,3763228,87.29281,4311040
3533,backjo,53,0.00123,3763281,87.29404,4311040
3534,billy2180,53,0.00123,3763334,87.29527,4311040
3535,bryanlarsen,53,0.00123,3763387,87.29650,4311040
3536,cprivite,53,0.00123,3763440,87.29773,4311040
3537,CsatariGergely,53,0.00123,3763493,87.29896,4311040
3538,didicodes,53,0.00123,3763546,87.30019,4311040
3539,disrani-px,53,0.00123,3763599,87.30142,4311040
3540,donggangcj,53,0.00123,3763652,87.30265,4311040
3541,DXist,53,0.00123,3763705,87.30388,4311040
3542,egeland,53,0.00123,3763758,87.30511,4311040
3543,HardySimpson,53,0.00123,3763811,87.30633,4311040
3544,Hokutosei,53,0.00123,3763864,87.30756,4311040
3545,irajdeep,53,0.00123,3763917,87.30879,4311040
3546,JacobHenner,53,0.00123,3763970,87.31002,4311040
3547,jstrachan,53,0.00123,3764023,87.31125,4311040
3548,kameshsampath,53,0.00123,3764076,87.31248,4311040
3549,keontang,53,0.00123,3764129,87.31371,4311040
3550,kevincox,53,0.00123,3764182,87.31494,4311040
3551,lukasmrtvy,53,0.00123,3764235,87.31617,4311040
3552,michaelfig,53,0.00123,3764288,87.31740,4311040
3553,Moriadry,53,0.00123,3764341,87.31863,4311040
3554,nrobert13,53,0.00123,3764394,87.31986,4311040
3555,PhilibertDugas,53,0.00123,3764447,87.32109,4311040
3556,philk,53,0.00123,3764500,87.32232,4311040
3557,Ramyak,53,0.00123,3764553,87.32355,4311040
3558,Ressetkk,53,0.00123,3764606,87.32478,4311040
3559,ShivangShandilya,53,0.00123,3764659,87.32600,4311040
3560,teaguecole,53,0.00123,3764712,87.32723,4311040
3561,abrennan89,52,0.00121,3764764,87.32844,4311040
3562,antaloala,52,0.00121,3764816,87.32965,4311040
3563,b0b0haha,52,0.00121,3764868,87.33085,4311040
3564,b10s,52,0.00121,3764920,87.33206,4311040
3565,bluebreezecf,52,0.00121,3764972,87.33327,4311040
3566,blurpy,52,0.00121,3765024,87.33447,4311040
3567,bouk,52,0.00121,3765076,87.33568,4311040
3568,BugRoger,52,0.00121,3765128,87.33688,4311040
3569,cliffburdick,52,0.00121,3765180,87.33809,4311040
3570,cormachogan,52,0.00121,3765232,87.33930,4311040
3571,craigtracey,52,0.00121,3765284,87.34050,4311040
3572,danielnorberg,52,0.00121,3765336,87.34171,4311040
3573,ddelange,52,0.00121,3765388,87.34291,4311040
3574,derekmahar,52,0.00121,3765440,87.34412,4311040
3575,ekuefler,52,0.00121,3765492,87.34533,4311040
3576,everett-toews,52,0.00121,3765544,87.34653,4311040
3577,fengshunli,52,0.00121,3765596,87.34774,4311040
3578,gamename,52,0.00121,3765648,87.34895,4311040
3579,ghouscht,52,0.00121,3765700,87.35015,4311040
3580,IAXES,52,0.00121,3765752,87.35136,4311040
3581,iusergii,52,0.00121,3765804,87.35256,4311040
3582,ivanilves,52,0.00121,3765856,87.35377,4311040
3583,jonnylangefeld,52,0.00121,3765908,87.35498,4311040
3584,juandiegopalomino,52,0.00121,3765960,87.35618,4311040
3585,KarstenSiemer,52,0.00121,3766012,87.35739,4311040
3586,leeeboo,52,0.00121,3766064,87.35860,4311040
3587,liangxia,52,0.00121,3766116,87.35980,4311040
3588,lioncruise,52,0.00121,3766168,87.36101,4311040
3589,loqutus,52,0.00121,3766220,87.36221,4311040
3590,Lp-Francois,52,0.00121,3766272,87.36342,4311040
3591,MartinWeindel,52,0.00121,3766324,87.36463,4311040
3592,mewais,52,0.00121,3766376,87.36583,4311040
3593,mgr01,52,0.00121,3766428,87.36704,4311040
3594,Michael-Sinz,52,0.00121,3766480,87.36825,4311040
3595,migueleliasweb,52,0.00121,3766532,87.36945,4311040
3596,miminar,52,0.00121,3766584,87.37066,4311040
3597,okgolove,52,0.00121,3766636,87.37186,4311040
3598,prasita123,52,0.00121,3766688,87.37307,4311040
3599,rakyll,52,0.00121,3766740,87.37428,4311040
3600,roboll,52,0.00121,3766792,87.37548,4311040
3601,runyontr,52,0.00121,3766844,87.37669,4311040
3602,shinebayar-g,52,0.00121,3766896,87.37789,4311040
3603,ShyamsundarR,52,0.00121,3766948,87.37910,4311040
3604,somersbmatthews,52,0.00121,3767000,87.38031,4311040
3605,staugust,52,0.00121,3767052,87.38151,4311040
3606,TamerTas,52,0.00121,3767104,87.38272,4311040
3607,vrlo,52,0.00121,3767156,87.38393,4311040
3608,vrutkovs,52,0.00121,3767208,87.38513,4311040
3609,wiggitywhitney,52,0.00121,3767260,87.38634,4311040
3610,zachmandeville,52,0.00121,3767312,87.38754,4311040
3611,zedtux,52,0.00121,3767364,87.38875,4311040
3612,zefciu,52,0.00121,3767416,87.38996,4311040
3613,adamwalach,51,0.00118,3767467,87.39114,4311040
3614,AndrewFarley,51,0.00118,3767518,87.39232,4311040
3615,anthonyho007,51,0.00118,3767569,87.39351,4311040
3616,brett-elliott,51,0.00118,3767620,87.39469,4311040
3617,briandealwis,51,0.00118,3767671,87.39587,4311040
3618,coryrc,51,0.00118,3767722,87.39706,4311040
3619,crhym3,51,0.00118,3767773,87.39824,4311040
3620,cristifalcas,51,0.00118,3767824,87.39942,4311040
3621,dominykas,51,0.00118,3767875,87.40060,4311040
3622,donaldguy,51,0.00118,3767926,87.40179,4311040
3623,DP19,51,0.00118,3767977,87.40297,4311040
3624,dschunack,51,0.00118,3768028,87.40415,4311040
3625,elsesiy,51,0.00118,3768079,87.40534,4311040
3626,ffledgling,51,0.00118,3768130,87.40652,4311040
3627,garethr,51,0.00118,3768181,87.40770,4311040
3628,Go-Iwamoto,51,0.00118,3768232,87.40889,4311040
3629,groodt,51,0.00118,3768283,87.41007,4311040
3630,gwkunze,51,0.00118,3768334,87.41125,4311040
3631,jackielii,51,0.00118,3768385,87.41243,4311040
3632,JensErat,51,0.00118,3768436,87.41362,4311040
3633,jlegrone,51,0.00118,3768487,87.41480,4311040
3634,Joseph-Goergen,51,0.00118,3768538,87.41598,4311040
3635,jpetazzo,51,0.00118,3768589,87.41717,4311040
3636,JrCs,51,0.00118,3768640,87.41835,4311040
3637,kendallroden,51,0.00118,3768691,87.41953,4311040
3638,lilongfeng0902,51,0.00118,3768742,87.42072,4311040
3639,ludydoo,51,0.00118,3768793,87.42190,4311040
3640,MarcosNBJ,51,0.00118,3768844,87.42308,4311040
3641,minerba,51,0.00118,3768895,87.42426,4311040
3642,moserke,51,0.00118,3768946,87.42545,4311040
3643,mwwolters,51,0.00118,3768997,87.42663,4311040
3644,natereid72,51,0.00118,3769048,87.42781,4311040
3645,osterman,51,0.00118,3769099,87.42900,4311040
3646,PauloGoncalvesLima,51,0.00118,3769150,87.43018,4311040
3647,pondohva,51,0.00118,3769201,87.43136,4311040
3648,rjtsdl,51,0.00118,3769252,87.43255,4311040
3649,ryfow,51,0.00118,3769303,87.43373,4311040
3650,saarques,51,0.00118,3769354,87.43491,4311040
3651,ssup2,51,0.00118,3769405,87.43609,4311040
3652,stensonb,51,0.00118,3769456,87.43728,4311040
3653,sterchelen,51,0.00118,3769507,87.43846,4311040
3654,sysnet4admin,51,0.00118,3769558,87.43964,4311040
3655,SzekeresB,51,0.00118,3769609,87.44083,4311040
3656,tacy,51,0.00118,3769660,87.44201,4311040
3657,tomfotherby,51,0.00118,3769711,87.44319,4311040
3658,vladimir-shcherbakov,51,0.00118,3769762,87.44438,4311040
3659,vrabbi,51,0.00118,3769813,87.44556,4311040
3660,zacharya,51,0.00118,3769864,87.44674,4311040
3661,zen,51,0.00118,3769915,87.44792,4311040
3662,albertvaka,50,0.00116,3769965,87.44908,4311040
3663,andrewwatson,50,0.00116,3770015,87.45024,4311040
3664,angelbarrera92,50,0.00116,3770065,87.45140,4311040
3665,chrishiestand,50,0.00116,3770115,87.45256,4311040
3666,claytononeill,50,0.00116,3770165,87.45372,4311040
3667,cvila84,50,0.00116,3770215,87.45488,4311040
3668,davidB,50,0.00116,3770265,87.45604,4311040
3669,dbason,50,0.00116,3770315,87.45720,4311040
3670,DeliangFan,50,0.00116,3770365,87.45836,4311040
3671,dignajar,50,0.00116,3770415,87.45952,4311040
3672,dlsniper,50,0.00116,3770465,87.46068,4311040
3673,edglynes,50,0.00116,3770515,87.46184,4311040
3674,edwardstudy,50,0.00116,3770565,87.46300,4311040
3675,fabiokung,50,0.00116,3770615,87.46416,4311040
3676,fidencio,50,0.00116,3770665,87.46532,4311040
3677,froblesmartin,50,0.00116,3770715,87.46648,4311040
3678,gajju26,50,0.00116,3770765,87.46764,4311040
3679,geerlingguy,50,0.00116,3770815,87.46880,4311040
3680,guilhem,50,0.00116,3770865,87.46996,4311040
3681,huyhg,50,0.00116,3770915,87.47112,4311040
3682,jimmyjones2,50,0.00116,3770965,87.47228,4311040
3683,khos2ow,50,0.00116,3771015,87.47344,4311040
3684,kk-src,50,0.00116,3771065,87.47460,4311040
3685,KnicKnic,50,0.00116,3771115,87.47576,4311040
3686,kumudt,50,0.00116,3771165,87.47692,4311040
3687,Miftahunajat,50,0.00116,3771215,87.47808,4311040
3688,mikekap,50,0.00116,3771265,87.47924,4311040
3689,mrobson,50,0.00116,3771315,87.48040,4311040
3690,omar-nahhas,50,0.00116,3771365,87.48156,4311040
3691,PatrickGhadban,50,0.00116,3771415,87.48272,4311040
3692,paulbouwer,50,0.00116,3771465,87.48388,4311040
3693,ps882,50,0.00116,3771515,87.48504,4311040
3694,qeqar,50,0.00116,3771565,87.48620,4311040
3695,sayanarijit,50,0.00116,3771615,87.48736,4311040
3696,scoulomb,50,0.00116,3771665,87.48852,4311040
3697,tiffanyfay,50,0.00116,3771715,87.48968,4311040
3698,timmycarr,50,0.00116,3771765,87.49084,4311040
3699,tioxy,50,0.00116,3771815,87.49200,4311040
3700,vharsh,50,0.00116,3771865,87.49316,4311040
3701,yank1,50,0.00116,3771915,87.49432,4311040
3702,yhrn,50,0.00116,3771965,87.49548,4311040
3703,yolossn,50,0.00116,3772015,87.49664,4311040
3704,zackzhangkai,50,0.00116,3772065,87.49780,4311040
3705,21kyu,49,0.00114,3772114,87.49893,4311040
3706,anjensan,49,0.00114,3772163,87.50007,4311040
3707,Antiarchitect,49,0.00114,3772212,87.50121,4311040
3708,anusha-ragunathan,49,0.00114,3772261,87.50234,4311040
3709,armsnyder,49,0.00114,3772310,87.50348,4311040
3710,Arslanbekov,49,0.00114,3772359,87.50462,4311040
3711,avagin,49,0.00114,3772408,87.50575,4311040
3712,axot,49,0.00114,3772457,87.50689,4311040
3713,bcho,49,0.00114,3772506,87.50803,4311040
3714,cedriclam,49,0.00114,3772555,87.50916,4311040
3715,christophercarney,49,0.00114,3772604,87.51030,4311040
3716,cizezsy,49,0.00114,3772653,87.51144,4311040
3717,cmcconnell1,49,0.00114,3772702,87.51257,4311040
3718,Conan-Kudo,49,0.00114,3772751,87.51371,4311040
3719,cyb70289,49,0.00114,3772800,87.51485,4311040
3720,DanRoscigno,49,0.00114,3772849,87.51598,4311040
3721,derekperkins,49,0.00114,3772898,87.51712,4311040
3722,dezmodue,49,0.00114,3772947,87.51826,4311040
3723,eliaslevy,49,0.00114,3772996,87.51939,4311040
3724,fredleger,49,0.00114,3773045,87.52053,4311040
3725,FZhg,49,0.00114,3773094,87.52167,4311040
3726,GMartinez-Sisti,49,0.00114,3773143,87.52280,4311040
3727,Icedroid,49,0.00114,3773192,87.52394,4311040
3728,IvanovOleg,49,0.00114,3773241,87.52508,4311040
3729,jason-riddle,49,0.00114,3773290,87.52621,4311040
3730,kbruner,49,0.00114,3773339,87.52735,4311040
3731,kihahu,49,0.00114,3773388,87.52849,4311040
3732,m14815,49,0.00114,3773437,87.52962,4311040
3733,macb,49,0.00114,3773486,87.53076,4311040
3734,mateuszmatejczyk,49,0.00114,3773535,87.53189,4311040
3735,mkilchhofer,49,0.00114,3773584,87.53303,4311040
3736,MSSedusch,49,0.00114,3773633,87.53417,4311040
3737,nictuku,49,0.00114,3773682,87.53530,4311040
3738,PascalBourdier,49,0.00114,3773731,87.53644,4311040
3739,pci,49,0.00114,3773780,87.53758,4311040
3740,pshahzeb,49,0.00114,3773829,87.53871,4311040
3741,QianChenglong,49,0.00114,3773878,87.53985,4311040
3742,sattarfeizollahibarough,49,0.00114,3773927,87.54099,4311040
3743,SerialVelocity,49,0.00114,3773976,87.54212,4311040
3744,sethvargo,49,0.00114,3774025,87.54326,4311040
3745,venkatnsrinivasan,49,0.00114,3774074,87.54440,4311040
3746,vikas027,49,0.00114,3774123,87.54553,4311040
3747,vkhromov,49,0.00114,3774172,87.54667,4311040
3748,xtophs,49,0.00114,3774221,87.54781,4311040
3749,ystryuchkov,49,0.00114,3774270,87.54894,4311040
3750,zigmund,49,0.00114,3774319,87.55008,4311040
3751,zxh326,49,0.00114,3774368,87.55122,4311040
3752,AbelHu,48,0.00111,3774416,87.55233,4311040
3753,azweb76,48,0.00111,3774464,87.55344,4311040
3754,brandondr96,48,0.00111,3774512,87.55456,4311040
3755,brightzheng100,48,0.00111,3774560,87.55567,4311040
3756,bweston92,48,0.00111,3774608,87.55678,4311040
3757,crosbymichael,48,0.00111,3774656,87.55790,4311040
3758,dbcode,48,0.00111,3774704,87.55901,4311040
3759,distortedsignal,48,0.00111,3774752,87.56012,4311040
3760,dsbrng25b,48,0.00111,3774800,87.56124,4311040
3761,gunjan5,48,0.00111,3774848,87.56235,4311040
3762,Icarus9913,48,0.00111,3774896,87.56346,4311040
3763,insequent,48,0.00111,3774944,87.56458,4311040
3764,jbarrick-mesosphere,48,0.00111,3774992,87.56569,4311040
3765,juliafmorgado,48,0.00111,3775040,87.56681,4311040
3766,lakshya8066,48,0.00111,3775088,87.56792,4311040
3767,lewisheadden,48,0.00111,3775136,87.56903,4311040
3768,lindhe,48,0.00111,3775184,87.57015,4311040
3769,lkaybob,48,0.00111,3775232,87.57126,4311040
3770,marema31,48,0.00111,3775280,87.57237,4311040
3771,mlamina,48,0.00111,3775328,87.57349,4311040
3772,nareshku,48,0.00111,3775376,87.57460,4311040
3773,neiljerram,48,0.00111,3775424,87.57571,4311040
3774,paulsubrata55,48,0.00111,3775472,87.57683,4311040
3775,rbtr,48,0.00111,3775520,87.57794,4311040
3776,renehernandez,48,0.00111,3775568,87.57905,4311040
3777,rhtyd,48,0.00111,3775616,87.58017,4311040
3778,schrodit,48,0.00111,3775664,87.58128,4311040
3779,sculley,48,0.00111,3775712,87.58239,4311040
3780,Shawyeok,48,0.00111,3775760,87.58351,4311040
3781,StevenReitsma,48,0.00111,3775808,87.58462,4311040
3782,stijndehaes,48,0.00111,3775856,87.58573,4311040
3783,sunyuan3,48,0.00111,3775904,87.58685,4311040
3784,tdmalone,48,0.00111,3775952,87.58796,4311040
3785,vanekjar,48,0.00111,3776000,87.58907,4311040
3786,vithati,48,0.00111,3776048,87.59019,4311040
3787,yokawasa,48,0.00111,3776096,87.59130,4311040
3788,zioalex,48,0.00111,3776144,87.59241,4311040
3789,acnodal-tc,47,0.00109,3776191,87.59350,4311040
3790,adamnovak,47,0.00109,3776238,87.59459,4311040
3791,AevaOnline,47,0.00109,3776285,87.59568,4311040
3792,alegacy,47,0.00109,3776332,87.59677,4311040
3793,anhowe,47,0.00109,3776379,87.59787,4311040
3794,Ashwin901,47,0.00109,3776426,87.59896,4311040
3795,cduchesne,47,0.00109,3776473,87.60005,4311040
3796,congliu01,47,0.00109,3776520,87.60114,4311040
3797,den-is,47,0.00109,3776567,87.60223,4311040
3798,edwardecook,47,0.00109,3776614,87.60332,4311040
3799,GFilipek,47,0.00109,3776661,87.60441,4311040
3800,glb,47,0.00109,3776708,87.60550,4311040
3801,hach-que,47,0.00109,3776755,87.60659,4311040
3802,ian-howell,47,0.00109,3776802,87.60768,4311040
3803,jessesuen,47,0.00109,3776849,87.60877,4311040
3804,jlojosnegros,47,0.00109,3776896,87.60986,4311040
3805,jmnote,47,0.00109,3776943,87.61095,4311040
3806,jonaskello,47,0.00109,3776990,87.61204,4311040
3807,jsenon,47,0.00109,3777037,87.61313,4311040
3808,jstangroome,47,0.00109,3777084,87.61422,4311040
3809,krabhishek8260,47,0.00109,3777131,87.61531,4311040
3810,mansikulkarni96,47,0.00109,3777178,87.61640,4311040
3811,margocrawf,47,0.00109,3777225,87.61749,4311040
3812,mcayland,47,0.00109,3777272,87.61858,4311040
3813,michalno1,47,0.00109,3777319,87.61967,4311040
3814,msschl,47,0.00109,3777366,87.62076,4311040
3815,namusyaka,47,0.00109,3777413,87.62185,4311040
3816,q384566678,47,0.00109,3777460,87.62294,4311040
3817,rakesh-k,47,0.00109,3777507,87.62403,4311040
3818,rst0git,47,0.00109,3777554,87.62512,4311040
3819,s1061123,47,0.00109,3777601,87.62621,4311040
3820,Sispheor,47,0.00109,3777648,87.62730,4311040
3821,Smirl,47,0.00109,3777695,87.62839,4311040
3822,spikecurtis,47,0.00109,3777742,87.62948,4311040
3823,ssubramanian123,47,0.00109,3777789,87.63057,4311040
3824,stevebail,47,0.00109,3777836,87.63166,4311040
3825,thelinuxfoundation,47,0.00109,3777883,87.63275,4311040
3826,tomerf,47,0.00109,3777930,87.63384,4311040
3827,twz123,47,0.00109,3777977,87.63493,4311040
3828,vponomaryov,47,0.00109,3778024,87.63602,4311040
3829,whereismyjetpack,47,0.00109,3778071,87.63711,4311040
3830,wulonghui,47,0.00109,3778118,87.63820,4311040
3831,zacblazic,47,0.00109,3778165,87.63929,4311040
3832,zanetworker,47,0.00109,3778212,87.64038,4311040
3833,ahmedwaleedmalik,46,0.00107,3778258,87.64145,4311040
3834,andrewhowdencom,46,0.00107,3778304,87.64252,4311040
3835,andreychernih,46,0.00107,3778350,87.64358,4311040
3836,ArbelNathan,46,0.00107,3778396,87.64465,4311040
3837,Aryan-Deshpande,46,0.00107,3778442,87.64572,4311040
3838,asauber,46,0.00107,3778488,87.64679,4311040
3839,asridharan,46,0.00107,3778534,87.64785,4311040
3840,benmccann,46,0.00107,3778580,87.64892,4311040
3841,cnphil,46,0.00107,3778626,87.64999,4311040
3842,cornelius-keller,46,0.00107,3778672,87.65105,4311040
3843,danielSbastos,46,0.00107,3778718,87.65212,4311040
3844,Davidchinacloud,46,0.00107,3778764,87.65319,4311040
3845,divyasri537,46,0.00107,3778810,87.65426,4311040
3846,eosrei,46,0.00107,3778856,87.65532,4311040
3847,ericrrath,46,0.00107,3778902,87.65639,4311040
3848,evansheng,46,0.00107,3778948,87.65746,4311040
3849,eyeofthefrog,46,0.00107,3778994,87.65852,4311040
3850,fgutmann,46,0.00107,3779040,87.65959,4311040
3851,fmejia97,46,0.00107,3779086,87.66066,4311040
3852,four43,46,0.00107,3779132,87.66172,4311040
3853,Freyert,46,0.00107,3779178,87.66279,4311040
3854,jameskyle,46,0.00107,3779224,87.66386,4311040
3855,jkremser,46,0.00107,3779270,87.66493,4311040
3856,jnummelin,46,0.00107,3779316,87.66599,4311040
3857,jonpulsifer,46,0.00107,3779362,87.66706,4311040
3858,junxu,46,0.00107,3779408,87.66813,4311040
3859,justinmchase,46,0.00107,3779454,87.66919,4311040
3860,kebe7jun,46,0.00107,3779500,87.67026,4311040
3861,kshelton,46,0.00107,3779546,87.67133,4311040
3862,lawrencegripper,46,0.00107,3779592,87.67239,4311040
3863,luebken,46,0.00107,3779638,87.67346,4311040
3864,lvjiangzhao,46,0.00107,3779684,87.67453,4311040
3865,mariusgrigoriu,46,0.00107,3779730,87.67560,4311040
3866,metmajer,46,0.00107,3779776,87.67666,4311040
3867,mmingorance-dh,46,0.00107,3779822,87.67773,4311040
3868,mrcrgl,46,0.00107,3779868,87.67880,4311040
3869,nathanjsweet,46,0.00107,3779914,87.67986,4311040
3870,PhanLe1010,46,0.00107,3779960,87.68093,4311040
3871,RRAlex,46,0.00107,3780006,87.68200,4311040
3872,saltbo,46,0.00107,3780052,87.68306,4311040
3873,sesispla,46,0.00107,3780098,87.68413,4311040
3874,sreis,46,0.00107,3780144,87.68520,4311040
3875,takirala,46,0.00107,3780190,87.68627,4311040
3876,tangcong,46,0.00107,3780236,87.68733,4311040
3877,tweks,46,0.00107,3780282,87.68840,4311040
3878,vreon,46,0.00107,3780328,87.68947,4311040
3879,vvbogdanov87,46,0.00107,3780374,87.69053,4311040
3880,wb14123,46,0.00107,3780420,87.69160,4311040
3881,weisjohn,46,0.00107,3780466,87.69267,4311040
3882,yancl,46,0.00107,3780512,87.69374,4311040
3883,afsilvasantos,45,0.00104,3780557,87.69478,4311040
3884,andremarianiello,45,0.00104,3780602,87.69582,4311040
3885,bbbmj,45,0.00104,3780647,87.69687,4311040
3886,bowen5,45,0.00104,3780692,87.69791,4311040
3887,budhirajamadhav,45,0.00104,3780737,87.69895,4311040
3888,cab105,45,0.00104,3780782,87.70000,4311040
3889,ceeaspb,45,0.00104,3780827,87.70104,4311040
3890,chrisglass,45,0.00104,3780872,87.70209,4311040
3891,DarrienG,45,0.00104,3780917,87.70313,4311040
3892,darwin67,45,0.00104,3780962,87.70417,4311040
3893,dilyar85,45,0.00104,3781007,87.70522,4311040
3894,dleske,45,0.00104,3781052,87.70626,4311040
3895,dlespiau,45,0.00104,3781097,87.70730,4311040
3896,eflynn,45,0.00104,3781142,87.70835,4311040
3897,eltociear,45,0.00104,3781187,87.70939,4311040
3898,ericavonb,45,0.00104,3781232,87.71044,4311040
3899,fawadkhaliq,45,0.00104,3781277,87.71148,4311040
3900,flybd5,45,0.00104,3781322,87.71252,4311040
3901,frasertweedale,45,0.00104,3781367,87.71357,4311040
3902,GertiPoppel,45,0.00104,3781412,87.71461,4311040
3903,godliness,45,0.00104,3781457,87.71566,4311040
3904,haf,45,0.00104,3781502,87.71670,4311040
3905,JaredTan95,45,0.00104,3781547,87.71774,4311040
3906,jim-minter,45,0.00104,3781592,87.71879,4311040
3907,joncwong,45,0.00104,3781637,87.71983,4311040
3908,jonkerj,45,0.00104,3781682,87.72087,4311040
3909,joshkurz,45,0.00104,3781727,87.72192,4311040
3910,jouve,45,0.00104,3781772,87.72296,4311040
3911,kreempuff,45,0.00104,3781817,87.72401,4311040
3912,ktock,45,0.00104,3781862,87.72505,4311040
3913,KyleMartin901,45,0.00104,3781907,87.72609,4311040
3914,latteczy,45,0.00104,3781952,87.72714,4311040
3915,loozhengyuan,45,0.00104,3781997,87.72818,4311040
3916,machadovilaca,45,0.00104,3782042,87.72923,4311040
3917,markmandel,45,0.00104,3782087,87.73027,4311040
3918,maxgio92,45,0.00104,3782132,87.73131,4311040
3919,mgabeler-lee-6rs,45,0.00104,3782177,87.73236,4311040
3920,MrTrustor,45,0.00104,3782222,87.73340,4311040
3921,n1r1,45,0.00104,3782267,87.73444,4311040
3922,naisanza,45,0.00104,3782312,87.73549,4311040
3923,phillipsj,45,0.00104,3782357,87.73653,4311040
3924,PratikDeoghare,45,0.00104,3782402,87.73758,4311040
3925,PxyUp,45,0.00104,3782447,87.73862,4311040
3926,rohitagarwal003,45,0.00104,3782492,87.73966,4311040
3927,sashayakovtseva,45,0.00104,3782537,87.74071,4311040
3928,SayakMukhopadhyay,45,0.00104,3782582,87.74175,4311040
3929,sbdtu5498,45,0.00104,3782627,87.74280,4311040
3930,seeekr,45,0.00104,3782672,87.74384,4311040
3931,sgotti,45,0.00104,3782717,87.74488,4311040
3932,stuart-warren,45,0.00104,3782762,87.74593,4311040
3933,tomoe,45,0.00104,3782807,87.74697,4311040
3934,tony-clarke-amdocs,45,0.00104,3782852,87.74801,4311040
3935,tylerje,45,0.00104,3782897,87.74906,4311040
3936,v1k0d3n,45,0.00104,3782942,87.75010,4311040
3937,vivek-koppuru,45,0.00104,3782987,87.75115,4311040
3938,voigt,45,0.00104,3783032,87.75219,4311040
3939,vsimon,45,0.00104,3783077,87.75323,4311040
3940,weekface,45,0.00104,3783122,87.75428,4311040
3941,xiaods,45,0.00104,3783167,87.75532,4311040
3942,xuexu6666,45,0.00104,3783212,87.75637,4311040
3943,z0rc,45,0.00104,3783257,87.75741,4311040
3944,100mik,44,0.00102,3783301,87.75843,4311040
3945,AdamKorcz,44,0.00102,3783345,87.75945,4311040
3946,AmitSahastra,44,0.00102,3783389,87.76047,4311040
3947,Avni-Sharma,44,0.00102,3783433,87.76149,4311040
3948,bmorettodama,44,0.00102,3783477,87.76251,4311040
3949,brsolomon-deloitte,44,0.00102,3783521,87.76353,4311040
3950,chief93,44,0.00102,3783565,87.76455,4311040
3951,cjyabraham,44,0.00102,3783609,87.76557,4311040
3952,ddymko,44,0.00102,3783653,87.76659,4311040
3953,dkarlovi,44,0.00102,3783697,87.76762,4311040
3954,drpaneas,44,0.00102,3783741,87.76864,4311040
3955,ebriand,44,0.00102,3783785,87.76966,4311040
3956,erulabs,44,0.00102,3783829,87.77068,4311040
3957,estesp,44,0.00102,3783873,87.77170,4311040
3958,fhemberger,44,0.00102,3783917,87.77272,4311040
3959,gclawes,44,0.00102,3783961,87.77374,4311040
3960,grosskur,44,0.00102,3784005,87.77476,4311040
3961,hklai,44,0.00102,3784049,87.77578,4311040
3962,hwoarang,44,0.00102,3784093,87.77680,4311040
3963,jjacobelli,44,0.00102,3784137,87.77782,4311040
3964,jrperritt,44,0.00102,3784181,87.77884,4311040
3965,jveski,44,0.00102,3784225,87.77986,4311040
3966,kmadnani,44,0.00102,3784269,87.78088,4311040
3967,linsun,44,0.00102,3784313,87.78190,4311040
3968,littleroad,44,0.00102,3784357,87.78292,4311040
3969,lujinda,44,0.00102,3784401,87.78395,4311040
3970,mccare,44,0.00102,3784445,87.78497,4311040
3971,micheleorsi,44,0.00102,3784489,87.78599,4311040
3972,mzylowski,44,0.00102,3784533,87.78701,4311040
3973,odacremolbap,44,0.00102,3784577,87.78803,4311040
3974,ozevren,44,0.00102,3784621,87.78905,4311040
3975,paullaffitte,44,0.00102,3784665,87.79007,4311040
3976,PranshuSrivastava,44,0.00102,3784709,87.79109,4311040
3977,prune998,44,0.00102,3784753,87.79211,4311040
3978,prydie,44,0.00102,3784797,87.79313,4311040
3979,shahiddev,44,0.00102,3784841,87.79415,4311040
3980,stamak,44,0.00102,3784885,87.79517,4311040
3981,taherv,44,0.00102,3784929,87.79619,4311040
3982,tbarrella,44,0.00102,3784973,87.79721,4311040
3983,timuthy,44,0.00102,3785017,87.79823,4311040
3984,vinayagg,44,0.00102,3785061,87.79925,4311040
3985,wasylkowski-a,44,0.00102,3785105,87.80028,4311040
3986,yowenter,44,0.00102,3785149,87.80130,4311040
3987,yuanying,44,0.00102,3785193,87.80232,4311040
3988,zembutsu,44,0.00102,3785237,87.80334,4311040
3989,Akasurde,43,0.00100,3785280,87.80433,4311040
3990,alex88,43,0.00100,3785323,87.80533,4311040
3991,bgilbert,43,0.00100,3785366,87.80633,4311040
3992,boluisa,43,0.00100,3785409,87.80733,4311040
3993,bzon,43,0.00100,3785452,87.80832,4311040
3994,DavidParks8,43,0.00100,3785495,87.80932,4311040
3995,Deepthidharwar,43,0.00100,3785538,87.81032,4311040
3996,dharmjit,43,0.00100,3785581,87.81132,4311040
3997,dkirrane,43,0.00100,3785624,87.81231,4311040
3998,eddytruyen,43,0.00100,3785667,87.81331,4311040
3999,eghobo,43,0.00100,3785710,87.81431,4311040
4000,gdhuper,43,0.00100,3785753,87.81531,4311040
4001,huxiaoliang,43,0.00100,3785796,87.81630,4311040
4002,jasonrichardsmith,43,0.00100,3785839,87.81730,4311040
4003,jjmengze,43,0.00100,3785882,87.81830,4311040
4004,jmcdonagh,43,0.00100,3785925,87.81930,4311040
4005,joao-luna-98,43,0.00100,3785968,87.82029,4311040
4006,JocelynBerrendonner,43,0.00100,3786011,87.82129,4311040
4007,johanhaleby,43,0.00100,3786054,87.82229,4311040
4008,kaivalya97,43,0.00100,3786097,87.82329,4311040
4009,kaiwalyakoparkar,43,0.00100,3786140,87.82428,4311040
4010,kangarlou,43,0.00100,3786183,87.82528,4311040
4011,kschumy,43,0.00100,3786226,87.82628,4311040
4012,lafh,43,0.00100,3786269,87.82728,4311040
4013,liyanyanli,43,0.00100,3786312,87.82827,4311040
4014,marload,43,0.00100,3786355,87.82927,4311040
4015,mazzystr,43,0.00100,3786398,87.83027,4311040
4016,melnikalex,43,0.00100,3786441,87.83127,4311040
4017,Misteur-Z,43,0.00100,3786484,87.83226,4311040
4018,mrostecki,43,0.00100,3786527,87.83326,4311040
4019,nelvadas,43,0.00100,3786570,87.83426,4311040
4020,Nitishupkr,43,0.00100,3786613,87.83526,4311040
4021,opeco17,43,0.00100,3786656,87.83625,4311040
4022,paulcarlton-ww,43,0.00100,3786699,87.83725,4311040
4023,paultiplady,43,0.00100,3786742,87.83825,4311040
4024,pbitty,43,0.00100,3786785,87.83925,4311040
4025,pcj,43,0.00100,3786828,87.84024,4311040
4026,prashima,43,0.00100,3786871,87.84124,4311040
4027,qq690388648,43,0.00100,3786914,87.84224,4311040
4028,rayterrill,43,0.00100,3786957,87.84324,4311040
4029,robbiemcmichael,43,0.00100,3787000,87.84423,4311040
4030,rosskirkpat,43,0.00100,3787043,87.84523,4311040
4031,ryokotmng,43,0.00100,3787086,87.84623,4311040
4032,scottd018,43,0.00100,3787129,87.84722,4311040
4033,sekka1,43,0.00100,3787172,87.84822,4311040
4034,shogohida,43,0.00100,3787215,87.84922,4311040
4035,shreesha21,43,0.00100,3787258,87.85022,4311040
4036,shubhbapna,43,0.00100,3787301,87.85121,4311040
4037,slack,43,0.00100,3787344,87.85221,4311040
4038,soulseen,43,0.00100,3787387,87.85321,4311040
4039,spacexnice,43,0.00100,3787430,87.85421,4311040
4040,sureshpalemoni,43,0.00100,3787473,87.85520,4311040
4041,swiftdiaries,43,0.00100,3787516,87.85620,4311040
4042,swinslow,43,0.00100,3787559,87.85720,4311040
4043,syscll,43,0.00100,3787602,87.85820,4311040
4044,tmurakam,43,0.00100,3787645,87.85919,4311040
4045,trinitronx,43,0.00100,3787688,87.86019,4311040
4046,tyrannasaurusbanks,43,0.00100,3787731,87.86119,4311040
4047,voro015,43,0.00100,3787774,87.86219,4311040
4048,wxb0521,43,0.00100,3787817,87.86318,4311040
4049,xuhdev,43,0.00100,3787860,87.86418,4311040
4050,yuyangbj,43,0.00100,3787903,87.86518,4311040
4051,2014BDuck,42,0.00097,3787945,87.86615,4311040
4052,andor44,42,0.00097,3787987,87.86713,4311040
4053,andreykaipov,42,0.00097,3788029,87.86810,4311040
4054,Ankit152,42,0.00097,3788071,87.86908,4311040
4055,anyulled,42,0.00097,3788113,87.87005,4311040
4056,attlee-wang,42,0.00097,3788155,87.87102,4311040
4057,bergerx,42,0.00097,3788197,87.87200,4311040
4058,bgagnon,42,0.00097,3788239,87.87297,4311040
4059,bhavin192,42,0.00097,3788281,87.87395,4311040
4060,brian-brazil,42,0.00097,3788323,87.87492,4311040
4061,Chenditang,42,0.00097,3788365,87.87590,4311040
4062,chhanz,42,0.00097,3788407,87.87687,4311040
4063,christianjoun,42,0.00097,3788449,87.87784,4311040
4064,Constantin07,42,0.00097,3788491,87.87882,4311040
4065,ctalledo,42,0.00097,3788533,87.87979,4311040
4066,erusso7,42,0.00097,3788575,87.88077,4311040
4067,etiennecoutaud,42,0.00097,3788617,87.88174,4311040
4068,etiennetremel,42,0.00097,3788659,87.88272,4311040
4069,gorda,42,0.00097,3788701,87.88369,4311040
4070,haoqing0110,42,0.00097,3788743,87.88466,4311040
4071,haugenj,42,0.00097,3788785,87.88564,4311040
4072,heidecke,42,0.00097,3788827,87.88661,4311040
4073,iawia002,42,0.00097,3788869,87.88759,4311040
4074,ijl,42,0.00097,3788911,87.88856,4311040
4075,InAnimaTe,42,0.00097,3788953,87.88953,4311040
4076,itajaja,42,0.00097,3788995,87.89051,4311040
4077,jan--f,42,0.00097,3789037,87.89148,4311040
4078,javefang,42,0.00097,3789079,87.89246,4311040
4079,jaxxstorm,42,0.00097,3789121,87.89343,4311040
4080,joeatwork,42,0.00097,3789163,87.89441,4311040
4081,Jukie,42,0.00097,3789205,87.89538,4311040
4082,kenmaglio,42,0.00097,3789247,87.89635,4311040
4083,legal90,42,0.00097,3789289,87.89733,4311040
4084,leki75,42,0.00097,3789331,87.89830,4311040
4085,luohao,42,0.00097,3789373,87.89928,4311040
4086,manikanth04,42,0.00097,3789415,87.90025,4311040
4087,Marusyk,42,0.00097,3789457,87.90123,4311040
4088,mashayev,42,0.00097,3789499,87.90220,4311040
4089,matlockx,42,0.00097,3789541,87.90317,4311040
4090,MatMaul,42,0.00097,3789583,87.90415,4311040
4091,mdianjun,42,0.00097,3789625,87.90512,4311040
4092,mheese,42,0.00097,3789667,87.90610,4311040
4093,michaelhenkel,42,0.00097,3789709,87.90707,4311040
4094,Monkeyanator,42,0.00097,3789751,87.90805,4311040
4095,mr-yaky,42,0.00097,3789793,87.90902,4311040
4096,mshaverdo,42,0.00097,3789835,87.90999,4311040
4097,obeyda,42,0.00097,3789877,87.91097,4311040
4098,oded-dd,42,0.00097,3789919,87.91194,4311040
4099,ohsewon,42,0.00097,3789961,87.91292,4311040
4100,petermetz,42,0.00097,3790003,87.91389,4311040
4101,petervo,42,0.00097,3790045,87.91487,4311040
4102,pradeep-hegde,42,0.00097,3790087,87.91584,4311040
4103,RafaeLeal,42,0.00097,3790129,87.91681,4311040
4104,razic,42,0.00097,3790171,87.91779,4311040
4105,saiyam1814,42,0.00097,3790213,87.91876,4311040
4106,sandeeppsunny,42,0.00097,3790255,87.91974,4311040
4107,sfudeus,42,0.00097,3790297,87.92071,4311040
4108,sosiouxme,42,0.00097,3790339,87.92168,4311040
4109,spagno,42,0.00097,3790381,87.92266,4311040
4110,stefansedich,42,0.00097,3790423,87.92363,4311040
4111,SuperQ,42,0.00097,3790465,87.92461,4311040
4112,ThisIsQasim,42,0.00097,3790507,87.92558,4311040
4113,tomkukral,42,0.00097,3790549,87.92656,4311040
4114,ursuad,42,0.00097,3790591,87.92753,4311040
4115,varshavaradarajan,42,0.00097,3790633,87.92850,4311040
4116,wjiangjay,42,0.00097,3790675,87.92948,4311040
4117,yangl900,42,0.00097,3790717,87.93045,4311040
4118,youyongsong,42,0.00097,3790759,87.93143,4311040
4119,ysy2020,42,0.00097,3790801,87.93240,4311040
4120,yuha0,42,0.00097,3790843,87.93338,4311040
4121,zchee,42,0.00097,3790885,87.93435,4311040
4122,zdxgs,42,0.00097,3790927,87.93532,4311040
4123,zelenushechka,42,0.00097,3790969,87.93630,4311040
4124,zhgwenming,42,0.00097,3791011,87.93727,4311040
4125,24sama,41,0.00095,3791052,87.93822,4311040
4126,aagusuab,41,0.00095,3791093,87.93917,4311040
4127,alam0rt,41,0.00095,3791134,87.94013,4311040
4128,anapsix,41,0.00095,3791175,87.94108,4311040
4129,annProg,41,0.00095,3791216,87.94203,4311040
4130,apatil,41,0.00095,3791257,87.94298,4311040
4131,appledaily0,41,0.00095,3791298,87.94393,4311040
4132,ask0n,41,0.00095,3791339,87.94488,4311040
4133,baldwinSPC,41,0.00095,3791380,87.94583,4311040
4134,boeboe,41,0.00095,3791421,87.94678,4311040
4135,Bregor,41,0.00095,3791462,87.94773,4311040
4136,BrianKopp,41,0.00095,3791503,87.94869,4311040
4137,caniko,41,0.00095,3791544,87.94964,4311040
4138,Capstan,41,0.00095,3791585,87.95059,4311040
4139,chbatey,41,0.00095,3791626,87.95154,4311040
4140,chekolyn,41,0.00095,3791667,87.95249,4311040
4141,chengyli,41,0.00095,3791708,87.95344,4311040
4142,christhomas,41,0.00095,3791749,87.95439,4311040
4143,code-sleuth,41,0.00095,3791790,87.95534,4311040
4144,coreypobrien,41,0.00095,3791831,87.95629,4311040
4145,cubxxw,41,0.00095,3791872,87.95724,4311040
4146,curtisallen,41,0.00095,3791913,87.95820,4311040
4147,dansimone,41,0.00095,3791954,87.95915,4311040
4148,dejanb,41,0.00095,3791995,87.96010,4311040
4149,edvald,41,0.00095,3792036,87.96105,4311040
4150,elisiano,41,0.00095,3792077,87.96200,4311040
4151,feelobot,41,0.00095,3792118,87.96295,4311040
4152,gaeljw,41,0.00095,3792159,87.96390,4311040
4153,gazal-k,41,0.00095,3792200,87.96485,4311040
4154,haizaar,41,0.00095,3792241,87.96580,4311040
4155,hanjiayao,41,0.00095,3792282,87.96676,4311040
4156,headcr4sh,41,0.00095,3792323,87.96771,4311040
4157,iAnomaly,41,0.00095,3792364,87.96866,4311040
4158,idcrook,41,0.00095,3792405,87.96961,4311040
4159,jeremywadsack,41,0.00095,3792446,87.97056,4311040
4160,jonaz,41,0.00095,3792487,87.97151,4311040
4161,JonPulsifer,41,0.00095,3792528,87.97246,4311040
4162,k2huang,41,0.00095,3792569,87.97341,4311040
4163,khyew,41,0.00095,3792610,87.97436,4311040
4164,klizhentas,41,0.00095,3792651,87.97531,4311040
4165,LalatenduMohanty,41,0.00095,3792692,87.97627,4311040
4166,liuyuan10,41,0.00095,3792733,87.97722,4311040
4167,locmai,41,0.00095,3792774,87.97817,4311040
4168,maximrub,41,0.00095,3792815,87.97912,4311040
4169,mcronce,41,0.00095,3792856,87.98007,4311040
4170,mhrivnak,41,0.00095,3792897,87.98102,4311040
4171,mnussbaum,41,0.00095,3792938,87.98197,4311040
4172,mogren,41,0.00095,3792979,87.98292,4311040
4173,mvisonneau,41,0.00095,3793020,87.98387,4311040
4174,nicknovitski,41,0.00095,3793061,87.98483,4311040
4175,ohmystack,41,0.00095,3793102,87.98578,4311040
4176,OJFord,41,0.00095,3793143,87.98673,4311040
4177,RochesterinNYC,41,0.00095,3793184,87.98768,4311040
4178,Rohitrajak1807,41,0.00095,3793225,87.98863,4311040
4179,rquitales,41,0.00095,3793266,87.98958,4311040
4180,SatoruItaya,41,0.00095,3793307,87.99053,4311040
4181,sebgl,41,0.00095,3793348,87.99148,4311040
4182,sherifabdlnaby,41,0.00095,3793389,87.99243,4311040
4183,spencer-p,41,0.00095,3793430,87.99338,4311040
4184,sputnik13,41,0.00095,3793471,87.99434,4311040
4185,srinivashegde86,41,0.00095,3793512,87.99529,4311040
4186,sunny-b,41,0.00095,3793553,87.99624,4311040
4187,sysrich,41,0.00095,3793594,87.99719,4311040
4188,tkms0106,41,0.00095,3793635,87.99814,4311040
4189,tsenart,41,0.00095,3793676,87.99909,4311040
4190,zquestz,41,0.00095,3793717,88.00004,4311040
4191,ablock84,40,0.00093,3793757,88.00097,4311040
4192,aburdenthehand,40,0.00093,3793797,88.00190,4311040
4193,AlekSi,40,0.00093,3793837,88.00283,4311040
4194,andrewmichaelsmith,40,0.00093,3793877,88.00375,4311040
4195,andrewstuart,40,0.00093,3793917,88.00468,4311040
4196,arjanschaaf,40,0.00093,3793957,88.00561,4311040
4197,billyshambrook,40,0.00093,3793997,88.00654,4311040
4198,BobbyJohansen,40,0.00093,3794037,88.00746,4311040
4199,bobcatfish,40,0.00093,3794077,88.00839,4311040
4200,Boutheina-Dab,40,0.00093,3794117,88.00932,4311040
4201,cadeniyi,40,0.00093,3794157,88.01025,4311040
4202,carldanley,40,0.00093,3794197,88.01118,4311040
4203,chaochn47,40,0.00093,3794237,88.01210,4311040
4204,christianhuening,40,0.00093,3794277,88.01303,4311040
4205,conwaychriscosmo,40,0.00093,3794317,88.01396,4311040
4206,CristianHenzel,40,0.00093,3794357,88.01489,4311040
4207,cv,40,0.00093,3794397,88.01582,4311040
4208,DaveAurionix,40,0.00093,3794437,88.01674,4311040
4209,david-martin,40,0.00093,3794477,88.01767,4311040
4210,dbazhal,40,0.00093,3794517,88.01860,4311040
4211,dongqi1990,40,0.00093,3794557,88.01953,4311040
4212,eliaskoromilas,40,0.00093,3794597,88.02045,4311040
4213,erimatnor,40,0.00093,3794637,88.02138,4311040
4214,erstaples,40,0.00093,3794677,88.02231,4311040
4215,gobomb,40,0.00093,3794717,88.02324,4311040
4216,grobie,40,0.00093,3794757,88.02417,4311040
4217,HarryStericker,40,0.00093,3794797,88.02509,4311040
4218,jjungnickel,40,0.00093,3794837,88.02602,4311040
4219,joekohlsdorf,40,0.00093,3794877,88.02695,4311040
4220,josdotso,40,0.00093,3794917,88.02788,4311040
4221,jukie,40,0.00093,3794957,88.02881,4311040
4222,JulienBreux,40,0.00093,3794997,88.02973,4311040
4223,jvanz,40,0.00093,3795037,88.03066,4311040
4224,jvitor83,40,0.00093,3795077,88.03159,4311040
4225,Kaffa-MY,40,0.00093,3795117,88.03252,4311040
4226,KatrinaHoffert,40,0.00093,3795157,88.03344,4311040
4227,khalilswdp,40,0.00093,3795197,88.03437,4311040
4228,linkvt,40,0.00093,3795237,88.03530,4311040
4229,Lirt,40,0.00093,3795277,88.03623,4311040
4230,lwolf,40,0.00093,3795317,88.03716,4311040
4231,mahmut-Abi,40,0.00093,3795357,88.03808,4311040
4232,mariuskimmina,40,0.00093,3795397,88.03901,4311040
4233,mohamedsgap,40,0.00093,3795437,88.03994,4311040
4234,nielsole,40,0.00093,3795477,88.04087,4311040
4235,nmittler,40,0.00093,3795517,88.04180,4311040
4236,pgnaleen,40,0.00093,3795557,88.04272,4311040
4237,phiphi282,40,0.00093,3795597,88.04365,4311040
4238,PierrickI3,40,0.00093,3795637,88.04458,4311040
4239,pperiyasamy,40,0.00093,3795677,88.04551,4311040
4240,RaghavRoy145,40,0.00093,3795717,88.04643,4311040
4241,ramitsurana,40,0.00093,3795757,88.04736,4311040
4242,rpluem-vf,40,0.00093,3795797,88.04829,4311040
4243,runningwild,40,0.00093,3795837,88.04922,4311040
4244,sagikazarmark,40,0.00093,3795877,88.05015,4311040
4245,sahilvv,40,0.00093,3795917,88.05107,4311040
4246,segevfiner,40,0.00093,3795957,88.05200,4311040
4247,soupdiver,40,0.00093,3795997,88.05293,4311040
4248,stibi,40,0.00093,3796037,88.05386,4311040
4249,sujil02,40,0.00093,3796077,88.05478,4311040
4250,tasdikrahman,40,0.00093,3796117,88.05571,4311040
4251,TeddyAndrieux,40,0.00093,3796157,88.05664,4311040
4252,thommay,40,0.00093,3796197,88.05757,4311040
4253,unixwitch,40,0.00093,3796237,88.05850,4311040
4254,vonsago,40,0.00093,3796277,88.05942,4311040
4255,wangao1236,40,0.00093,3796317,88.06035,4311040
4256,WillPlatnick,40,0.00093,3796357,88.06128,4311040
4257,aabouzaid,39,0.00090,3796396,88.06218,4311040
4258,bashofmann,39,0.00090,3796435,88.06309,4311040
4259,bdbauer,39,0.00090,3796474,88.06399,4311040
4260,beekhof,39,0.00090,3796513,88.06490,4311040
4261,Benjamintf1,39,0.00090,3796552,88.06580,4311040
4262,beorn7,39,0.00090,3796591,88.06671,4311040
4263,binarybana,39,0.00090,3796630,88.06761,4311040
4264,bjlee72,39,0.00090,3796669,88.06852,4311040
4265,buptliuwei,39,0.00090,3796708,88.06942,4311040
4266,Cherishty,39,0.00090,3796747,88.07033,4311040
4267,chlung,39,0.00090,3796786,88.07123,4311040
4268,clandry94,39,0.00090,3796825,88.07214,4311040
4269,clarkmcc,39,0.00090,3796864,88.07304,4311040
4270,clubanderson,39,0.00090,3796903,88.07395,4311040
4271,ctron,39,0.00090,3796942,88.07485,4311040
4272,damongant,39,0.00090,3796981,88.07575,4311040
4273,djmgit,39,0.00090,3797020,88.07666,4311040
4274,dwradcliffe,39,0.00090,3797059,88.07756,4311040
4275,felipecrs,39,0.00090,3797098,88.07847,4311040
4276,gaozhenhai,39,0.00090,3797137,88.07937,4311040
4277,gertipoppel,39,0.00090,3797176,88.08028,4311040
4278,hantmac,39,0.00090,3797215,88.08118,4311040
4279,harshvkarn,39,0.00090,3797254,88.08209,4311040
4280,hoelzro,39,0.00090,3797293,88.08299,4311040
4281,houfangdong,39,0.00090,3797332,88.08390,4311040
4282,ismailyenigul,39,0.00090,3797371,88.08480,4311040
4283,jian-he,39,0.00090,3797410,88.08571,4311040
4284,judkowitz,39,0.00090,3797449,88.08661,4311040
4285,JuJu227,39,0.00090,3797488,88.08751,4311040
4286,junaid-ali,39,0.00090,3797527,88.08842,4311040
4287,juris,39,0.00090,3797566,88.08932,4311040
4288,kanolato,39,0.00090,3797605,88.09023,4311040
4289,koep,39,0.00090,3797644,88.09113,4311040
4290,kon-angelo,39,0.00090,3797683,88.09204,4311040
4291,kscharm,39,0.00090,3797722,88.09294,4311040
4292,LittleFox94,39,0.00090,3797761,88.09385,4311040
4293,manishbansal8843,39,0.00090,3797800,88.09475,4311040
4294,maxbrunet,39,0.00090,3797839,88.09566,4311040
4295,mirahmed753,39,0.00090,3797878,88.09656,4311040
4296,miramar-labs,39,0.00090,3797917,88.09747,4311040
4297,MonzElmasry,39,0.00090,3797956,88.09837,4311040
4298,mscherer,39,0.00090,3797995,88.09928,4311040
4299,mzyfree,39,0.00090,3798034,88.10018,4311040
4300,nagarjung,39,0.00090,3798073,88.10108,4311040
4301,Nodraak,39,0.00090,3798112,88.10199,4311040
4302,nqn,39,0.00090,3798151,88.10289,4311040
4303,palash25,39,0.00090,3798190,88.10380,4311040
4304,pdbogen,39,0.00090,3798229,88.10470,4311040
4305,Prabhakar-17,39,0.00090,3798268,88.10561,4311040
4306,praveenrewar,39,0.00090,3798307,88.10651,4311040
4307,renatoviana12,39,0.00090,3798346,88.10742,4311040
4308,rralcala,39,0.00090,3798385,88.10832,4311040
4309,samuela,39,0.00090,3798424,88.10923,4311040
4310,shintard,39,0.00090,3798463,88.11013,4311040
4311,Shrugs,39,0.00090,3798502,88.11104,4311040
4312,skarthiksrinivas,39,0.00090,3798541,88.11194,4311040
4313,spradeepv,39,0.00090,3798580,88.11285,4311040
4314,stamm,39,0.00090,3798619,88.11375,4311040
4315,stefanprodan,39,0.00090,3798658,88.11465,4311040
4316,SyamSundarKirubakaran,39,0.00090,3798697,88.11556,4311040
4317,tcnksm,39,0.00090,3798736,88.11646,4311040
4318,thcdrt,39,0.00090,3798775,88.11737,4311040
4319,TheBeatles1994,39,0.00090,3798814,88.11827,4311040
4320,thucatebay,39,0.00090,3798853,88.11918,4311040
4321,Trackhe,39,0.00090,3798892,88.12008,4311040
4322,unclejack,39,0.00090,3798931,88.12099,4311040
4323,venezia,39,0.00090,3798970,88.12189,4311040
4324,vinceprignano,39,0.00090,3799009,88.12280,4311040
4325,xeor,39,0.00090,3799048,88.12370,4311040
4326,xiezongzhe,39,0.00090,3799087,88.12461,4311040
4327,AaronFriel,38,0.00088,3799125,88.12549,4311040
4328,adrcunha,38,0.00088,3799163,88.12637,4311040
4329,agadelshin,38,0.00088,3799201,88.12725,4311040
4330,Akrog,38,0.00088,3799239,88.12813,4311040
4331,akshayamadhuri,38,0.00088,3799277,88.12901,4311040
4332,al45tair,38,0.00088,3799315,88.12989,4311040
4333,andsens,38,0.00088,3799353,88.13078,4311040
4334,arno01,38,0.00088,3799391,88.13166,4311040
4335,bharaththiruveedula,38,0.00088,3799429,88.13254,4311040
4336,bjethwan,38,0.00088,3799467,88.13342,4311040
4337,bodepd,38,0.00088,3799505,88.13430,4311040
4338,calmkart,38,0.00088,3799543,88.13518,4311040
4339,canhnt,38,0.00088,3799581,88.13606,4311040
4340,cbonte,38,0.00088,3799619,88.13695,4311040
4341,cesartl,38,0.00088,3799657,88.13783,4311040
4342,chenlin07,38,0.00088,3799695,88.13871,4311040
4343,ChenLingPeng,38,0.00088,3799733,88.13959,4311040
4344,chrismoos,38,0.00088,3799771,88.14047,4311040
4345,ckleban,38,0.00088,3799809,88.14135,4311040
4346,ctrox,38,0.00088,3799847,88.14223,4311040
4347,dgl,38,0.00088,3799885,88.14312,4311040
4348,djablonski-moia,38,0.00088,3799923,88.14400,4311040
4349,djosborne,38,0.00088,3799961,88.14488,4311040
4350,dqminh,38,0.00088,3799999,88.14576,4311040
4351,dstrebel,38,0.00088,3800037,88.14664,4311040
4352,erikwilson,38,0.00088,3800075,88.14752,4311040
4353,gregsidelinger,38,0.00088,3800113,88.14841,4311040
4354,harishspqr,38,0.00088,3800151,88.14929,4311040
4355,hlee95,38,0.00088,3800189,88.15017,4311040
4356,HoustonPutman,38,0.00088,3800227,88.15105,4311040
4357,hridyeshpant,38,0.00088,3800265,88.15193,4311040
4358,iameli,38,0.00088,3800303,88.15281,4311040
4359,irfanjs,38,0.00088,3800341,88.15369,4311040
4360,istalker2,38,0.00088,3800379,88.15458,4311040
4361,jenningsloy318,38,0.00088,3800417,88.15546,4311040
4362,joelittlejohn,38,0.00088,3800455,88.15634,4311040
4363,jroper,38,0.00088,3800493,88.15722,4311040
4364,justechn,38,0.00088,3800531,88.15810,4311040
4365,keglevich3,38,0.00088,3800569,88.15898,4311040
4366,kevensen,38,0.00088,3800607,88.15986,4311040
4367,kfr2,38,0.00088,3800645,88.16075,4311040
4368,kimxogus,38,0.00088,3800683,88.16163,4311040
4369,KuberDriver,38,0.00088,3800721,88.16251,4311040
4370,luarx,38,0.00088,3800759,88.16339,4311040
4371,Lukenickerson,38,0.00088,3800797,88.16427,4311040
4372,manoj-nutanix,38,0.00088,3800835,88.16515,4311040
4373,martinmosegaard,38,0.00088,3800873,88.16603,4311040
4374,mateuszdrab,38,0.00088,3800911,88.16692,4311040
4375,neeleshkorade,38,0.00088,3800949,88.16780,4311040
4376,nixgadget,38,0.00088,3800987,88.16868,4311040
4377,ofek,38,0.00088,3801025,88.16956,4311040
4378,petergardfjall,38,0.00088,3801063,88.17044,4311040
4379,petrutlucian94,38,0.00088,3801101,88.17132,4311040
4380,phillebaba,38,0.00088,3801139,88.17220,4311040
4381,Polokghosh53,38,0.00088,3801177,88.17309,4311040
4382,radeksm,38,0.00088,3801215,88.17397,4311040
4383,rahulkrishnanfs,38,0.00088,3801253,88.17485,4311040
4384,rgarcia89,38,0.00088,3801291,88.17573,4311040
4385,rodrigodelmonte,38,0.00088,3801329,88.17661,4311040
4386,sdodson,38,0.00088,3801367,88.17749,4311040
4387,skelterjohn,38,0.00088,3801405,88.17837,4311040
4388,Sryther,38,0.00088,3801443,88.17926,4311040
4389,sunminjeon,38,0.00088,3801481,88.18014,4311040
4390,thefirstofthe300,38,0.00088,3801519,88.18102,4311040
4391,TomasTomecek,38,0.00088,3801557,88.18190,4311040
4392,tomwilkie,38,0.00088,3801595,88.18278,4311040
4393,vasrem,38,0.00088,3801633,88.18366,4311040
4394,williamsandrew,38,0.00088,3801671,88.18454,4311040
4395,w-leads,38,0.00088,3801709,88.18543,4311040
4396,YueHonghui,38,0.00088,3801747,88.18631,4311040
4397,zehicle,38,0.00088,3801785,88.18719,4311040
4398,ZhengZhenyu,38,0.00088,3801823,88.18807,4311040
4399,adracus,37,0.00086,3801860,88.18893,4311040
4400,adrianmoisey,37,0.00086,3801897,88.18979,4311040
4401,aerostitch,37,0.00086,3801934,88.19065,4311040
4402,agarg2008,37,0.00086,3801971,88.19150,4311040
4403,AljoschaP,37,0.00086,3802008,88.19236,4311040
4404,atishn,37,0.00086,3802045,88.19322,4311040
4405,atulaggarwal,37,0.00086,3802082,88.19408,4311040
4406,auhlig,37,0.00086,3802119,88.19494,4311040
4407,bfournie,37,0.00086,3802156,88.19579,4311040
4408,broady,37,0.00086,3802193,88.19665,4311040
4409,bwells,37,0.00086,3802230,88.19751,4311040
4410,bygui86,37,0.00086,3802267,88.19837,4311040
4411,cameronbraid,37,0.00086,3802304,88.19923,4311040
4412,castroricardo1,37,0.00086,3802341,88.20009,4311040
4413,cescoferraro,37,0.00086,3802378,88.20094,4311040
4414,dannymk,37,0.00086,3802415,88.20180,4311040
4415,danopia,37,0.00086,3802452,88.20266,4311040
4416,desponda,37,0.00086,3802489,88.20352,4311040
4417,dineshba,37,0.00086,3802526,88.20438,4311040
4418,dmick,37,0.00086,3802563,88.20524,4311040
4419,dpratt,37,0.00086,3802600,88.20609,4311040
4420,eatjeff,37,0.00086,3802637,88.20695,4311040
4421,edwarnicke,37,0.00086,3802674,88.20781,4311040
4422,elfinhe,37,0.00086,3802711,88.20867,4311040
4423,faraazkhan,37,0.00086,3802748,88.20953,4311040
4424,felixfbecker,37,0.00086,3802785,88.21039,4311040
4425,gajus,37,0.00086,3802822,88.21124,4311040
4426,gprossliner,37,0.00086,3802859,88.21210,4311040
4427,gyunnkim,37,0.00086,3802896,88.21296,4311040
4428,HackToday,37,0.00086,3802933,88.21382,4311040
4429,hamza3202,37,0.00086,3802970,88.21468,4311040
4430,harshal-shah,37,0.00086,3803007,88.21553,4311040
4431,hpejustin,37,0.00086,3803044,88.21639,4311040
4432,ignasi35,37,0.00086,3803081,88.21725,4311040
4433,infa-ddeore,37,0.00086,3803118,88.21811,4311040
4434,ishantanu,37,0.00086,3803155,88.21897,4311040
4435,Jc2k,37,0.00086,3803192,88.21983,4311040
4436,jcderr,37,0.00086,3803229,88.22068,4311040
4437,jimmy-zh,37,0.00086,3803266,88.22154,4311040
4438,jkryl,37,0.00086,3803303,88.22240,4311040
4439,jon-fearer,37,0.00086,3803340,88.22326,4311040
4440,Joseph94m,37,0.00086,3803377,88.22412,4311040
4441,josephglanville,37,0.00086,3803414,88.22498,4311040
4442,Kafei59,37,0.00086,3803451,88.22583,4311040
4443,keith4743,37,0.00086,3803488,88.22669,4311040
4444,kevincvlam,37,0.00086,3803525,88.22755,4311040
4445,lambdanis,37,0.00086,3803562,88.22841,4311040
4446,lawliet89,37,0.00086,3803599,88.22927,4311040
4447,leifmadsen,37,0.00086,3803636,88.23013,4311040
4448,liyimeng,37,0.00086,3803673,88.23098,4311040
4449,lorenzvth7,37,0.00086,3803710,88.23184,4311040
4450,mattayes,37,0.00086,3803747,88.23270,4311040
4451,mausch,37,0.00086,3803784,88.23356,4311040
4452,midN,37,0.00086,3803821,88.23442,4311040
4453,mikeln,37,0.00086,3803858,88.23528,4311040
4454,MilanDasek,37,0.00086,3803895,88.23613,4311040
4455,mneverov,37,0.00086,3803932,88.23699,4311040
4456,mohag,37,0.00086,3803969,88.23785,4311040
4457,natekartchner,37,0.00086,3804006,88.23871,4311040
4458,netikras,37,0.00086,3804043,88.23957,4311040
4459,NickLarsenNZ,37,0.00086,3804080,88.24042,4311040
4460,onlyjob,37,0.00086,3804117,88.24128,4311040
4461,Paxa,37,0.00086,3804154,88.24214,4311040
4462,Pharb,37,0.00086,3804191,88.24300,4311040
4463,pkit,37,0.00086,3804228,88.24386,4311040
4464,RamanPndy,37,0.00086,3804265,88.24472,4311040
4465,rdsubhas,37,0.00086,3804302,88.24557,4311040
4466,ryane,37,0.00086,3804339,88.24643,4311040
4467,s2504s,37,0.00086,3804376,88.24729,4311040
4468,sboardwell,37,0.00086,3804413,88.24815,4311040
4469,SeananXu,37,0.00086,3804450,88.24901,4311040
4470,serialx,37,0.00086,3804487,88.24987,4311040
4471,Sevii,37,0.00086,3804524,88.25072,4311040
4472,sherifkayad,37,0.00086,3804561,88.25158,4311040
4473,slashpai,37,0.00086,3804598,88.25244,4311040
4474,spadgett,37,0.00086,3804635,88.25330,4311040
4475,sparkprime,37,0.00086,3804672,88.25416,4311040
4476,SSmallMonster,37,0.00086,3804709,88.25502,4311040
4477,Steffen911,37,0.00086,3804746,88.25587,4311040
4478,tammert,37,0.00086,3804783,88.25673,4311040
4479,tigerlinux,37,0.00086,3804820,88.25759,4311040
4480,tiwalter,37,0.00086,3804857,88.25845,4311040
4481,tristanburgess,37,0.00086,3804894,88.25931,4311040
4482,ultradio,37,0.00086,3804931,88.26016,4311040
4483,WebSpider,37,0.00086,3804968,88.26102,4311040
4484,weikhor,37,0.00086,3805005,88.26188,4311040
4485,willmore,37,0.00086,3805042,88.26274,4311040
4486,WillsonHG,37,0.00086,3805079,88.26360,4311040
4487,willstudy,37,0.00086,3805116,88.26446,4311040
4488,wingyplus,37,0.00086,3805153,88.26531,4311040
4489,wsong,37,0.00086,3805190,88.26617,4311040
4490,xq2005,37,0.00086,3805227,88.26703,4311040
4491,you-n-g,37,0.00086,3805264,88.26789,4311040
4492,ysaakpr,37,0.00086,3805301,88.26875,4311040
4493,Yuan-Junliang,37,0.00086,3805338,88.26961,4311040
4494,zachaller,37,0.00086,3805375,88.27046,4311040
4495,zak905,37,0.00086,3805412,88.27132,4311040
4496,zhangjianweibj,37,0.00086,3805449,88.27218,4311040
4497,ZongqiangZhang,37,0.00086,3805486,88.27304,4311040
4498,zonzamas,37,0.00086,3805523,88.27390,4311040
4499,zufardhiyaulhaq,37,0.00086,3805560,88.27476,4311040
4500,aaronbbrown,36,0.00084,3805596,88.27559,4311040
4501,aaron-kasten,36,0.00084,3805632,88.27643,4311040
4502,acobaugh,36,0.00084,3805668,88.27726,4311040
4503,alejandrojnm,36,0.00084,3805704,88.27810,4311040
4504,allenhaozi,36,0.00084,3805740,88.27893,4311040
4505,AlphaWong,36,0.00084,3805776,88.27977,4311040
4506,anggao,36,0.00084,3805812,88.28060,4311040
4507,AugustinasS,36,0.00084,3805848,88.28144,4311040
4508,briandorsey,36,0.00084,3805884,88.28227,4311040
4509,BruceZu,36,0.00084,3805920,88.28311,4311040
4510,btiernay,36,0.00084,3805956,88.28394,4311040
4511,bysnupy,36,0.00084,3805992,88.28478,4311040
4512,bzuelke,36,0.00084,3806028,88.28561,4311040
4513,cizixs,36,0.00084,3806064,88.28645,4311040
4514,clenimar,36,0.00084,3806100,88.28728,4311040
4515,czahedi,36,0.00084,3806136,88.28812,4311040
4516,deepsm007,36,0.00084,3806172,88.28895,4311040
4517,Denton24646,36,0.00084,3806208,88.28979,4311040
4518,dklyle,36,0.00084,3806244,88.29062,4311040
4519,drywheat,36,0.00084,3806280,88.29146,4311040
4520,duan-yue,36,0.00084,3806316,88.29229,4311040
4521,dwmkerr,36,0.00084,3806352,88.29313,4311040
4522,eastlondoner,36,0.00084,3806388,88.29396,4311040
4523,ebbeelsborg,36,0.00084,3806424,88.29480,4311040
4524,engedaam,36,0.00084,3806460,88.29563,4311040
4525,eroji,36,0.00084,3806496,88.29647,4311040
4526,fen4o,36,0.00084,3806532,88.29730,4311040
4527,FlorinPeter,36,0.00084,3806568,88.29814,4311040
4528,gabeduke,36,0.00084,3806604,88.29897,4311040
4529,gitlabbin,36,0.00084,3806640,88.29981,4311040
4530,greggbjensen,36,0.00084,3806676,88.30064,4311040
4531,guenhter,36,0.00084,3806712,88.30148,4311040
4532,GuyPaddock,36,0.00084,3806748,88.30231,4311040
4533,Hokwang,36,0.00084,3806784,88.30315,4311040
4534,houz42,36,0.00084,3806820,88.30398,4311040
4535,jasperf,36,0.00084,3806856,88.30482,4311040
4536,jekohk,36,0.00084,3806892,88.30565,4311040
4537,jolestar,36,0.00084,3806928,88.30649,4311040
4538,jonathino2590,36,0.00084,3806964,88.30732,4311040
4539,jordanwilson230,36,0.00084,3807000,88.30816,4311040
4540,jperville,36,0.00084,3807036,88.30899,4311040
4541,jsloyer,36,0.00084,3807072,88.30983,4311040
4542,kaspernissen,36,0.00084,3807108,88.31066,4311040
4543,kevinjqiu,36,0.00084,3807144,88.31150,4311040
4544,kinghrothgar,36,0.00084,3807180,88.31233,4311040
4545,knfoo,36,0.00084,3807216,88.31317,4311040
4546,liyongxin,36,0.00084,3807252,88.31400,4311040
4547,llarsson,36,0.00084,3807288,88.31484,4311040
4548,lvthillo,36,0.00084,3807324,88.31567,4311040
4549,maklemenz,36,0.00084,3807360,88.31651,4311040
4550,markstur,36,0.00084,3807396,88.31734,4311040
4551,maximsnezhkov,36,0.00084,3807432,88.31818,4311040
4552,mccormd,36,0.00084,3807468,88.31901,4311040
4553,mmorel-35,36,0.00084,3807504,88.31985,4311040
4554,msvticket,36,0.00084,3807540,88.32068,4311040
4555,nevermyuk,36,0.00084,3807576,88.32152,4311040
4556,NillsF,36,0.00084,3807612,88.32235,4311040
4557,nvartolomei,36,0.00084,3807648,88.32319,4311040
4558,outofmem0ry,36,0.00084,3807684,88.32402,4311040
4559,Pearl1594,36,0.00084,3807720,88.32486,4311040
4560,phisco,36,0.00084,3807756,88.32569,4311040
4561,pmallory,36,0.00084,3807792,88.32653,4311040
4562,PuneetPunamiya,36,0.00084,3807828,88.32736,4311040
4563,rctl,36,0.00084,3807864,88.32820,4311040
4564,retr0h,36,0.00084,3807900,88.32903,4311040
4565,reverson,36,0.00084,3807936,88.32987,4311040
4566,rlees85,36,0.00084,3807972,88.33070,4311040
4567,rohan47,36,0.00084,3808008,88.33154,4311040
4568,rosenhouse,36,0.00084,3808044,88.33237,4311040
4569,rrangith,36,0.00084,3808080,88.33321,4311040
4570,russellb,36,0.00084,3808116,88.33404,4311040
4571,safanaj,36,0.00084,3808152,88.33488,4311040
4572,schmitch,36,0.00084,3808188,88.33571,4311040
4573,simonferquel,36,0.00084,3808224,88.33655,4311040
4574,sylvainOL,36,0.00084,3808260,88.33738,4311040
4575,tangle329,36,0.00084,3808296,88.33822,4311040
4576,tehlers320,36,0.00084,3808332,88.33906,4311040
4577,thecanadianbaker,36,0.00084,3808368,88.33989,4311040
4578,tianhuil,36,0.00084,3808404,88.34073,4311040
4579,trawler,36,0.00084,3808440,88.34156,4311040
4580,Ulexus,36,0.00084,3808476,88.34240,4311040
4581,vdemeester,36,0.00084,3808512,88.34323,4311040
4582,w0mbat,36,0.00084,3808548,88.34407,4311040
4583,webern,36,0.00084,3808584,88.34490,4311040
4584,woehrl01,36,0.00084,3808620,88.34574,4311040
4585,xujyan,36,0.00084,3808656,88.34657,4311040
4586,zirain,36,0.00084,3808692,88.34741,4311040
4587,zzq889,36,0.00084,3808728,88.34824,4311040
4588,adabuleanu,35,0.00081,3808763,88.34905,4311040
4589,aga20,35,0.00081,3808798,88.34986,4311040
4590,ahadas,35,0.00081,3808833,88.35068,4311040
4591,allurisravanth,35,0.00081,3808868,88.35149,4311040
4592,ams0,35,0.00081,3808903,88.35230,4311040
4593,anaclaudiar,35,0.00081,3808938,88.35311,4311040
4594,argusua,35,0.00081,3808973,88.35392,4311040
4595,batazor,35,0.00081,3809008,88.35474,4311040
4596,bdarnell,35,0.00081,3809043,88.35555,4311040
4597,binacs,35,0.00081,3809078,88.35636,4311040
4598,clementnuss,35,0.00081,3809113,88.35717,4311040
4599,courtneypacheco,35,0.00081,3809148,88.35798,4311040
4600,danielepolencic,35,0.00081,3809183,88.35880,4311040
4601,darrenhaken,35,0.00081,3809218,88.35961,4311040
4602,dberuben,35,0.00081,3809253,88.36042,4311040
4603,dieseldesai,35,0.00081,3809288,88.36123,4311040
4604,dmizelle,35,0.00081,3809323,88.36204,4311040
4605,dominikschulz,35,0.00081,3809358,88.36285,4311040
4606,duyanghao,35,0.00081,3809393,88.36367,4311040
4607,edsiper,35,0.00081,3809428,88.36448,4311040
4608,frederiko,35,0.00081,3809463,88.36529,4311040
4609,gg7,35,0.00081,3809498,88.36610,4311040
4610,gkudra-msft,35,0.00081,3809533,88.36691,4311040
4611,hannibalhuang,35,0.00081,3809568,88.36773,4311040
4612,Hugome,35,0.00081,3809603,88.36854,4311040
4613,imsky,35,0.00081,3809638,88.36935,4311040
4614,iyashu,35,0.00081,3809673,88.37016,4311040
4615,jameshearttech,35,0.00081,3809708,88.37097,4311040
4616,JeffLuoo,35,0.00081,3809743,88.37178,4311040
4617,jonasrmichel,35,0.00081,3809778,88.37260,4311040
4618,kevinkim9264,35,0.00081,3809813,88.37341,4311040
4619,keyingliu,35,0.00081,3809848,88.37422,4311040
4620,kinderyj,35,0.00081,3809883,88.37503,4311040
4621,kozikow,35,0.00081,3809918,88.37584,4311040
4622,luisyonaldo,35,0.00081,3809953,88.37666,4311040
4623,madhuri-rai07,35,0.00081,3809988,88.37747,4311040
4624,MansM,35,0.00081,3810023,88.37828,4311040
4625,marcellodesales,35,0.00081,3810058,88.37909,4311040
4626,matteoolivi,35,0.00081,3810093,88.37990,4311040
4627,matttproud,35,0.00081,3810128,88.38072,4311040
4628,mikegrass,35,0.00081,3810163,88.38153,4311040
4629,neilhwatson,35,0.00081,3810198,88.38234,4311040
4630,ocofaigh,35,0.00081,3810233,88.38315,4311040
4631,olegch,35,0.00081,3810268,88.38396,4311040
4632,PabloCastellano,35,0.00081,3810303,88.38477,4311040
4633,palmerabollo,35,0.00081,3810338,88.38559,4311040
4634,paralika,35,0.00081,3810373,88.38640,4311040
4635,paulczar,35,0.00081,3810408,88.38721,4311040
4636,pete911,35,0.00081,3810443,88.38802,4311040
4637,portante,35,0.00081,3810478,88.38883,4311040
4638,pracucci,35,0.00081,3810513,88.38965,4311040
4639,princerachit,35,0.00081,3810548,88.39046,4311040
4640,pyaillet,35,0.00081,3810583,88.39127,4311040
4641,ranchothu,35,0.00081,3810618,88.39208,4311040
4642,rdtr,35,0.00081,3810653,88.39289,4311040
4643,Rei1010,35,0.00081,3810688,88.39371,4311040
4644,richm,35,0.00081,3810723,88.39452,4311040
4645,Rustin-Liu,35,0.00081,3810758,88.39533,4311040
4646,rustycl0ck,35,0.00081,3810793,88.39614,4311040
4647,salv-orlando,35,0.00081,3810828,88.39695,4311040
4648,SCLogo,35,0.00081,3810863,88.39776,4311040
4649,shahbour,35,0.00081,3810898,88.39858,4311040
4650,shivnagarajan,35,0.00081,3810933,88.39939,4311040
4651,shuaich,35,0.00081,3810968,88.40020,4311040
4652,sjcarriere,35,0.00081,3811003,88.40101,4311040
4653,stephen-fox,35,0.00081,3811038,88.40182,4311040
4654,techdragon,35,0.00081,3811073,88.40264,4311040
4655,tshaiman,35,0.00081,3811108,88.40345,4311040
4656,ttauveron,35,0.00081,3811143,88.40426,4311040
4657,tuananh,35,0.00081,3811178,88.40507,4311040
4658,unmarshall,35,0.00081,3811213,88.40588,4311040
4659,va7ish,35,0.00081,3811248,88.40670,4311040
4660,vanduc95,35,0.00081,3811283,88.40751,4311040
4661,ViniciusDeAndrade,35,0.00081,3811318,88.40832,4311040
4662,vishalanarase,35,0.00081,3811353,88.40913,4311040
4663,VladMasarik,35,0.00081,3811388,88.40994,4311040
4664,wangrzneu,35,0.00081,3811423,88.41075,4311040
4665,xiao-jay,35,0.00081,3811458,88.41157,4311040
4666,xmulligan,35,0.00081,3811493,88.41238,4311040
4667,xujihui1985,35,0.00081,3811528,88.41319,4311040
4668,yeqiugt,35,0.00081,3811563,88.41400,4311040
4669,Yoshiki0705,35,0.00081,3811598,88.41481,4311040
4670,accepting,34,0.00079,3811632,88.41560,4311040
4671,adieu,34,0.00079,3811666,88.41639,4311040
4672,ADITYADAS1999,34,0.00079,3811700,88.41718,4311040
4673,ahmadalli,34,0.00079,3811734,88.41797,4311040
4674,ak2766,34,0.00079,3811768,88.41876,4311040
4675,andjelx,34,0.00079,3811802,88.41955,4311040
4676,AnitaNayak,34,0.00079,3811836,88.42033,4311040
4677,antoinedeschenes,34,0.00079,3811870,88.42112,4311040
4678,ateleshev,34,0.00079,3811904,88.42191,4311040
4679,austinorth,34,0.00079,3811938,88.42270,4311040
4680,barkbay,34,0.00079,3811972,88.42349,4311040
4681,byxorna,34,0.00079,3812006,88.42428,4311040
4682,cdemers,34,0.00079,3812040,88.42507,4311040
4683,cep21,34,0.00079,3812074,88.42586,4311040
4684,ChristopherFry,34,0.00079,3812108,88.42664,4311040
4685,ConradIrwin,34,0.00079,3812142,88.42743,4311040
4686,dabeck,34,0.00079,3812176,88.42822,4311040
4687,danielpacak,34,0.00079,3812210,88.42901,4311040
4688,davinkevin,34,0.00079,3812244,88.42980,4311040
4689,der-eismann,34,0.00079,3812278,88.43059,4311040
4690,Draiken,34,0.00079,3812312,88.43138,4311040
4691,DylanGraham,34,0.00079,3812346,88.43216,4311040
4692,ejweber,34,0.00079,3812380,88.43295,4311040
4693,eranco74,34,0.00079,3812414,88.43374,4311040
4694,furkanmustafa,34,0.00079,3812448,88.43453,4311040
4695,Gandem,34,0.00079,3812482,88.43532,4311040
4696,GaoRong,34,0.00079,3812516,88.43611,4311040
4697,glyn,34,0.00079,3812550,88.43690,4311040
4698,haardikdharma10,34,0.00079,3812584,88.43769,4311040
4699,hacktastic,34,0.00079,3812618,88.43847,4311040
4700,haorenfsa,34,0.00079,3812652,88.43926,4311040
4701,hedinasr,34,0.00079,3812686,88.44005,4311040
4702,hugoprudente,34,0.00079,3812720,88.44084,4311040
4703,iamtodor,34,0.00079,3812754,88.44163,4311040
4704,immanuelfodor,34,0.00079,3812788,88.44242,4311040
4705,janeczku,34,0.00079,3812822,88.44321,4311040
4706,jcchavezs,34,0.00079,3812856,88.44399,4311040
4707,jinchihe,34,0.00079,3812890,88.44478,4311040
4708,jlucktay,34,0.00079,3812924,88.44557,4311040
4709,joan38,34,0.00079,3812958,88.44636,4311040
4710,j-vizcaino,34,0.00079,3812992,88.44715,4311040
4711,jwendell,34,0.00079,3813026,88.44794,4311040
4712,karancode,34,0.00079,3813060,88.44873,4311040
4713,kdima,34,0.00079,3813094,88.44952,4311040
4714,kwmonroe,34,0.00079,3813128,88.45030,4311040
4715,Lihua93,34,0.00079,3813162,88.45109,4311040
4716,macropin,34,0.00079,3813196,88.45188,4311040
4717,mansi-a,34,0.00079,3813230,88.45267,4311040
4718,mattma,34,0.00079,3813264,88.45346,4311040
4719,max-sixty,34,0.00079,3813298,88.45425,4311040
4720,mcorbin,34,0.00079,3813332,88.45504,4311040
4721,mmacfadden,34,0.00079,3813366,88.45583,4311040
4722,moolen,34,0.00079,3813400,88.45661,4311040
4723,Mouly22,34,0.00079,3813434,88.45740,4311040
4724,mzupan,34,0.00079,3813468,88.45819,4311040
4725,nikox94,34,0.00079,3813502,88.45898,4311040
4726,nysthee,34,0.00079,3813536,88.45977,4311040
4727,ojmhetar,34,0.00079,3813570,88.46056,4311040
4728,olvesh,34,0.00079,3813604,88.46135,4311040
4729,ostrain,34,0.00079,3813638,88.46213,4311040
4730,ozdanborne,34,0.00079,3813672,88.46292,4311040
4731,pacevedom,34,0.00079,3813706,88.46371,4311040
4732,paolomainardi,34,0.00079,3813740,88.46450,4311040
4733,pawelprazak,34,0.00079,3813774,88.46529,4311040
4734,phspagiari,34,0.00079,3813808,88.46608,4311040
4735,poelzi,34,0.00079,3813842,88.46687,4311040
4736,posquit0,34,0.00079,3813876,88.46766,4311040
4737,prashbnair,34,0.00079,3813910,88.46844,4311040
4738,ramr,34,0.00079,3813944,88.46923,4311040
4739,Reinkaos,34,0.00079,3813978,88.47002,4311040
4740,RickHaan,34,0.00079,3814012,88.47081,4311040
4741,rite2nikhil,34,0.00079,3814046,88.47160,4311040
4742,rodcloutier,34,0.00079,3814080,88.47239,4311040
4743,roksolana-d,34,0.00079,3814114,88.47318,4311040
4744,rtripat,34,0.00079,3814148,88.47396,4311040
4745,runlevel5,34,0.00079,3814182,88.47475,4311040
4746,rvkubiak,34,0.00079,3814216,88.47554,4311040
4747,ryancox,34,0.00079,3814250,88.47633,4311040
4748,ryantking,34,0.00079,3814284,88.47712,4311040
4749,ryarnyah,34,0.00079,3814318,88.47791,4311040
4750,shanalily,34,0.00079,3814352,88.47870,4311040
4751,shettyg,34,0.00079,3814386,88.47949,4311040
4752,soundTricker,34,0.00079,3814420,88.48027,4311040
4753,srfrnk,34,0.00079,3814454,88.48106,4311040
4754,stevemcquaid,34,0.00079,3814488,88.48185,4311040
4755,stuartpb,34,0.00079,3814522,88.48264,4311040
4756,syst0m,34,0.00079,3814556,88.48343,4311040
4757,syswu,34,0.00079,3814590,88.48422,4311040
4758,thomasjungblut,34,0.00079,3814624,88.48501,4311040
4759,TrishaChetani,34,0.00079,3814658,88.48579,4311040
4760,venkat-443,34,0.00079,3814692,88.48658,4311040
4761,vyta,34,0.00079,3814726,88.48737,4311040
4762,wangycc,34,0.00079,3814760,88.48816,4311040
4763,webmutation,34,0.00079,3814794,88.48895,4311040
4764,21h,33,0.00077,3814827,88.48971,4311040
4765,ahalim-intel,33,0.00077,3814860,88.49048,4311040
4766,aliakhtar,33,0.00077,3814893,88.49125,4311040
4767,Alvaro-Campesino,33,0.00077,3814926,88.49201,4311040
4768,ameade,33,0.00077,3814959,88.49278,4311040
4769,apeeyush,33,0.00077,3814992,88.49354,4311040
4770,arajkumar,33,0.00077,3815025,88.49431,4311040
4771,asottile,33,0.00077,3815058,88.49507,4311040
4772,bbatha,33,0.00077,3815091,88.49584,4311040
4773,bcreane,33,0.00077,3815124,88.49660,4311040
4774,bradmwilliams,33,0.00077,3815157,88.49737,4311040
4775,chaspy,33,0.00077,3815190,88.49814,4311040
4776,chiluk,33,0.00077,3815223,88.49890,4311040
4777,christus02,33,0.00077,3815256,88.49967,4311040
4778,daenney,33,0.00077,3815289,88.50043,4311040
4779,danishprakash,33,0.00077,3815322,88.50120,4311040
4780,ddongchen,33,0.00077,3815355,88.50196,4311040
4781,deustis,33,0.00077,3815388,88.50273,4311040
4782,dhaiducek,33,0.00077,3815421,88.50349,4311040
4783,diranged,33,0.00077,3815454,88.50426,4311040
4784,droctothorpe,33,0.00077,3815487,88.50502,4311040
4785,faust64,33,0.00077,3815520,88.50579,4311040
4786,Fred78290,33,0.00077,3815553,88.50656,4311040
4787,gAmUssA,33,0.00077,3815586,88.50732,4311040
4788,gitlawr,33,0.00077,3815619,88.50809,4311040
4789,hikhvar,33,0.00077,3815652,88.50885,4311040
4790,hoxhaeris,33,0.00077,3815685,88.50962,4311040
4791,jamesgeorge007,33,0.00077,3815718,88.51038,4311040
4792,jangdm,33,0.00077,3815751,88.51115,4311040
4793,janwillies,33,0.00077,3815784,88.51191,4311040
4794,jmccormick2001,33,0.00077,3815817,88.51268,4311040
4795,jonastl,33,0.00077,3815850,88.51344,4311040
4796,joshix,33,0.00077,3815883,88.51421,4311040
4797,jwenz723,33,0.00077,3815916,88.51498,4311040
4798,kamalmarhubi,33,0.00077,3815949,88.51574,4311040
4799,khizunov,33,0.00077,3815982,88.51651,4311040
4800,kvokka,33,0.00077,3816015,88.51727,4311040
4801,kylegato,33,0.00077,3816048,88.51804,4311040
4802,lawrencedudley,33,0.00077,3816081,88.51880,4311040
4803,lee0c,33,0.00077,3816114,88.51957,4311040
4804,lixin963,33,0.00077,3816147,88.52033,4311040
4805,liyuan198251,33,0.00077,3816180,88.52110,4311040
4806,lsq645599166,33,0.00077,3816213,88.52186,4311040
4807,Lukasz-AWS,33,0.00077,3816246,88.52263,4311040
4808,mattiaperi,33,0.00077,3816279,88.52340,4311040
4809,mattsmithdatera,33,0.00077,3816312,88.52416,4311040
4810,mattysweeps,33,0.00077,3816345,88.52493,4311040
4811,mecampbellsoup,33,0.00077,3816378,88.52569,4311040
4812,medined,33,0.00077,3816411,88.52646,4311040
4813,mgoltzsche,33,0.00077,3816444,88.52722,4311040
4814,MichaelJCole,33,0.00077,3816477,88.52799,4311040
4815,m-no-2017,33,0.00077,3816510,88.52875,4311040
4816,mritd,33,0.00077,3816543,88.52952,4311040
4817,muff1nman,33,0.00077,3816576,88.53029,4311040
4818,nick5616,33,0.00077,3816609,88.53105,4311040
4819,nodesocket,33,0.00077,3816642,88.53182,4311040
4820,Nokel81,33,0.00077,3816675,88.53258,4311040
4821,nottix,33,0.00077,3816708,88.53335,4311040
4822,numbsafari,33,0.00077,3816741,88.53411,4311040
4823,patricknelson,33,0.00077,3816774,88.53488,4311040
4824,peterhuene,33,0.00077,3816807,88.53564,4311040
4825,pingles,33,0.00077,3816840,88.53641,4311040
4826,rawlingsj,33,0.00077,3816873,88.53717,4311040
4827,rhvgoyal,33,0.00077,3816906,88.53794,4311040
4828,RiRa12621,33,0.00077,3816939,88.53871,4311040
4829,rk295,33,0.00077,3816972,88.53947,4311040
4830,robrich,33,0.00077,3817005,88.54024,4311040
4831,rochaporto,33,0.00077,3817038,88.54100,4311040
4832,rosscdh,33,0.00077,3817071,88.54177,4311040
4833,sagarbhavsar4328,33,0.00077,3817104,88.54253,4311040
4834,sander-su,33,0.00077,3817137,88.54330,4311040
4835,shinytang6,33,0.00077,3817170,88.54406,4311040
4836,sils1297,33,0.00077,3817203,88.54483,4311040
4837,sroze,33,0.00077,3817236,88.54559,4311040
4838,starizard,33,0.00077,3817269,88.54636,4311040
4839,stgleb,33,0.00077,3817302,88.54713,4311040
4840,svend,33,0.00077,3817335,88.54789,4311040
4841,tmrpavan,33,0.00077,3817368,88.54866,4311040
4842,tomelliot16,33,0.00077,3817401,88.54942,4311040
4843,vibhorrawat,33,0.00077,3817434,88.55019,4311040
4844,vigothehacker,33,0.00077,3817467,88.55095,4311040
4845,vlerenc,33,0.00077,3817500,88.55172,4311040
4846,weikaipan,33,0.00077,3817533,88.55248,4311040
4847,wendorf,33,0.00077,3817566,88.55325,4311040
4848,yaxinlx,33,0.00077,3817599,88.55401,4311040
4849,yittg,33,0.00077,3817632,88.55478,4311040
4850,youhonglian,33,0.00077,3817665,88.55555,4311040
4851,abelgana,32,0.00074,3817697,88.55629,4311040
4852,abourget,32,0.00074,3817729,88.55703,4311040
4853,AdheipSingh,32,0.00074,3817761,88.55777,4311040
4854,ahanabi,32,0.00074,3817793,88.55851,4311040
4855,ahenobarbi,32,0.00074,3817825,88.55926,4311040
4856,alex123012,32,0.00074,3817857,88.56000,4311040
4857,alexcpn,32,0.00074,3817889,88.56074,4311040
4858,almariah,32,0.00074,3817921,88.56148,4311040
4859,andreygoran,32,0.00074,3817953,88.56223,4311040
4860,artemkrim,32,0.00074,3817985,88.56297,4311040
4861,ashishbharthi,32,0.00074,3818017,88.56371,4311040
4862,askervin,32,0.00074,3818049,88.56445,4311040
4863,ccatlett2000,32,0.00074,3818081,88.56520,4311040
4864,charlesxsh,32,0.00074,3818113,88.56594,4311040
4865,chrisns,32,0.00074,3818145,88.56668,4311040
4866,chrisseto,32,0.00074,3818177,88.56742,4311040
4867,ChrsMark,32,0.00074,3818209,88.56816,4311040
4868,cjyar,32,0.00074,3818241,88.56891,4311040
4869,collimarco,32,0.00074,3818273,88.56965,4311040
4870,coolsvap,32,0.00074,3818305,88.57039,4311040
4871,crockpotveggies,32,0.00074,3818337,88.57113,4311040
4872,cytar,32,0.00074,3818369,88.57188,4311040
4873,daemon1024,32,0.00074,3818401,88.57262,4311040
4874,danbeaulieu,32,0.00074,3818433,88.57336,4311040
4875,dani-santos-code,32,0.00074,3818465,88.57410,4311040
4876,dbgoytia,32,0.00074,3818497,88.57485,4311040
4877,dcwangmit01,32,0.00074,3818529,88.57559,4311040
4878,dgageot,32,0.00074,3818561,88.57633,4311040
4879,dhoer,32,0.00074,3818593,88.57707,4311040
4880,DingGGu,32,0.00074,3818625,88.57781,4311040
4881,druidsbane,32,0.00074,3818657,88.57856,4311040
4882,dudgns3443,32,0.00074,3818689,88.57930,4311040
4883,dusansusic,32,0.00074,3818721,88.58004,4311040
4884,ellenkorbes,32,0.00074,3818753,88.58078,4311040
4885,EmilyShepherd,32,0.00074,3818785,88.58153,4311040
4886,eranreshef,32,0.00074,3818817,88.58227,4311040
4887,ezeev,32,0.00074,3818849,88.58301,4311040
4888,falcon78921,32,0.00074,3818881,88.58375,4311040
4889,fjammes,32,0.00074,3818913,88.58449,4311040
4890,Frankkkkk,32,0.00074,3818945,88.58524,4311040
4891,FreeZhang61,32,0.00074,3818977,88.58598,4311040
4892,frzifus,32,0.00074,3819009,88.58672,4311040
4893,guenter,32,0.00074,3819041,88.58746,4311040
4894,haoranleo,32,0.00074,3819073,88.58821,4311040
4895,hickey,32,0.00074,3819105,88.58895,4311040
4896,idosh,32,0.00074,3819137,88.58969,4311040
4897,imesh,32,0.00074,3819169,88.59043,4311040
4898,iocanel,32,0.00074,3819201,88.59118,4311040
4899,itsmrwave,32,0.00074,3819233,88.59192,4311040
4900,jarias-lfx,32,0.00074,3819265,88.59266,4311040
4901,jetersen,32,0.00074,3819297,88.59340,4311040
4902,jlebon,32,0.00074,3819329,88.59414,4311040
4903,jorgemoralespou,32,0.00074,3819361,88.59489,4311040
4904,jseely,32,0.00074,3819393,88.59563,4311040
4905,kaazoo,32,0.00074,3819425,88.59637,4311040
4906,koen92,32,0.00074,3819457,88.59711,4311040
4907,lalyos,32,0.00074,3819489,88.59786,4311040
4908,ldemailly,32,0.00074,3819521,88.59860,4311040
4909,Letme,32,0.00074,3819553,88.59934,4311040
4910,lfrancke,32,0.00074,3819585,88.60008,4311040
4911,lizrice,32,0.00074,3819617,88.60082,4311040
4912,lumjjb,32,0.00074,3819649,88.60157,4311040
4913,marrrvin,32,0.00074,3819681,88.60231,4311040
4914,mattn,32,0.00074,3819713,88.60305,4311040
4915,merkata,32,0.00074,3819745,88.60379,4311040
4916,mokua,32,0.00074,3819777,88.60454,4311040
4917,monaka,32,0.00074,3819809,88.60528,4311040
4918,mrahbar,32,0.00074,3819841,88.60602,4311040
4919,mufti1,32,0.00074,3819873,88.60676,4311040
4920,murillodigital,32,0.00074,3819905,88.60751,4311040
4921,mzacho,32,0.00074,3819937,88.60825,4311040
4922,nabadger,32,0.00074,3819969,88.60899,4311040
4923,natemurthy,32,0.00074,3820001,88.60973,4311040
4924,olljanat,32,0.00074,3820033,88.61047,4311040
4925,OscarNeira,32,0.00074,3820065,88.61122,4311040
4926,Patil2099,32,0.00074,3820097,88.61196,4311040
4927,pierreyves-lebrun,32,0.00074,3820129,88.61270,4311040
4928,poweroftrue,32,0.00074,3820161,88.61344,4311040
4929,qbl,32,0.00074,3820193,88.61419,4311040
4930,rajalokan,32,0.00074,3820225,88.61493,4311040
4931,rastislavs,32,0.00074,3820257,88.61567,4311040
4932,raushan2016,32,0.00074,3820289,88.61641,4311040
4933,rjaini,32,0.00074,3820321,88.61716,4311040
4934,ruudk,32,0.00074,3820353,88.61790,4311040
4935,salavessa,32,0.00074,3820385,88.61864,4311040
4936,sebsoto,32,0.00074,3820417,88.61938,4311040
4937,shanegibbs,32,0.00074,3820449,88.62012,4311040
4938,sokoow,32,0.00074,3820481,88.62087,4311040
4939,ss22ever,32,0.00074,3820513,88.62161,4311040
4940,stek29,32,0.00074,3820545,88.62235,4311040
4941,steveeJ,32,0.00074,3820577,88.62309,4311040
4942,talset,32,0.00074,3820609,88.62384,4311040
4943,tanalam2411,32,0.00074,3820641,88.62458,4311040
4944,theothermike,32,0.00074,3820673,88.62532,4311040
4945,ThiagoGMF,32,0.00074,3820705,88.62606,4311040
4946,tsjsdbd,32,0.00074,3820737,88.62680,4311040
4947,uesyn,32,0.00074,3820769,88.62755,4311040
4948,verdverm,32,0.00074,3820801,88.62829,4311040
4949,vi7,32,0.00074,3820833,88.62903,4311040
4950,weherdh,32,0.00074,3820865,88.62977,4311040
4951,wienczny,32,0.00074,3820897,88.63052,4311040
4952,wxsms,32,0.00074,3820929,88.63126,4311040
4953,wzqnls,32,0.00074,3820961,88.63200,4311040
4954,xinxingliu90,32,0.00074,3820993,88.63274,4311040
4955,yinshuxun,32,0.00074,3821025,88.63349,4311040
4956,zbindenren,32,0.00074,3821057,88.63423,4311040
4957,zryfish,32,0.00074,3821089,88.63497,4311040
4958,ZYecho,32,0.00074,3821121,88.63571,4311040
4959,9bany,31,0.00072,3821152,88.63643,4311040
4960,aattuluri,31,0.00072,3821183,88.63715,4311040
4961,airstand,31,0.00072,3821214,88.63787,4311040
4962,akgunjal,31,0.00072,3821245,88.63859,4311040
4963,akrieg-ionos,31,0.00072,3821276,88.63931,4311040
4964,alex-berger,31,0.00072,3821307,88.64003,4311040
4965,andreaskaris,31,0.00072,3821338,88.64075,4311040
4966,andromedarabbit,31,0.00072,3821369,88.64146,4311040
4967,AnshRoshan,31,0.00072,3821400,88.64218,4311040
4968,apupier,31,0.00072,3821431,88.64290,4311040
4969,arturo-skydio,31,0.00072,3821462,88.64362,4311040
4970,ashish493,31,0.00072,3821493,88.64434,4311040
4971,ashleydavies,31,0.00072,3821524,88.64506,4311040
4972,bandesz,31,0.00072,3821555,88.64578,4311040
4973,bbourbie,31,0.00072,3821586,88.64650,4311040
4974,bhargav-naik,31,0.00072,3821617,88.64722,4311040
4975,bnrjee,31,0.00072,3821648,88.64794,4311040
4976,brianharwell,31,0.00072,3821679,88.64866,4311040
4977,cabrinoob,31,0.00072,3821710,88.64937,4311040
4978,cbluth,31,0.00072,3821741,88.65009,4311040
4979,cbroglie,31,0.00072,3821772,88.65081,4311040
4980,cbuschka,31,0.00072,3821803,88.65153,4311040
4981,chao007,31,0.00072,3821834,88.65225,4311040
4982,CharlyF,31,0.00072,3821865,88.65297,4311040
4983,ChaturvediSulabh,31,0.00072,3821896,88.65369,4311040
4984,clickyotomy,31,0.00072,3821927,88.65441,4311040
4985,damingerdai,31,0.00072,3821958,88.65513,4311040
4986,danbondd,31,0.00072,3821989,88.65585,4311040
4987,dani8art,31,0.00072,3822020,88.65657,4311040
4988,debgiles,31,0.00072,3822051,88.65728,4311040
4989,dengyi1996,31,0.00072,3822082,88.65800,4311040
4990,dfarrell07,31,0.00072,3822113,88.65872,4311040
4991,dgonzalez,31,0.00072,3822144,88.65944,4311040
4992,dimitropoulos,31,0.00072,3822175,88.66016,4311040
4993,eminalemdar,31,0.00072,3822206,88.66088,4311040
4994,emwalker,31,0.00072,3822237,88.66160,4311040
4995,ericsmalling,31,0.00072,3822268,88.66232,4311040
4996,eyenx,31,0.00072,3822299,88.66304,4311040
4997,falser101,31,0.00072,3822330,88.66376,4311040
4998,flawedmatrix,31,0.00072,3822361,88.66448,4311040
4999,flickerfly,31,0.00072,3822392,88.66519,4311040
5000,foolusion,31,0.00072,3822423,88.66591,4311040
5001,frezbo,31,0.00072,3822454,88.66663,4311040
5002,gavksingh,31,0.00072,3822485,88.66735,4311040
5003,glasser,31,0.00072,3822516,88.66807,4311040
5004,gm7y8,31,0.00072,3822547,88.66879,4311040
5005,guitmz,31,0.00072,3822578,88.66951,4311040
5006,hanghliu,31,0.00072,3822609,88.67023,4311040
5007,harihud,31,0.00072,3822640,88.67095,4311040
5008,hermanbanken,31,0.00072,3822671,88.67167,4311040
5009,hibbert,31,0.00072,3822702,88.67239,4311040
5010,himanshug,31,0.00072,3822733,88.67310,4311040
5011,hrishin,31,0.00072,3822764,88.67382,4311040
5012,hzamani,31,0.00072,3822795,88.67454,4311040
5013,ibazhitov,31,0.00072,3822826,88.67526,4311040
5014,ifosch,31,0.00072,3822857,88.67598,4311040
5015,irbull,31,0.00072,3822888,88.67670,4311040
5016,jayconrod,31,0.00072,3822919,88.67742,4311040
5017,jpoon,31,0.00072,3822950,88.67814,4311040
5018,kakkoyun,31,0.00072,3822981,88.67886,4311040
5019,kamilgregorczyk,31,0.00072,3823012,88.67958,4311040
5020,kapilt,31,0.00072,3823043,88.68030,4311040
5021,kaybinwong,31,0.00072,3823074,88.68101,4311040
5022,kunal-kushwaha,31,0.00072,3823105,88.68173,4311040
5023,LronDC,31,0.00072,3823136,88.68245,4311040
5024,lxlxok,31,0.00072,3823167,88.68317,4311040
5025,mandarjog,31,0.00072,3823198,88.68389,4311040
5026,mburke5678,31,0.00072,3823229,88.68461,4311040
5027,mitchellhuang,31,0.00072,3823260,88.68533,4311040
5028,mittachaitu,31,0.00072,3823291,88.68605,4311040
5029,moikot,31,0.00072,3823322,88.68677,4311040
5030,montyz,31,0.00072,3823353,88.68749,4311040
5031,mortenlj,31,0.00072,3823384,88.68821,4311040
5032,mqasimsarfraz,31,0.00072,3823415,88.68892,4311040
5033,natalysheinin,31,0.00072,3823446,88.68964,4311040
5034,Nilesh-chaudhary,31,0.00072,3823477,88.69036,4311040
5035,obeyler,31,0.00072,3823508,88.69108,4311040
5036,odeke-em,31,0.00072,3823539,88.69180,4311040
5037,patrikerdes,31,0.00072,3823570,88.69252,4311040
5038,prakharporwal,31,0.00072,3823601,88.69324,4311040
5039,qianzhangxa,31,0.00072,3823632,88.69396,4311040
5040,rahulchheda,31,0.00072,3823663,88.69468,4311040
5041,rlguarino,31,0.00072,3823694,88.69540,4311040
5042,rohitsardesai83,31,0.00072,3823725,88.69612,4311040
5043,rokkiter,31,0.00072,3823756,88.69683,4311040
5044,sanjana-bhat,31,0.00072,3823787,88.69755,4311040
5045,ScheererJ,31,0.00072,3823818,88.69827,4311040
5046,scholzj,31,0.00072,3823849,88.69899,4311040
5047,sepulworld,31,0.00072,3823880,88.69971,4311040
5048,shewless,31,0.00072,3823911,88.70043,4311040
5049,solidnerd,31,0.00072,3823942,88.70115,4311040
5050,SpecialYang,31,0.00072,3823973,88.70187,4311040
5051,squall0gd,31,0.00072,3824004,88.70259,4311040
5052,stevvooe,31,0.00072,3824035,88.70331,4311040
5053,stiller-leser,31,0.00072,3824066,88.70403,4311040
5054,Summer-Field,31,0.00072,3824097,88.70474,4311040
5055,talk2vino,31,0.00072,3824128,88.70546,4311040
5056,tanaka-takayoshi,31,0.00072,3824159,88.70618,4311040
5057,Toasterson,31,0.00072,3824190,88.70690,4311040
5058,TomorJM,31,0.00072,3824221,88.70762,4311040
5059,uzuku,31,0.00072,3824252,88.70834,4311040
5060,vsamidurai,31,0.00072,3824283,88.70906,4311040
5061,Xtigyro,31,0.00072,3824314,88.70978,4311040
5062,zawachte-msft,31,0.00072,3824345,88.71050,4311040
5063,zestrells,31,0.00072,3824376,88.71122,4311040
5064,zmsp,31,0.00072,3824407,88.71193,4311040
5065,abelsromero,30,0.00070,3824437,88.71263,4311040
5066,amila-ku,30,0.00070,3824467,88.71333,4311040
5067,amitsaha,30,0.00070,3824497,88.71402,4311040
5068,amrmahdi,30,0.00070,3824527,88.71472,4311040
5069,amshinde,30,0.00070,3824557,88.71541,4311040
5070,AndersonQ,30,0.00070,3824587,88.71611,4311040
5071,anshprat,30,0.00070,3824617,88.71681,4311040
5072,AnthonyWC,30,0.00070,3824647,88.71750,4311040
5073,anton-johansson,30,0.00070,3824677,88.71820,4311040
5074,armujahid,30,0.00070,3824707,88.71889,4311040
5075,arnaudmz,30,0.00070,3824737,88.71959,4311040
5076,asac,30,0.00070,3824767,88.72029,4311040
5077,astropuffin,30,0.00070,3824797,88.72098,4311040
5078,bbguimaraes,30,0.00070,3824827,88.72168,4311040
5079,bergerhoffer,30,0.00070,3824857,88.72237,4311040
5080,bhperry,30,0.00070,3824887,88.72307,4311040
5081,bitglue,30,0.00070,3824917,88.72377,4311040
5082,brentpearson,30,0.00070,3824947,88.72446,4311040
5083,briend,30,0.00070,3824977,88.72516,4311040
5084,bysph,30,0.00070,3825007,88.72585,4311040
5085,calvinbui,30,0.00070,3825037,88.72655,4311040
5086,CalvinHartwell,30,0.00070,3825067,88.72724,4311040
5087,carlpett,30,0.00070,3825097,88.72794,4311040
5088,cflewis,30,0.00070,3825127,88.72864,4311040
5089,cforce,30,0.00070,3825157,88.72933,4311040
5090,chiefy,30,0.00070,3825187,88.73003,4311040
5091,Chili-Man,30,0.00070,3825217,88.73072,4311040
5092,chmouel,30,0.00070,3825247,88.73142,4311040
5093,CodeJuan,30,0.00070,3825277,88.73212,4311040
5094,cprayer,30,0.00070,3825307,88.73281,4311040
5095,cruwe,30,0.00070,3825337,88.73351,4311040
5096,davidfowl,30,0.00070,3825367,88.73420,4311040
5097,davidwalter0,30,0.00070,3825397,88.73490,4311040
5098,DimpleRajaVamsi,30,0.00070,3825427,88.73560,4311040
5099,distol,30,0.00070,3825457,88.73629,4311040
5100,dkulchinsky,30,0.00070,3825487,88.73699,4311040
5101,dmitry-mightydevops,30,0.00070,3825517,88.73768,4311040
5102,elegos,30,0.00070,3825547,88.73838,4311040
5103,emirot,30,0.00070,3825577,88.73907,4311040
5104,Eriner,30,0.00070,3825607,88.73977,4311040
5105,fatalc,30,0.00070,3825637,88.74047,4311040
5106,foxdalas,30,0.00070,3825667,88.74116,4311040
5107,ganeshmaharaj,30,0.00070,3825697,88.74186,4311040
5108,greut,30,0.00070,3825727,88.74255,4311040
5109,hairyhenderson,30,0.00070,3825757,88.74325,4311040
5110,harjas27,30,0.00070,3825787,88.74395,4311040
5111,ilyee,30,0.00070,3825817,88.74464,4311040
5112,Jamstah,30,0.00070,3825847,88.74534,4311040
5113,jdockerty,30,0.00070,3825877,88.74603,4311040
5114,jeffchanjunwei,30,0.00070,3825907,88.74673,4311040
5115,Jell,30,0.00070,3825937,88.74743,4311040
5116,jjasghar,30,0.00070,3825967,88.74812,4311040
5117,jonfriesen,30,0.00070,3825997,88.74882,4311040
5118,juanluisvaladas,30,0.00070,3826027,88.74951,4311040
5119,kaarolch,30,0.00070,3826057,88.75021,4311040
5120,kaplanelad,30,0.00070,3826087,88.75090,4311040
5121,kskalski,30,0.00070,3826117,88.75160,4311040
5122,Kyrremann,30,0.00070,3826147,88.75230,4311040
5123,lareeth,30,0.00070,3826177,88.75299,4311040
5124,ljdelight,30,0.00070,3826207,88.75369,4311040
5125,ljnaresh,30,0.00070,3826237,88.75438,4311040
5126,LSmyrnaios,30,0.00070,3826267,88.75508,4311040
5127,ltupin,30,0.00070,3826297,88.75578,4311040
5128,luis5tb,30,0.00070,3826327,88.75647,4311040
5129,manansaraf,30,0.00070,3826357,88.75717,4311040
5130,marcelocyreno,30,0.00070,3826387,88.75786,4311040
5131,marcstreeter,30,0.00070,3826417,88.75856,4311040
5132,MartinKaburu,30,0.00070,3826447,88.75926,4311040
5133,Maxpain177,30,0.00070,3826477,88.75995,4311040
5134,mnagy,30,0.00070,3826507,88.76065,4311040
5135,mrballcb,30,0.00070,3826537,88.76134,4311040
5136,nagexiucai,30,0.00070,3826567,88.76204,4311040
5137,nbutton23,30,0.00070,3826597,88.76273,4311040
5138,neverfox,30,0.00070,3826627,88.76343,4311040
5139,nicolaferraro,30,0.00070,3826657,88.76413,4311040
5140,nishant-jain-94,30,0.00070,3826687,88.76482,4311040
5141,noah8713,30,0.00070,3826717,88.76552,4311040
5142,novahe,30,0.00070,3826747,88.76621,4311040
5143,NovaHe,30,0.00070,3826777,88.76691,4311040
5144,nuka137,30,0.00070,3826807,88.76761,4311040
5145,offzale,30,0.00070,3826837,88.76830,4311040
5146,Omkar0114,30,0.00070,3826867,88.76900,4311040
5147,ossareh,30,0.00070,3826897,88.76969,4311040
5148,otakumike,30,0.00070,3826927,88.77039,4311040
5149,pawanpraka1,30,0.00070,3826957,88.77109,4311040
5150,pcgeek86,30,0.00070,3826987,88.77178,4311040
5151,pesho,30,0.00070,3827017,88.77248,4311040
5152,philoserf,30,0.00070,3827047,88.77317,4311040
5153,phumberdroz,30,0.00070,3827077,88.77387,4311040
5154,pierre-emmanuelJ,30,0.00070,3827107,88.77456,4311040
5155,pradeeppandeyy,30,0.00070,3827137,88.77526,4311040
5156,project0,30,0.00070,3827167,88.77596,4311040
5157,RakshitKumar04,30,0.00070,3827197,88.77665,4311040
5158,ranjan2829,30,0.00070,3827227,88.77735,4311040
5159,rcorre,30,0.00070,3827257,88.77804,4311040
5160,rosskukulinski,30,0.00070,3827287,88.77874,4311040
5161,s3rj1k,30,0.00070,3827317,88.77944,4311040
5162,scothis,30,0.00070,3827347,88.78013,4311040
5163,seantywork,30,0.00070,3827377,88.78083,4311040
5164,shmish111,30,0.00070,3827407,88.78152,4311040
5165,Shunpoco,30,0.00070,3827437,88.78222,4311040
5166,simongottschlag,30,0.00070,3827467,88.78292,4311040
5167,sjmiller609,30,0.00070,3827497,88.78361,4311040
5168,smileisak,30,0.00070,3827527,88.78431,4311040
5169,snwfdhmp,30,0.00070,3827557,88.78500,4311040
5170,ssbarnea,30,0.00070,3827587,88.78570,4311040
5171,superleo,30,0.00070,3827617,88.78639,4311040
5172,till,30,0.00070,3827647,88.78709,4311040
5173,tlbdk,30,0.00070,3827677,88.78779,4311040
5174,tomwans,30,0.00070,3827707,88.78848,4311040
5175,vsabella,30,0.00070,3827737,88.78918,4311040
5176,while1eq1,30,0.00070,3827767,88.78987,4311040
5177,witlessbird,30,0.00070,3827797,88.79057,4311040
5178,wu-qiang,30,0.00070,3827827,88.79127,4311040
5179,wyardley,30,0.00070,3827857,88.79196,4311040
5180,xiuqiaoli,30,0.00070,3827887,88.79266,4311040
5181,yasker,30,0.00070,3827917,88.79335,4311040
5182,yehielnetapp,30,0.00070,3827947,88.79405,4311040
5183,yland,30,0.00070,3827977,88.79475,4311040
5184,YorikSar,30,0.00070,3828007,88.79544,4311040
5185,2eron,29,0.00067,3828036,88.79611,4311040
5186,aceeric,29,0.00067,3828065,88.79679,4311040
5187,AdityaMisra,29,0.00067,3828094,88.79746,4311040
5188,ahmed-mez,29,0.00067,3828123,88.79813,4311040
5189,AlexeyKasatkin,29,0.00067,3828152,88.79880,4311040
5190,alml,29,0.00067,3828181,88.79948,4311040
5191,amitkumarj441,29,0.00067,3828210,88.80015,4311040
5192,Arsen-Uulu,29,0.00067,3828239,88.80082,4311040
5193,ashb,29,0.00067,3828268,88.80150,4311040
5194,ashic,29,0.00067,3828297,88.80217,4311040
5195,ASverdlov,29,0.00067,3828326,88.80284,4311040
5196,awalker125,29,0.00067,3828355,88.80351,4311040
5197,besha100,29,0.00067,3828384,88.80419,4311040
5198,bingbing8,29,0.00067,3828413,88.80486,4311040
5199,bkuschel,29,0.00067,3828442,88.80553,4311040
5200,bordenit,29,0.00067,3828471,88.80620,4311040
5201,bwmetcalf,29,0.00067,3828500,88.80688,4311040
5202,calavera,29,0.00067,3828529,88.80755,4311040
5203,carlosjgp,29,0.00067,3828558,88.80822,4311040
5204,chengyu-l,29,0.00067,3828587,88.80890,4311040
5205,chnyda,29,0.00067,3828616,88.80957,4311040
5206,concaf,29,0.00067,3828645,88.81024,4311040
5207,creydr,29,0.00067,3828674,88.81091,4311040
5208,cronik,29,0.00067,3828703,88.81159,4311040
5209,cuppett,29,0.00067,3828732,88.81226,4311040
5210,daniel-garcia,29,0.00067,3828761,88.81293,4311040
5211,dene14,29,0.00067,3828790,88.81360,4311040
5212,denibertovic,29,0.00067,3828819,88.81428,4311040
5213,dereulenspiegel,29,0.00067,3828848,88.81495,4311040
5214,devstein,29,0.00067,3828877,88.81562,4311040
5215,drGrove,29,0.00067,3828906,88.81629,4311040
5216,eherot,29,0.00067,3828935,88.81697,4311040
5217,ElijahCaine,29,0.00067,3828964,88.81764,4311040
5218,emosbaugh,29,0.00067,3828993,88.81831,4311040
5219,EnergyLiYN,29,0.00067,3829022,88.81899,4311040
5220,epcim,29,0.00067,3829051,88.81966,4311040
5221,ericandrewlewis,29,0.00067,3829080,88.82033,4311040
5222,eromanova,29,0.00067,3829109,88.82100,4311040
5223,eugene-marchanka,29,0.00067,3829138,88.82168,4311040
5224,eyalev,29,0.00067,3829167,88.82235,4311040
5225,flmmartins,29,0.00067,3829196,88.82302,4311040
5226,frodopwns,29,0.00067,3829225,88.82369,4311040
5227,gecube,29,0.00067,3829254,88.82437,4311040
5228,germetist,29,0.00067,3829283,88.82504,4311040
5229,gireeshp,29,0.00067,3829312,88.82571,4311040
5230,Goodwine,29,0.00067,3829341,88.82639,4311040
5231,HardikDR,29,0.00067,3829370,88.82706,4311040
5232,hiddeco,29,0.00067,3829399,88.82773,4311040
5233,hsyed,29,0.00067,3829428,88.82840,4311040
5234,huynq0911,29,0.00067,3829457,88.82908,4311040
5235,inyee786,29,0.00067,3829486,88.82975,4311040
5236,ismith,29,0.00067,3829515,88.83042,4311040
5237,istikamet,29,0.00067,3829544,88.83109,4311040
5238,janario,29,0.00067,3829573,88.83177,4311040
5239,jensentanlo,29,0.00067,3829602,88.83244,4311040
5240,jeyglk,29,0.00067,3829631,88.83311,4311040
5241,jmound,29,0.00067,3829660,88.83378,4311040
5242,jonKSA,29,0.00067,3829689,88.83446,4311040
5243,jseldess,29,0.00067,3829718,88.83513,4311040
5244,kcrawley,29,0.00067,3829747,88.83580,4311040
5245,kevpar,29,0.00067,3829776,88.83648,4311040
5246,kohtala,29,0.00067,3829805,88.83715,4311040
5247,Kokan,29,0.00067,3829834,88.83782,4311040
5248,kongslund,29,0.00067,3829863,88.83849,4311040
5249,kuramal,29,0.00067,3829892,88.83917,4311040
5250,Kusanagi9999,29,0.00067,3829921,88.83984,4311040
5251,kzwang,29,0.00067,3829950,88.84051,4311040
5252,learner0810,29,0.00067,3829979,88.84118,4311040
5253,LeeHampton,29,0.00067,3830008,88.84186,4311040
5254,leonwanghui,29,0.00067,3830037,88.84253,4311040
5255,ltamaster,29,0.00067,3830066,88.84320,4311040
5256,luispabon,29,0.00067,3830095,88.84388,4311040
5257,manedurphy,29,0.00067,3830124,88.84455,4311040
5258,manueltellez,29,0.00067,3830153,88.84522,4311040
5259,marshall007,29,0.00067,3830182,88.84589,4311040
5260,mbtamuli,29,0.00067,3830211,88.84657,4311040
5261,meowfaceman,29,0.00067,3830240,88.84724,4311040
5262,mgalgs,29,0.00067,3830269,88.84791,4311040
5263,Mini256,29,0.00067,3830298,88.84858,4311040
5264,mlowery,29,0.00067,3830327,88.84926,4311040
5265,mltsy,29,0.00067,3830356,88.84993,4311040
5266,morallito,29,0.00067,3830385,88.85060,4311040
5267,mrogers950,29,0.00067,3830414,88.85127,4311040
5268,mrrandrade,29,0.00067,3830443,88.85195,4311040
5269,mseewooth,29,0.00067,3830472,88.85262,4311040
5270,musse,29,0.00067,3830501,88.85329,4311040
5271,owenhaynes,29,0.00067,3830530,88.85397,4311040
5272,Penguin-zlh,29,0.00067,3830559,88.85464,4311040
5273,piequi,29,0.00067,3830588,88.85531,4311040
5274,qingkunl,29,0.00067,3830617,88.85598,4311040
5275,rguichard,29,0.00067,3830646,88.85666,4311040
5276,rsevilla87,29,0.00067,3830675,88.85733,4311040
5277,s3than,29,0.00067,3830704,88.85800,4311040
5278,sallydeng,29,0.00067,3830733,88.85867,4311040
5279,sebastien-prudhomme,29,0.00067,3830762,88.85935,4311040
5280,secustor,29,0.00067,3830791,88.86002,4311040
5281,tatobi,29,0.00067,3830820,88.86069,4311040
5282,thedrow,29,0.00067,3830849,88.86137,4311040
5283,timbunce,29,0.00067,3830878,88.86204,4311040
5284,toVersus,29,0.00067,3830907,88.86271,4311040
5285,tuanvcw,29,0.00067,3830936,88.86338,4311040
5286,tylerauerbeck,29,0.00067,3830965,88.86406,4311040
5287,valeriano-manassero,29,0.00067,3830994,88.86473,4311040
5288,vincentmli,29,0.00067,3831023,88.86540,4311040
5289,wfhartford,29,0.00067,3831052,88.86607,4311040
5290,willbeason,29,0.00067,3831081,88.86675,4311040
5291,wxuedong,29,0.00067,3831110,88.86742,4311040
5292,xudifsd,29,0.00067,3831139,88.86809,4311040
5293,xuxinkun,29,0.00067,3831168,88.86876,4311040
5294,yanirq,29,0.00067,3831197,88.86944,4311040
5295,yodarshafrir1,29,0.00067,3831226,88.87011,4311040
5296,yongzhang,29,0.00067,3831255,88.87078,4311040
5297,7oku,28,0.00065,3831283,88.87143,4311040
5298,aaruna,28,0.00065,3831311,88.87208,4311040
5299,AbdulBasitAlvi,28,0.00065,3831339,88.87273,4311040
5300,AceHack,28,0.00065,3831367,88.87338,4311040
5301,ajayk,28,0.00065,3831395,88.87403,4311040
5302,alexec,28,0.00065,3831423,88.87468,4311040
5303,AmitBenAmi,28,0.00065,3831451,88.87533,4311040
5304,andersjanmyr,28,0.00065,3831479,88.87598,4311040
5305,andrey01,28,0.00065,3831507,88.87663,4311040
5306,anjuls,28,0.00065,3831535,88.87728,4311040
5307,Aracki,28,0.00065,3831563,88.87793,4311040
5308,ArchangelX360,28,0.00065,3831591,88.87858,4311040
5309,ArieLevs,28,0.00065,3831619,88.87923,4311040
5310,Ayush9026,28,0.00065,3831647,88.87988,4311040
5311,babilen5,28,0.00065,3831675,88.88053,4311040
5312,better88,28,0.00065,3831703,88.88117,4311040
5313,billpratt,28,0.00065,3831731,88.88182,4311040
5314,braghettos,28,0.00065,3831759,88.88247,4311040
5315,bramvdklinkenberg,28,0.00065,3831787,88.88312,4311040
5316,brianmay,28,0.00065,3831815,88.88377,4311040
5317,brooksgarrett,28,0.00065,3831843,88.88442,4311040
5318,bvandewalle,28,0.00065,3831871,88.88507,4311040
5319,calfonso,28,0.00065,3831899,88.88572,4311040
5320,cceckman,28,0.00065,3831927,88.88637,4311040
5321,chaitanyaenr,28,0.00065,3831955,88.88702,4311040
5322,chanjarster,28,0.00065,3831983,88.88767,4311040
5323,cheungpat,28,0.00065,3832011,88.88832,4311040
5324,chriskinsman,28,0.00065,3832039,88.88897,4311040
5325,chupman,28,0.00065,3832067,88.88962,4311040
5326,connor1989,28,0.00065,3832095,88.89027,4311040
5327,daxmc99,28,0.00065,3832123,88.89092,4311040
5328,de1m,28,0.00065,3832151,88.89157,4311040
5329,delfer,28,0.00065,3832179,88.89222,4311040
5330,dennis-benzinger-hybris,28,0.00065,3832207,88.89287,4311040
5331,dirkmueller,28,0.00065,3832235,88.89352,4311040
5332,dmage,28,0.00065,3832263,88.89416,4311040
5333,donhui,28,0.00065,3832291,88.89481,4311040
5334,draksha22,28,0.00065,3832319,88.89546,4311040
5335,dsharp-pivotal,28,0.00065,3832347,88.89611,4311040
5336,duchuanLX,28,0.00065,3832375,88.89676,4311040
5337,esecules,28,0.00065,3832403,88.89741,4311040
5338,eugene-chow,28,0.00065,3832431,88.89806,4311040
5339,FischerLGLN,28,0.00065,3832459,88.89871,4311040
5340,gadinaor,28,0.00065,3832487,88.89936,4311040
5341,genome21,28,0.00065,3832515,88.90001,4311040
5342,gmile,28,0.00065,3832543,88.90066,4311040
5343,haines,28,0.00065,3832571,88.90131,4311040
5344,harveyxia,28,0.00065,3832599,88.90196,4311040
5345,huikang,28,0.00065,3832627,88.90261,4311040
5346,jasine,28,0.00065,3832655,88.90326,4311040
5347,jcrowthe,28,0.00065,3832683,88.90391,4311040
5348,jhoblitt,28,0.00065,3832711,88.90456,4311040
5349,jistr,28,0.00065,3832739,88.90521,4311040
5350,joonlim,28,0.00065,3832767,88.90586,4311040
5351,JosephSalisbury,28,0.00065,3832795,88.90651,4311040
5352,joshk0,28,0.00065,3832823,88.90715,4311040
5353,jpriebe,28,0.00065,3832851,88.90780,4311040
5354,junneyang,28,0.00065,3832879,88.90845,4311040
5355,karlhungus,28,0.00065,3832907,88.90910,4311040
5356,kinarashah,28,0.00065,3832935,88.90975,4311040
5357,kiyoshim55,28,0.00065,3832963,88.91040,4311040
5358,kumarom,28,0.00065,3832991,88.91105,4311040
5359,lazzarello,28,0.00065,3833019,88.91170,4311040
5360,lexxxel,28,0.00065,3833047,88.91235,4311040
5361,liamawhite,28,0.00065,3833075,88.91300,4311040
5362,LukeMwila,28,0.00065,3833103,88.91365,4311040
5363,luojie233,28,0.00065,3833131,88.91430,4311040
5364,lyzhang1999,28,0.00065,3833159,88.91495,4311040
5365,mamikonyana,28,0.00065,3833187,88.91560,4311040
5366,martin-ducar-gd,28,0.00065,3833215,88.91625,4311040
5367,masterzen,28,0.00065,3833243,88.91690,4311040
5368,Matheusafonsouza,28,0.00065,3833271,88.91755,4311040
5369,mfbieber,28,0.00065,3833299,88.91820,4311040
5370,mfpierre,28,0.00065,3833327,88.91885,4311040
5371,mhulscher,28,0.00065,3833355,88.91950,4311040
5372,mikechengwei,28,0.00065,3833383,88.92014,4311040
5373,missingcharacter,28,0.00065,3833411,88.92079,4311040
5374,mstrYoda,28,0.00065,3833439,88.92144,4311040
5375,parikhyash,28,0.00065,3833467,88.92209,4311040
5376,PaulCharlton,28,0.00065,3833495,88.92274,4311040
5377,pawank0411,28,0.00065,3833523,88.92339,4311040
5378,pierDipi,28,0.00065,3833551,88.92404,4311040
5379,posix4e,28,0.00065,3833579,88.92469,4311040
5380,pslijkhuis,28,0.00065,3833607,88.92534,4311040
5381,queeno,28,0.00065,3833635,88.92599,4311040
5382,rancerbeta,28,0.00065,3833663,88.92664,4311040
5383,rushtehrani,28,0.00065,3833691,88.92729,4311040
5384,rvillablanca,28,0.00065,3833719,88.92794,4311040
5385,rytswd,28,0.00065,3833747,88.92859,4311040
5386,scostache,28,0.00065,3833775,88.92924,4311040
5387,sdodsley,28,0.00065,3833803,88.92989,4311040
5388,sdurrheimer,28,0.00065,3833831,88.93054,4311040
5389,shiresky,28,0.00065,3833859,88.93119,4311040
5390,shiveshabhishek,28,0.00065,3833887,88.93184,4311040
5391,shomron,28,0.00065,3833915,88.93248,4311040
5392,ShualLiu,28,0.00065,3833943,88.93313,4311040
5393,shyaamsn,28,0.00065,3833971,88.93378,4311040
5394,sngchlko,28,0.00065,3833999,88.93443,4311040
5395,sondinht,28,0.00065,3834027,88.93508,4311040
5396,srflaxu40,28,0.00065,3834055,88.93573,4311040
5397,taaraora,28,0.00065,3834083,88.93638,4311040
5398,tammersaleh,28,0.00065,3834111,88.93703,4311040
5399,thedadams,28,0.00065,3834139,88.93768,4311040
5400,unacceptable,28,0.00065,3834167,88.93833,4311040
5401,vjm,28,0.00065,3834195,88.93898,4311040
5402,v-pap,28,0.00065,3834223,88.93963,4311040
5403,wabernatScality,28,0.00065,3834251,88.94028,4311040
5404,wefine,28,0.00065,3834279,88.94093,4311040
5405,wwwil,28,0.00065,3834307,88.94158,4311040
5406,yalctay93,28,0.00065,3834335,88.94223,4311040
5407,ycjiang50,28,0.00065,3834363,88.94288,4311040
5408,youwalther65,28,0.00065,3834391,88.94353,4311040
5409,zhaochaobo,28,0.00065,3834419,88.94418,4311040
5410,zhuguihua,28,0.00065,3834447,88.94483,4311040
5411,ZhuPeng,28,0.00065,3834475,88.94547,4311040
5412,ackintosh,27,0.00063,3834502,88.94610,4311040
5413,afrittoli,27,0.00063,3834529,88.94673,4311040
5414,afro-coder,27,0.00063,3834556,88.94735,4311040
5415,akanso,27,0.00063,3834583,88.94798,4311040
5416,anandkumarpatel,27,0.00063,3834610,88.94861,4311040
5417,andersosthus,27,0.00063,3834637,88.94923,4311040
5418,AndresPineros,27,0.00063,3834664,88.94986,4311040
5419,a-palchikov,27,0.00063,3834691,88.95049,4311040
5420,arturhoo,27,0.00063,3834718,88.95111,4311040
5421,asherf,27,0.00063,3834745,88.95174,4311040
5422,avdhoot,27,0.00063,3834772,88.95236,4311040
5423,avinashupadhya99,27,0.00063,3834799,88.95299,4311040
5424,awprice,27,0.00063,3834826,88.95362,4311040
5425,axsuul,27,0.00063,3834853,88.95424,4311040
5426,Azbesciak,27,0.00063,3834880,88.95487,4311040
5427,aznashwan,27,0.00063,3834907,88.95550,4311040
5428,baijum,27,0.00063,3834934,88.95612,4311040
5429,barry-schneider,27,0.00063,3834961,88.95675,4311040
5430,benjigoldberg,27,0.00063,3834988,88.95737,4311040
5431,bfallik,27,0.00063,3835015,88.95800,4311040
5432,bibryam,27,0.00063,3835042,88.95863,4311040
5433,BoleynSu,27,0.00063,3835069,88.95925,4311040
5434,byteor,27,0.00063,3835096,88.95988,4311040
5435,castlemilk,27,0.00063,3835123,88.96051,4311040
5436,ccravens,27,0.00063,3835150,88.96113,4311040
5437,cdickmann,27,0.00063,3835177,88.96176,4311040
5438,christian-roggia,27,0.00063,3835204,88.96238,4311040
5439,cometrojan,27,0.00063,3835231,88.96301,4311040
5440,darshanime,27,0.00063,3835258,88.96364,4311040
5441,dastonzerg,27,0.00063,3835285,88.96426,4311040
5442,daverick,27,0.00063,3835312,88.96489,4311040
5443,DavidLangworthy,27,0.00063,3835339,88.96552,4311040
5444,dcarney,27,0.00063,3835366,88.96614,4311040
5445,decker502,27,0.00063,3835393,88.96677,4311040
5446,deromka,27,0.00063,3835420,88.96740,4311040
5447,Deshke,27,0.00063,3835447,88.96802,4311040
5448,diegocn,27,0.00063,3835474,88.96865,4311040
5449,diegows,27,0.00063,3835501,88.96927,4311040
5450,djboris9,27,0.00063,3835528,88.96990,4311040
5451,dmyerscough,27,0.00063,3835555,88.97053,4311040
5452,donbeave,27,0.00063,3835582,88.97115,4311040
5453,emmanuel,27,0.00063,3835609,88.97178,4311040
5454,FerminCastro,27,0.00063,3835636,88.97241,4311040
5455,FlorentATo,27,0.00063,3835663,88.97303,4311040
5456,FlorianOtel,27,0.00063,3835690,88.97366,4311040
5457,frankjiao,27,0.00063,3835717,88.97428,4311040
5458,galindro,27,0.00063,3835744,88.97491,4311040
5459,gdmello,27,0.00063,3835771,88.97554,4311040
5460,gertcuykens,27,0.00063,3835798,88.97616,4311040
5461,goddenrich,27,0.00063,3835825,88.97679,4311040
5462,googs1025,27,0.00063,3835852,88.97742,4311040
5463,grafvonb,27,0.00063,3835879,88.97804,4311040
5464,hercynium,27,0.00063,3835906,88.97867,4311040
5465,HerrmannHinz,27,0.00063,3835933,88.97930,4311040
5466,horis233,27,0.00063,3835960,88.97992,4311040
5467,hterik,27,0.00063,3835987,88.98055,4311040
5468,iamchuckss,27,0.00063,3836014,88.98117,4311040
5469,imriss,27,0.00063,3836041,88.98180,4311040
5470,it2911,27,0.00063,3836068,88.98243,4311040
5471,itdove,27,0.00063,3836095,88.98305,4311040
5472,JasonGiedymin,27,0.00063,3836122,88.98368,4311040
5473,javapapo,27,0.00063,3836149,88.98431,4311040
5474,javiercr,27,0.00063,3836176,88.98493,4311040
5475,jfchevrette,27,0.00063,3836203,88.98556,4311040
5476,jhbiggs,27,0.00063,3836230,88.98618,4311040
5477,jianliao82,27,0.00063,3836257,88.98681,4311040
5478,jiecloud,27,0.00063,3836284,88.98744,4311040
5479,jnaulty,27,0.00063,3836311,88.98806,4311040
5480,johnko,27,0.00063,3836338,88.98869,4311040
5481,johnt337,27,0.00063,3836365,88.98932,4311040
5482,joshuarubin,27,0.00063,3836392,88.98994,4311040
5483,jparklab,27,0.00063,3836419,88.99057,4311040
5484,jsleeio,27,0.00063,3836446,88.99119,4311040
5485,karolyc,27,0.00063,3836473,88.99182,4311040
5486,kelcecil,27,0.00063,3836500,88.99245,4311040
5487,kevinsimper,27,0.00063,3836527,88.99307,4311040
5488,king-julien,27,0.00063,3836554,88.99370,4311040
5489,korjek,27,0.00063,3836581,88.99433,4311040
5490,kwaazaar,27,0.00063,3836608,88.99495,4311040
5491,leodido,27,0.00063,3836635,88.99558,4311040
5492,Luke-Humphreys,27,0.00063,3836662,88.99621,4311040
5493,madhukar32,27,0.00063,3836689,88.99683,4311040
5494,marcosnils,27,0.00063,3836716,88.99746,4311040
5495,mcfedr,27,0.00063,3836743,88.99808,4311040
5496,moogzy,27,0.00063,3836770,88.99871,4311040
5497,mtovmassian,27,0.00063,3836797,88.99934,4311040
5498,mudverma,27,0.00063,3836824,88.99996,4311040
5499,mykaul,27,0.00063,3836851,89.00059,4311040
5500,nailgun,27,0.00063,3836878,89.00122,4311040
5501,nancykyo,27,0.00063,3836905,89.00184,4311040
5502,nelsonfassis,27,0.00063,3836932,89.00247,4311040
5503,nevola,27,0.00063,3836959,89.00309,4311040
5504,nicolasbelanger,27,0.00063,3836986,89.00372,4311040
5505,nitisht,27,0.00063,3837013,89.00435,4311040
5506,Nonymus,27,0.00063,3837040,89.00497,4311040
5507,Ntr0,27,0.00063,3837067,89.00560,4311040
5508,OmerKahani,27,0.00063,3837094,89.00623,4311040
5509,omkensey,27,0.00063,3837121,89.00685,4311040
5510,ordovicia,27,0.00063,3837148,89.00748,4311040
5511,oscerd,27,0.00063,3837175,89.00810,4311040
5512,palonsoro,27,0.00063,3837202,89.00873,4311040
5513,PeterLamar,27,0.00063,3837229,89.00936,4311040
5514,philipn,27,0.00063,3837256,89.00998,4311040
5515,polvi,27,0.00063,3837283,89.01061,4311040
5516,pradeepjairamani,27,0.00063,3837310,89.01124,4311040
5517,prat0318,27,0.00063,3837337,89.01186,4311040
5518,Prucek,27,0.00063,3837364,89.01249,4311040
5519,przemolb,27,0.00063,3837391,89.01312,4311040
5520,pswenson,27,0.00063,3837418,89.01374,4311040
5521,quangnguyen101,27,0.00063,3837445,89.01437,4311040
5522,randmonkey,27,0.00063,3837472,89.01499,4311040
5523,rcjsuen,27,0.00063,3837499,89.01562,4311040
5524,ReneSaenz,27,0.00063,3837526,89.01625,4311040
5525,rmorrise,27,0.00063,3837553,89.01687,4311040
5526,robinelfrink,27,0.00063,3837580,89.01750,4311040
5527,robinschneider,27,0.00063,3837607,89.01813,4311040
5528,roehrijn,27,0.00063,3837634,89.01875,4311040
5529,rsliotta,27,0.00063,3837661,89.01938,4311040
5530,rsoika,27,0.00063,3837688,89.02000,4311040
5531,RubenBaez,27,0.00063,3837715,89.02063,4311040
5532,rusher81572,27,0.00063,3837742,89.02126,4311040
5533,sebader,27,0.00063,3837769,89.02188,4311040
5534,secat,27,0.00063,3837796,89.02251,4311040
5535,sellers,27,0.00063,3837823,89.02314,4311040
5536,Shatakshi0805,27,0.00063,3837850,89.02376,4311040
5537,skeeey,27,0.00063,3837877,89.02439,4311040
5538,sreekaransrinath,27,0.00063,3837904,89.02501,4311040
5539,stonith,27,0.00063,3837931,89.02564,4311040
5540,strowi,27,0.00063,3837958,89.02627,4311040
5541,stu-gott,27,0.00063,3837985,89.02689,4311040
5542,styk-tv,27,0.00063,3838012,89.02752,4311040
5543,surki,27,0.00063,3838039,89.02815,4311040
5544,tanner-bruce,27,0.00063,3838066,89.02877,4311040
5545,tcurdt,27,0.00063,3838093,89.02940,4311040
5546,tristanz,27,0.00063,3838120,89.03003,4311040
5547,tummychow,27,0.00063,3838147,89.03065,4311040
5548,txomon,27,0.00063,3838174,89.03128,4311040
5549,vboginskey,27,0.00063,3838201,89.03190,4311040
5550,vicsufer,27,0.00063,3838228,89.03253,4311040
5551,VillePihlava,27,0.00063,3838255,89.03316,4311040
5552,vklonghml,27,0.00063,3838282,89.03378,4311040
5553,vyom-soft,27,0.00063,3838309,89.03441,4311040
5554,war-turtle,27,0.00063,3838336,89.03504,4311040
5555,wbrefvem,27,0.00063,3838363,89.03566,4311040
5556,WilliamDenniss,27,0.00063,3838390,89.03629,4311040
5557,wteiken,27,0.00063,3838417,89.03691,4311040
5558,xiangfeiz,27,0.00063,3838444,89.03754,4311040
5559,yanyhui,27,0.00063,3838471,89.03817,4311040
5560,yrs147,27,0.00063,3838498,89.03879,4311040
5561,ziabs,27,0.00063,3838525,89.03942,4311040
5562,Ab-hishek,26,0.00060,3838551,89.04002,4311040
5563,adityaalifn,26,0.00060,3838577,89.04063,4311040
5564,adkafka,26,0.00060,3838603,89.04123,4311040
5565,adowair,26,0.00060,3838629,89.04183,4311040
5566,ahaysx,26,0.00060,3838655,89.04244,4311040
5567,alarge,26,0.00060,3838681,89.04304,4311040
5568,alexmaret,26,0.00060,3838707,89.04364,4311040
5569,alex-slynko,26,0.00060,3838733,89.04424,4311040
5570,alfirin,26,0.00060,3838759,89.04485,4311040
5571,alph486,26,0.00060,3838785,89.04545,4311040
5572,amdonov,26,0.00060,3838811,89.04605,4311040
5573,amimof,26,0.00060,3838837,89.04666,4311040
5574,anders-swanson,26,0.00060,3838863,89.04726,4311040
5575,argoyle,26,0.00060,3838889,89.04786,4311040
5576,arturgspb,26,0.00060,3838915,89.04847,4311040
5577,asarkar,26,0.00060,3838941,89.04907,4311040
5578,baasbank,26,0.00060,3838967,89.04967,4311040
5579,bartoszmajsak,26,0.00060,3838993,89.05028,4311040
5580,basvandenbrink,26,0.00060,3839019,89.05088,4311040
5581,Bekt,26,0.00060,3839045,89.05148,4311040
5582,bonowang,26,0.00060,3839071,89.05208,4311040
5583,boranx,26,0.00060,3839097,89.05269,4311040
5584,cardil,26,0.00060,3839123,89.05329,4311040
5585,cemo,26,0.00060,3839149,89.05389,4311040
5586,ChanderG,26,0.00060,3839175,89.05450,4311040
5587,coderwangke,26,0.00060,3839201,89.05510,4311040
5588,czunker,26,0.00060,3839227,89.05570,4311040
5589,davidovich,26,0.00060,3839253,89.05631,4311040
5590,derailed,26,0.00060,3839279,89.05691,4311040
5591,devholic,26,0.00060,3839305,89.05751,4311040
5592,dialogbox,26,0.00060,3839331,89.05812,4311040
5593,dirien,26,0.00060,3839357,89.05872,4311040
5594,dm3ch,26,0.00060,3839383,89.05932,4311040
5595,DrBu7cher,26,0.00060,3839409,89.05993,4311040
5596,drnic,26,0.00060,3839435,89.06053,4311040
5597,endzyme,26,0.00060,3839461,89.06113,4311040
5598,epiclen,26,0.00060,3839487,89.06173,4311040
5599,EricMountain,26,0.00060,3839513,89.06234,4311040
5600,ericuldall,26,0.00060,3839539,89.06294,4311040
5601,erikh,26,0.00060,3839565,89.06354,4311040
5602,Ewocker,26,0.00060,3839591,89.06415,4311040
5603,fabiendupont,26,0.00060,3839617,89.06475,4311040
5604,fgiloux,26,0.00060,3839643,89.06535,4311040
5605,f-ld,26,0.00060,3839669,89.06596,4311040
5606,fooka03,26,0.00060,3839695,89.06656,4311040
5607,gabegorelick,26,0.00060,3839721,89.06716,4311040
5608,GabrielSVinha,26,0.00060,3839747,89.06777,4311040
5609,gdoctor,26,0.00060,3839773,89.06837,4311040
5610,GuessWhoSamFoo,26,0.00060,3839799,89.06897,4311040
5611,hodduc,26,0.00060,3839825,89.06957,4311040
5612,horizonzy,26,0.00060,3839851,89.07018,4311040
5613,hornpolish,26,0.00060,3839877,89.07078,4311040
5614,iamzhout,26,0.00060,3839903,89.07138,4311040
5615,icereval,26,0.00060,3839929,89.07199,4311040
5616,Insullone,26,0.00060,3839955,89.07259,4311040
5617,iotty,26,0.00060,3839981,89.07319,4311040
5618,iponnam,26,0.00060,3840007,89.07380,4311040
5619,isantospardo,26,0.00060,3840033,89.07440,4311040
5620,james65535,26,0.00060,3840059,89.07500,4311040
5621,James-Quigley,26,0.00060,3840085,89.07561,4311040
5622,JasonHaley,26,0.00060,3840111,89.07621,4311040
5623,Jason-ZW,26,0.00060,3840137,89.07681,4311040
5624,jaybatra26,26,0.00060,3840163,89.07742,4311040
5625,jcantrill,26,0.00060,3840189,89.07802,4311040
5626,jdolitsky,26,0.00060,3840215,89.07862,4311040
5627,jkaplowitz,26,0.00060,3840241,89.07922,4311040
5628,jkev53,26,0.00060,3840267,89.07983,4311040
5629,jlaswell,26,0.00060,3840293,89.08043,4311040
5630,jnicholls,26,0.00060,3840319,89.08103,4311040
5631,judexzhu,26,0.00060,3840345,89.08164,4311040
5632,kahootali,26,0.00060,3840371,89.08224,4311040
5633,kamilhristov,26,0.00060,3840397,89.08284,4311040
5634,Kavinraja-G,26,0.00060,3840423,89.08345,4311040
5635,kbhandari,26,0.00060,3840449,89.08405,4311040
5636,kellybirr,26,0.00060,3840475,89.08465,4311040
5637,kishorerj,26,0.00060,3840501,89.08526,4311040
5638,kivagant-ba,26,0.00060,3840527,89.08586,4311040
5639,L3o-pold,26,0.00060,3840553,89.08646,4311040
5640,laggyluke,26,0.00060,3840579,89.08706,4311040
5641,laijs,26,0.00060,3840605,89.08767,4311040
5642,ldx,26,0.00060,3840631,89.08827,4311040
5643,mangelajo,26,0.00060,3840657,89.08887,4311040
5644,marshallford,26,0.00060,3840683,89.08948,4311040
5645,Masquerade0097,26,0.00060,3840709,89.09008,4311040
5646,MeirP-3,26,0.00060,3840735,89.09068,4311040
5647,MeNsaaH,26,0.00060,3840761,89.09129,4311040
5648,meysam81,26,0.00060,3840787,89.09189,4311040
5649,michalskalski,26,0.00060,3840813,89.09249,4311040
5650,mirandawork,26,0.00060,3840839,89.09310,4311040
5651,mmisztal1980,26,0.00060,3840865,89.09370,4311040
5652,mnasiadka,26,0.00060,3840891,89.09430,4311040
5653,mskonovalov,26,0.00060,3840917,89.09491,4311040
5654,MurzNN,26,0.00060,3840943,89.09551,4311040
5655,nanorobocop,26,0.00060,3840969,89.09611,4311040
5656,nhumrich,26,0.00060,3840995,89.09671,4311040
5657,nyetwurk,26,0.00060,3841021,89.09732,4311040
5658,oleksiys,26,0.00060,3841047,89.09792,4311040
5659,OrlinVasilev,26,0.00060,3841073,89.09852,4311040
5660,PaulineLc,26,0.00060,3841099,89.09913,4311040
5661,Pendoragon,26,0.00060,3841125,89.09973,4311040
5662,peterrosell,26,0.00060,3841151,89.10033,4311040
5663,Pictor13,26,0.00060,3841177,89.10094,4311040
5664,prankkelkar,26,0.00060,3841203,89.10154,4311040
5665,praveensastry,26,0.00060,3841229,89.10214,4311040
5666,ProgramerGu,26,0.00060,3841255,89.10275,4311040
5667,qrevel,26,0.00060,3841281,89.10335,4311040
5668,QuentinBisson,26,0.00060,3841307,89.10395,4311040
5669,rainingmaster,26,0.00060,3841333,89.10455,4311040
5670,rajeshwer,26,0.00060,3841359,89.10516,4311040
5671,rambohe-ch,26,0.00060,3841385,89.10576,4311040
5672,raphaelauv,26,0.00060,3841411,89.10636,4311040
5673,rcmorano,26,0.00060,3841437,89.10697,4311040
5674,richardalberto,26,0.00060,3841463,89.10757,4311040
5675,rmohta,26,0.00060,3841489,89.10817,4311040
5676,roackb2,26,0.00060,3841515,89.10878,4311040
5677,rohantmp,26,0.00060,3841541,89.10938,4311040
5678,romanek-adam,26,0.00060,3841567,89.10998,4311040
5679,RomanKrasavtsev,26,0.00060,3841593,89.11059,4311040
5680,rowleyaj,26,0.00060,3841619,89.11119,4311040
5681,rverma-jm,26,0.00060,3841645,89.11179,4311040
5682,ryphon,26,0.00060,3841671,89.11240,4311040
5683,s0komma,26,0.00060,3841697,89.11300,4311040
5684,seano314,26,0.00060,3841723,89.11360,4311040
5685,sgandon,26,0.00060,3841749,89.11420,4311040
5686,shukawam,26,0.00060,3841775,89.11481,4311040
5687,sidewinder12s,26,0.00060,3841801,89.11541,4311040
5688,skonto,26,0.00060,3841827,89.11601,4311040
5689,Slach,26,0.00060,3841853,89.11662,4311040
5690,sorenmat,26,0.00060,3841879,89.11722,4311040
5691,strikingraghu,26,0.00060,3841905,89.11782,4311040
5692,timm088,26,0.00060,3841931,89.11843,4311040
5693,tiraboschi,26,0.00060,3841957,89.11903,4311040
5694,tiran,26,0.00060,3841983,89.11963,4311040
5695,tongpu,26,0.00060,3842009,89.12024,4311040
5696,trishankatdatadog,26,0.00060,3842035,89.12084,4311040
5697,tuannvm,26,0.00060,3842061,89.12144,4311040
5698,vboulineau,26,0.00060,3842087,89.12204,4311040
5699,vespian,26,0.00060,3842113,89.12265,4311040
5700,walteraa,26,0.00060,3842139,89.12325,4311040
5701,whs,26,0.00060,3842165,89.12385,4311040
5702,WillardHu,26,0.00060,3842191,89.12446,4311040
5703,wmuizelaar,26,0.00060,3842217,89.12506,4311040
5704,wzhliang,26,0.00060,3842243,89.12566,4311040
5705,XavierDuthil,26,0.00060,3842269,89.12627,4311040
5706,xrow,26,0.00060,3842295,89.12687,4311040
5707,yb172,26,0.00060,3842321,89.12747,4311040
5708,z4ce,26,0.00060,3842347,89.12808,4311040
5709,abhijeetgauravm,25,0.00058,3842372,89.12866,4311040
5710,adam-mesos,25,0.00058,3842397,89.12924,4311040
5711,adubkov,25,0.00058,3842422,89.12982,4311040
5712,alexef,25,0.00058,3842447,89.13040,4311040
5713,alexhersh,25,0.00058,3842472,89.13098,4311040
5714,alexw23,25,0.00058,3842497,89.13156,4311040
5715,amitkgupta,25,0.00058,3842522,89.13214,4311040
5716,amotoki,25,0.00058,3842547,89.13272,4311040
5717,Anubhavdevv,25,0.00058,3842572,89.13329,4311040
5718,arisgi,25,0.00058,3842597,89.13387,4311040
5719,AssafKatz3,25,0.00058,3842622,89.13445,4311040
5720,benmathews,25,0.00058,3842647,89.13503,4311040
5721,bensussman,25,0.00058,3842672,89.13561,4311040
5722,Birdrock,25,0.00058,3842697,89.13619,4311040
5723,bkochendorfer,25,0.00058,3842722,89.13677,4311040
5724,booxter,25,0.00058,3842747,89.13735,4311040
5725,bosatsu,25,0.00058,3842772,89.13793,4311040
5726,bseenu,25,0.00058,3842797,89.13851,4311040
5727,bugosiphionah,25,0.00058,3842822,89.13909,4311040
5728,Carlory,25,0.00058,3842847,89.13967,4311040
5729,ChristianCiach,25,0.00058,3842872,89.14025,4311040
5730,cjellick,25,0.00058,3842897,89.14083,4311040
5731,cpointner,25,0.00058,3842922,89.14141,4311040
5732,desty,25,0.00058,3842947,89.14199,4311040
5733,Dhiraj240,25,0.00058,3842972,89.14257,4311040
5734,dick-twocows,25,0.00058,3842997,89.14315,4311040
5735,d-shi,25,0.00058,3843022,89.14373,4311040
5736,dumb0002,25,0.00058,3843047,89.14431,4311040
5737,dvdthms,25,0.00058,3843072,89.14489,4311040
5738,EItanya,25,0.00058,3843097,89.14547,4311040
5739,EladDolev,25,0.00058,3843122,89.14605,4311040
5740,EricMountain-1A,25,0.00058,3843147,89.14663,4311040
5741,etanshaul,25,0.00058,3843172,89.14721,4311040
5742,etotheipi,25,0.00058,3843197,89.14779,4311040
5743,exarkun,25,0.00058,3843222,89.14837,4311040
5744,eyakubovich,25,0.00058,3843247,89.14895,4311040
5745,fluxrad,25,0.00058,3843272,89.14953,4311040
5746,fredjean,25,0.00058,3843297,89.15011,4311040
5747,fvasco,25,0.00058,3843322,89.15069,4311040
5748,gangadhars,25,0.00058,3843347,89.15127,4311040
5749,genti-t,25,0.00058,3843372,89.15185,4311040
5750,GreyBalloonYU,25,0.00058,3843397,89.15243,4311040
5751,guslcho,25,0.00058,3843422,89.15301,4311040
5752,harpratap,25,0.00058,3843447,89.15359,4311040
5753,helgi,25,0.00058,3843472,89.15417,4311040
5754,helios741,25,0.00058,3843497,89.15475,4311040
5755,hightoxicity,25,0.00058,3843522,89.15533,4311040
5756,honnix,25,0.00058,3843547,89.15591,4311040
5757,HuKeping,25,0.00058,3843572,89.15649,4311040
5758,hustclf,25,0.00058,3843597,89.15707,4311040
5759,igorvpcleao,25,0.00058,3843622,89.15765,4311040
5760,ijumps,25,0.00058,3843647,89.15823,4311040
5761,ikarldasan,25,0.00058,3843672,89.15881,4311040
5762,Jaakko-Os,25,0.00058,3843697,89.15939,4311040
5763,jacobtomlinson,25,0.00058,3843722,89.15997,4311040
5764,jadolg,25,0.00058,3843747,89.16055,4311040
5765,jakexks,25,0.00058,3843772,89.16113,4311040
5766,jar349,25,0.00058,3843797,89.16171,4311040
5767,jkachmar,25,0.00058,3843822,89.16229,4311040
5768,jmprusi,25,0.00058,3843847,89.16287,4311040
5769,jonmoter,25,0.00058,3843872,89.16345,4311040
5770,JTarasovic,25,0.00058,3843897,89.16403,4311040
5771,justgotthis,25,0.00058,3843922,89.16461,4311040
5772,Kaizhe,25,0.00058,3843947,89.16519,4311040
5773,kararade,25,0.00058,3843972,89.16577,4311040
5774,KimMJ,25,0.00058,3843997,89.16635,4311040
5775,klarose,25,0.00058,3844022,89.16693,4311040
5776,KoditkarVedant,25,0.00058,3844047,89.16751,4311040
5777,kubealex,25,0.00058,3844072,89.16809,4311040
5778,leeivan,25,0.00058,3844097,89.16867,4311040
5779,leodotcloud,25,0.00058,3844122,89.16925,4311040
5780,lfdominguez,25,0.00058,3844147,89.16983,4311040
5781,magaldima,25,0.00058,3844172,89.17041,4311040
5782,manolitto,25,0.00058,3844197,89.17099,4311040
5783,MartinKanters,25,0.00058,3844222,89.17157,4311040
5784,matthewrudy,25,0.00058,3844247,89.17215,4311040
5785,mattouille,25,0.00058,3844272,89.17273,4311040
5786,mdaniel,25,0.00058,3844297,89.17331,4311040
5787,metalmatze,25,0.00058,3844322,89.17389,4311040
5788,mfischer-zd,25,0.00058,3844347,89.17447,4311040
5789,michelzanini,25,0.00058,3844372,89.17505,4311040
5790,micmro,25,0.00058,3844397,89.17563,4311040
5791,mike-stewart,25,0.00058,3844422,89.17621,4311040
5792,mohatb,25,0.00058,3844447,89.17679,4311040
5793,Monnoroch,25,0.00058,3844472,89.17737,4311040
5794,Moshem123,25,0.00058,3844497,89.17795,4311040
5795,mrmm,25,0.00058,3844522,89.17853,4311040
5796,nagiesek,25,0.00058,3844547,89.17911,4311040
5797,nhorman,25,0.00058,3844572,89.17969,4311040
5798,Noah-Huppert,25,0.00058,3844597,89.18027,4311040
5799,nrvnrvn,25,0.00058,3844622,89.18085,4311040
5800,offlinehacker,25,0.00058,3844647,89.18143,4311040
5801,omeid,25,0.00058,3844672,89.18201,4311040
5802,oshoval,25,0.00058,3844697,89.18259,4311040
5803,OwenTuz,25,0.00058,3844722,89.18317,4311040
5804,pgburt,25,0.00058,3844747,89.18375,4311040
5805,phagunbaya,25,0.00058,3844772,89.18433,4311040
5806,piyush1594,25,0.00058,3844797,89.18491,4311040
5807,pulpbill,25,0.00058,3844822,89.18549,4311040
5808,pupapaik,25,0.00058,3844847,89.18607,4311040
5809,raeesbhatti,25,0.00058,3844872,89.18665,4311040
5810,rajiteh,25,0.00058,3844897,89.18723,4311040
5811,reneluria,25,0.00058,3844922,89.18781,4311040
5812,rgo,25,0.00058,3844947,89.18839,4311040
5813,RickyRajinder,25,0.00058,3844972,89.18897,4311040
5814,rjmorse,25,0.00058,3844997,89.18955,4311040
5815,roidelapluie,25,0.00058,3845022,89.19013,4311040
5816,rrichardson,25,0.00058,3845047,89.19071,4311040
5817,sajattack,25,0.00058,3845072,89.19129,4311040
5818,sarat-k,25,0.00058,3845097,89.19187,4311040
5819,shanesiebken,25,0.00058,3845122,89.19245,4311040
5820,sh-miyoshi,25,0.00058,3845147,89.19303,4311040
5821,shsjshentao,25,0.00058,3845172,89.19361,4311040
5822,sjezewski,25,0.00058,3845197,89.19419,4311040
5823,skolekonov,25,0.00058,3845222,89.19477,4311040
5824,smugcloud,25,0.00058,3845247,89.19534,4311040
5825,sNathan13,25,0.00058,3845272,89.19592,4311040
5826,sneko,25,0.00058,3845297,89.19650,4311040
5827,solsson,25,0.00058,3845322,89.19708,4311040
5828,songleo,25,0.00058,3845347,89.19766,4311040
5829,SpicySyntax,25,0.00058,3845372,89.19824,4311040
5830,sputnick,25,0.00058,3845397,89.19882,4311040
5831,stevenpall,25,0.00058,3845422,89.19940,4311040
5832,sumitranr,25,0.00058,3845447,89.19998,4311040
5833,szombi,25,0.00058,3845472,89.20056,4311040
5834,Tedezed,25,0.00058,3845497,89.20114,4311040
5835,thomaschaaf,25,0.00058,3845522,89.20172,4311040
5836,timothyjosefik,25,0.00058,3845547,89.20230,4311040
5837,tjanson,25,0.00058,3845572,89.20288,4311040
5838,t-lo,25,0.00058,3845597,89.20346,4311040
5839,toolboc,25,0.00058,3845622,89.20404,4311040
5840,Toplife,25,0.00058,3845647,89.20462,4311040
5841,trunet,25,0.00058,3845672,89.20520,4311040
5842,tyrken,25,0.00058,3845697,89.20578,4311040
5843,uhthomas,25,0.00058,3845722,89.20636,4311040
5844,ulm0,25,0.00058,3845747,89.20694,4311040
5845,unicell,25,0.00058,3845772,89.20752,4311040
5846,utkarshmani1997,25,0.00058,3845797,89.20810,4311040
5847,vibhansa-msft,25,0.00058,3845822,89.20868,4311040
5848,vietwow,25,0.00058,3845847,89.20926,4311040
5849,walterdolce,25,0.00058,3845872,89.20984,4311040
5850,wenyingd,25,0.00058,3845897,89.21042,4311040
5851,woosley,25,0.00058,3845922,89.21100,4311040
5852,xiaoyang-sde,25,0.00058,3845947,89.21158,4311040
5853,yashodhanmohan,25,0.00058,3845972,89.21216,4311040
5854,yasongxu,25,0.00058,3845997,89.21274,4311040
5855,ZouRui89,25,0.00058,3846022,89.21332,4311040
5856,aduffeck,24,0.00056,3846046,89.21388,4311040
5857,ahuffman,24,0.00056,3846070,89.21444,4311040
5858,aleveille,24,0.00056,3846094,89.21499,4311040
5859,alexandrsemak,24,0.00056,3846118,89.21555,4311040
5860,amouat,24,0.00056,3846142,89.21611,4311040
5861,AndrewDryga,24,0.00056,3846166,89.21666,4311040
5862,animeshsingh,24,0.00056,3846190,89.21722,4311040
5863,anwaradil,24,0.00056,3846214,89.21778,4311040
5864,arianitu,24,0.00056,3846238,89.21833,4311040
5865,arm64b,24,0.00056,3846262,89.21889,4311040
5866,artem-panchenko,24,0.00056,3846286,89.21945,4311040
5867,astrived,24,0.00056,3846310,89.22000,4311040
5868,avlasov-mos-de,24,0.00056,3846334,89.22056,4311040
5869,axsaucedo,24,0.00056,3846358,89.22112,4311040
5870,BadLiveware,24,0.00056,3846382,89.22167,4311040
5871,bamarni,24,0.00056,3846406,89.22223,4311040
5872,berendt,24,0.00056,3846430,89.22279,4311040
5873,bitoku,24,0.00056,3846454,89.22334,4311040
5874,bitsofinfo,24,0.00056,3846478,89.22390,4311040
5875,bizhao,24,0.00056,3846502,89.22446,4311040
5876,BrendanSChang,24,0.00056,3846526,89.22501,4311040
5877,buehler,24,0.00056,3846550,89.22557,4311040
5878,bulletRush,24,0.00056,3846574,89.22613,4311040
5879,bureado,24,0.00056,3846598,89.22668,4311040
5880,burningalchemist,24,0.00056,3846622,89.22724,4311040
5881,caboteria,24,0.00056,3846646,89.22780,4311040
5882,christarazi,24,0.00056,3846670,89.22835,4311040
5883,cosmo0920,24,0.00056,3846694,89.22891,4311040
5884,danielrodriguez,24,0.00056,3846718,89.22947,4311040
5885,davecheney,24,0.00056,3846742,89.23002,4311040
5886,debianmaster,24,0.00056,3846766,89.23058,4311040
5887,deimosfr,24,0.00056,3846790,89.23114,4311040
5888,derek-pryor,24,0.00056,3846814,89.23169,4311040
5889,deryrahman,24,0.00056,3846838,89.23225,4311040
5890,d-honeybadger,24,0.00056,3846862,89.23281,4311040
5891,dieterdemeyer,24,0.00056,3846886,89.23336,4311040
5892,dnascimento,24,0.00056,3846910,89.23392,4311040
5893,dsebastien,24,0.00056,3846934,89.23448,4311040
5894,dungdm93,24,0.00056,3846958,89.23503,4311040
5895,eagleusb,24,0.00056,3846982,89.23559,4311040
5896,edrandall,24,0.00056,3847006,89.23615,4311040
5897,eduardobaitello,24,0.00056,3847030,89.23670,4311040
5898,epc,24,0.00056,3847054,89.23726,4311040
5899,FalconerTC,24,0.00056,3847078,89.23782,4311040
5900,fgksgf,24,0.00056,3847102,89.23837,4311040
5901,fitzthum,24,0.00056,3847126,89.23893,4311040
5902,gabibbo97,24,0.00056,3847150,89.23949,4311040
5903,GeorgeGuo2018,24,0.00056,3847174,89.24004,4311040
5904,gimlichael,24,0.00056,3847198,89.24060,4311040
5905,gsaslis,24,0.00056,3847222,89.24116,4311040
5906,guibirow,24,0.00056,3847246,89.24171,4311040
5907,HariSekhon,24,0.00056,3847270,89.24227,4311040
5908,hutchic,24,0.00056,3847294,89.24283,4311040
5909,ihac,24,0.00056,3847318,89.24338,4311040
5910,itsallonetome,24,0.00056,3847342,89.24394,4311040
5911,javajon,24,0.00056,3847366,89.24450,4311040
5912,jboeuf,24,0.00056,3847390,89.24505,4311040
5913,jescarri,24,0.00056,3847414,89.24561,4311040
5914,jesseshieh,24,0.00056,3847438,89.24617,4311040
5915,jheiss,24,0.00056,3847462,89.24672,4311040
5916,jiangytcn,24,0.00056,3847486,89.24728,4311040
5917,joemiller,24,0.00056,3847510,89.24784,4311040
5918,johanfleury,24,0.00056,3847534,89.24839,4311040
5919,johnzeringue,24,0.00056,3847558,89.24895,4311040
5920,kedark3,24,0.00056,3847582,89.24951,4311040
5921,KesavanKing,24,0.00056,3847606,89.25006,4311040
5922,kilianc,24,0.00056,3847630,89.25062,4311040
5923,kim0,24,0.00056,3847654,89.25118,4311040
5924,kschaab,24,0.00056,3847678,89.25174,4311040
5925,kulong0105,24,0.00056,3847702,89.25229,4311040
5926,learnitall,24,0.00056,3847726,89.25285,4311040
5927,lightcode,24,0.00056,3847750,89.25341,4311040
5928,lihan,24,0.00056,3847774,89.25396,4311040
5929,lparis,24,0.00056,3847798,89.25452,4311040
5930,markfermor,24,0.00056,3847822,89.25508,4311040
5931,mattbates,24,0.00056,3847846,89.25563,4311040
5932,mbuccarello,24,0.00056,3847870,89.25619,4311040
5933,mcntrn,24,0.00056,3847894,89.25675,4311040
5934,mogaika,24,0.00056,3847918,89.25730,4311040
5935,mr-karan,24,0.00056,3847942,89.25786,4311040
5936,mstump,24,0.00056,3847966,89.25842,4311040
5937,mtl-wgtwo,24,0.00056,3847990,89.25897,4311040
5938,mulloymorrow,24,0.00056,3848014,89.25953,4311040
5939,Nawaz027,24,0.00056,3848038,89.26009,4311040
5940,nazarewk,24,0.00056,3848062,89.26064,4311040
5941,nberlee,24,0.00056,3848086,89.26120,4311040
5942,nerzhul,24,0.00056,3848110,89.26176,4311040
5943,networkop,24,0.00056,3848134,89.26231,4311040
5944,nevetS,24,0.00056,3848158,89.26287,4311040
5945,Nikhil2001,24,0.00056,3848182,89.26343,4311040
5946,nkuba,24,0.00056,3848206,89.26398,4311040
5947,noony,24,0.00056,3848230,89.26454,4311040
5948,notjames,24,0.00056,3848254,89.26510,4311040
5949,nswarnkar,24,0.00056,3848278,89.26565,4311040
5950,nVitius,24,0.00056,3848302,89.26621,4311040
5951,panjf2000,24,0.00056,3848326,89.26677,4311040
5952,Patrick0308,24,0.00056,3848350,89.26732,4311040
5953,pegerto,24,0.00056,3848374,89.26788,4311040
5954,philnichol,24,0.00056,3848398,89.26844,4311040
5955,plombardi89,24,0.00056,3848422,89.26899,4311040
5956,posita,24,0.00056,3848446,89.26955,4311040
5957,pradeepto,24,0.00056,3848470,89.27011,4311040
5958,pradipd,24,0.00056,3848494,89.27066,4311040
5959,prary,24,0.00056,3848518,89.27122,4311040
5960,Rabattkarte,24,0.00056,3848542,89.27178,4311040
5961,rafaelmagu,24,0.00056,3848566,89.27233,4311040
5962,rajdas98,24,0.00056,3848590,89.27289,4311040
5963,relaxdiego,24,0.00056,3848614,89.27345,4311040
5964,rewanthtammana,24,0.00056,3848638,89.27400,4311040
5965,rjhenry,24,0.00056,3848662,89.27456,4311040
5966,Rudd-O,24,0.00056,3848686,89.27512,4311040
5967,ruzickap,24,0.00056,3848710,89.27567,4311040
5968,sakaia,24,0.00056,3848734,89.27623,4311040
5969,scriptonist,24,0.00056,3848758,89.27679,4311040
5970,SgtCoDFish,24,0.00056,3848782,89.27734,4311040
5971,shaggyyy2002,24,0.00056,3848806,89.27790,4311040
5972,shawnho1018,24,0.00056,3848830,89.27846,4311040
5973,shlao,24,0.00056,3848854,89.27901,4311040
5974,shundezhang,24,0.00056,3848878,89.27957,4311040
5975,sopak,24,0.00056,3848902,89.28013,4311040
5976,stavalfi,24,0.00056,3848926,89.28068,4311040
5977,stephanlindauer,24,0.00056,3848950,89.28124,4311040
5978,survivant,24,0.00056,3848974,89.28180,4311040
5979,tapih,24,0.00056,3848998,89.28235,4311040
5980,tddorgtfo,24,0.00056,3849022,89.28291,4311040
5981,the-redback,24,0.00056,3849046,89.28347,4311040
5982,timmyers,24,0.00056,3849070,89.28402,4311040
5983,tolleiv,24,0.00056,3849094,89.28458,4311040
5984,tpoindessous,24,0.00056,3849118,89.28514,4311040
5985,travisnewhouse,24,0.00056,3849142,89.28569,4311040
5986,victor-timofei,24,0.00056,3849166,89.28625,4311040
5987,villesau,24,0.00056,3849190,89.28681,4311040
5988,vishaltak,24,0.00056,3849214,89.28736,4311040
5989,vishu2498,24,0.00056,3849238,89.28792,4311040
5990,volume-ji,24,0.00056,3849262,89.28848,4311040
5991,wallnerryan,24,0.00056,3849286,89.28903,4311040
5992,wangzhuzhen,24,0.00056,3849310,89.28959,4311040
5993,wbh1,24,0.00056,3849334,89.29015,4311040
5994,weitzj,24,0.00056,3849358,89.29070,4311040
5995,WilliamChang80,24,0.00056,3849382,89.29126,4311040
5996,woodbor,24,0.00056,3849406,89.29182,4311040
5997,wreed4,24,0.00056,3849430,89.29237,4311040
5998,Xcalizorz,24,0.00056,3849454,89.29293,4311040
5999,xiaolou86,24,0.00056,3849478,89.29349,4311040
6000,xiaonancc77,24,0.00056,3849502,89.29405,4311040
6001,xieydd,24,0.00056,3849526,89.29460,4311040
6002,XiShanYongYe-Chang,24,0.00056,3849550,89.29516,4311040
6003,yahaa,24,0.00056,3849574,89.29572,4311040
6004,yiweng-amz,24,0.00056,3849598,89.29627,4311040
6005,yttan,24,0.00056,3849622,89.29683,4311040
6006,yu-song,24,0.00056,3849646,89.29739,4311040
6007,ZihanJiang96,24,0.00056,3849670,89.29794,4311040
6008,ztewyk,24,0.00056,3849694,89.29850,4311040
6009,0x4c6565,23,0.00053,3849717,89.29903,4311040
6010,abhi1604,23,0.00053,3849740,89.29957,4311040
6011,abhijeet-26,23,0.00053,3849763,89.30010,4311040
6012,abuisine,23,0.00053,3849786,89.30063,4311040
6013,adityamandhare,23,0.00053,3849809,89.30117,4311040
6014,adrian-gierakowski,23,0.00053,3849832,89.30170,4311040
6015,akx,23,0.00053,3849855,89.30223,4311040
6016,andrewmclagan,23,0.00053,3849878,89.30277,4311040
6017,anooptp,23,0.00053,3849901,89.30330,4311040
6018,anurag,23,0.00053,3849924,89.30383,4311040
6019,artberger,23,0.00053,3849947,89.30437,4311040
6020,Arttii,23,0.00053,3849970,89.30490,4311040
6021,ashleykasim,23,0.00053,3849993,89.30543,4311040
6022,asychev,23,0.00053,3850016,89.30597,4311040
6023,aweiteka,23,0.00053,3850039,89.30650,4311040
6024,balonik,23,0.00053,3850062,89.30703,4311040
6025,bear-redhat,23,0.00053,3850085,89.30757,4311040
6026,bendrucker,23,0.00053,3850108,89.30810,4311040
6027,bennettellis,23,0.00053,3850131,89.30864,4311040
6028,bezalel-7,23,0.00053,3850154,89.30917,4311040
6029,bharathkkb,23,0.00053,3850177,89.30970,4311040
6030,boylee1111,23,0.00053,3850200,89.31024,4311040
6031,burdiyan,23,0.00053,3850223,89.31077,4311040
6032,carflo,23,0.00053,3850246,89.31130,4311040
6033,caseylucas,23,0.00053,3850269,89.31184,4311040
6034,ccleouf66,23,0.00053,3850292,89.31237,4311040
6035,cdvultur,23,0.00053,3850315,89.31290,4311040
6036,chunnallu,23,0.00053,3850338,89.31344,4311040
6037,cjreyn,23,0.00053,3850361,89.31397,4311040
6038,cleverhu,23,0.00053,3850384,89.31450,4311040
6039,cmastr,23,0.00053,3850407,89.31504,4311040
6040,CoderAway28th,23,0.00053,3850430,89.31557,4311040
6041,colinhoglund,23,0.00053,3850453,89.31610,4311040
6042,cpaika,23,0.00053,3850476,89.31664,4311040
6043,cypherfox,23,0.00053,3850499,89.31717,4311040
6044,davidreynolds,23,0.00053,3850522,89.31771,4311040
6045,dbdd4us,23,0.00053,3850545,89.31824,4311040
6046,dewan-ahmed,23,0.00053,3850568,89.31877,4311040
6047,djschny,23,0.00053,3850591,89.31931,4311040
6048,dmitriy-lukyanchikov,23,0.00053,3850614,89.31984,4311040
6049,dnoland1,23,0.00053,3850637,89.32037,4311040
6050,drewcsillag,23,0.00053,3850660,89.32091,4311040
6051,dsonck92,23,0.00053,3850683,89.32144,4311040
6052,dstynchula,23,0.00053,3850706,89.32197,4311040
6053,duduedri96,23,0.00053,3850729,89.32251,4311040
6054,ejc3,23,0.00053,3850752,89.32304,4311040
6055,ErikEngerd,23,0.00053,3850775,89.32357,4311040
6056,evrardjp,23,0.00053,3850798,89.32411,4311040
6057,feitnomore,23,0.00053,3850821,89.32464,4311040
6058,fengye87,23,0.00053,3850844,89.32517,4311040
6059,fjogeleit,23,0.00053,3850867,89.32571,4311040
6060,fvoznika,23,0.00053,3850890,89.32624,4311040
6061,gabrieljackson,23,0.00053,3850913,89.32677,4311040
6062,ganga1980,23,0.00053,3850936,89.32731,4311040
6063,geoah,23,0.00053,3850959,89.32784,4311040
6064,georgecrawford,23,0.00053,3850982,89.32838,4311040
6065,gitirabassi,23,0.00053,3851005,89.32891,4311040
6066,gkao123,23,0.00053,3851028,89.32944,4311040
6067,gsadhani,23,0.00053,3851051,89.32998,4311040
6068,guillaumebreton,23,0.00053,3851074,89.33051,4311040
6069,hadrien-toma,23,0.00053,3851097,89.33104,4311040
6070,harmjanblok,23,0.00053,3851120,89.33158,4311040
6071,Hashfyre,23,0.00053,3851143,89.33211,4311040
6072,hassenius,23,0.00053,3851166,89.33264,4311040
6073,hazcod,23,0.00053,3851189,89.33318,4311040
6074,hedayat,23,0.00053,3851212,89.33371,4311040
6075,hmtai,23,0.00053,3851235,89.33424,4311040
6076,ioandr,23,0.00053,3851258,89.33478,4311040
6077,jakub-d,23,0.00053,3851281,89.33531,4311040
6078,jia-jerry,23,0.00053,3851304,89.33584,4311040
6079,jingweno,23,0.00053,3851327,89.33638,4311040
6080,JinsYin,23,0.00053,3851350,89.33691,4311040
6081,jklare,23,0.00053,3851373,89.33745,4311040
6082,jmastr,23,0.00053,3851396,89.33798,4311040
6083,jmn,23,0.00053,3851419,89.33851,4311040
6084,JounQin,23,0.00053,3851442,89.33905,4311040
6085,jpb,23,0.00053,3851465,89.33958,4311040
6086,jutley,23,0.00053,3851488,89.34011,4311040
6087,kaoet,23,0.00053,3851511,89.34065,4311040
6088,klaus993,23,0.00053,3851534,89.34118,4311040
6089,kmlebedev,23,0.00053,3851557,89.34171,4311040
6090,koooge,23,0.00053,3851580,89.34225,4311040
6091,lf1029698952,23,0.00053,3851603,89.34278,4311040
6092,madis,23,0.00053,3851626,89.34331,4311040
6093,martin-helmich,23,0.00053,3851649,89.34385,4311040
6094,mateiidavid,23,0.00053,3851672,89.34438,4311040
6095,mattmelgard,23,0.00053,3851695,89.34491,4311040
6096,maxamillion,23,0.00053,3851718,89.34545,4311040
6097,mbevc1,23,0.00053,3851741,89.34598,4311040
6098,mblaschke,23,0.00053,3851764,89.34651,4311040
6099,mclarke47,23,0.00053,3851787,89.34705,4311040
6100,mfburnett,23,0.00053,3851810,89.34758,4311040
6101,Michael-Baylis,23,0.00053,3851833,89.34812,4311040
6102,michallowicki,23,0.00053,3851856,89.34865,4311040
6103,micheelengronne,23,0.00053,3851879,89.34918,4311040
6104,mihok,23,0.00053,3851902,89.34972,4311040
6105,mikutas,23,0.00053,3851925,89.35025,4311040
6106,mkoderer,23,0.00053,3851948,89.35078,4311040
6107,mmaquevice,23,0.00053,3851971,89.35132,4311040
6108,morganchristiansson,23,0.00053,3851994,89.35185,4311040
6109,msnelling,23,0.00053,3852017,89.35238,4311040
6110,mtanski,23,0.00053,3852040,89.35292,4311040
6111,mvazquezc,23,0.00053,3852063,89.35345,4311040
6112,Nalum,23,0.00053,3852086,89.35398,4311040
6113,nerdondon,23,0.00053,3852109,89.35452,4311040
6114,nf,23,0.00053,3852132,89.35505,4311040
6115,NikPaushkin,23,0.00053,3852155,89.35558,4311040
6116,nique905,23,0.00053,3852178,89.35612,4311040
6117,obaranov1,23,0.00053,3852201,89.35665,4311040
6118,omninonsense,23,0.00053,3852224,89.35719,4311040
6119,padlar,23,0.00053,3852247,89.35772,4311040
6120,philomory,23,0.00053,3852270,89.35825,4311040
6121,pohsienshih,23,0.00053,3852293,89.35879,4311040
6122,prabhakar-pal,23,0.00053,3852316,89.35932,4311040
6123,prateekarora151083,23,0.00053,3852339,89.35985,4311040
6124,prithviramesh,23,0.00053,3852362,89.36039,4311040
6125,prochnowc,23,0.00053,3852385,89.36092,4311040
6126,programmer04,23,0.00053,3852408,89.36145,4311040
6127,protosam,23,0.00053,3852431,89.36199,4311040
6128,qrpike,23,0.00053,3852454,89.36252,4311040
6129,qu1queee,23,0.00053,3852477,89.36305,4311040
6130,raghavendra-talur,23,0.00053,3852500,89.36359,4311040
6131,razashahid107,23,0.00053,3852523,89.36412,4311040
6132,rdrgporto,23,0.00053,3852546,89.36465,4311040
6133,rdubya16,23,0.00053,3852569,89.36519,4311040
6134,rehevkor5,23,0.00053,3852592,89.36572,4311040
6135,RomanKisilenko,23,0.00053,3852615,89.36626,4311040
6136,saintmalik,23,0.00053,3852638,89.36679,4311040
6137,salrashid123,23,0.00053,3852661,89.36732,4311040
6138,scott-chaney,23,0.00053,3852684,89.36786,4311040
6139,scottstout,23,0.00053,3852707,89.36839,4311040
6140,semoac,23,0.00053,3852730,89.36892,4311040
6141,serhatcetinkaya,23,0.00053,3852753,89.36946,4311040
6142,shawnps,23,0.00053,3852776,89.36999,4311040
6143,simingweng,23,0.00053,3852799,89.37052,4311040
6144,simon-geard,23,0.00053,3852822,89.37106,4311040
6145,simonostendorf,23,0.00053,3852845,89.37159,4311040
6146,skurtzemann,23,0.00053,3852868,89.37212,4311040
6147,smartaquarius10,23,0.00053,3852891,89.37266,4311040
6148,Somefive,23,0.00053,3852914,89.37319,4311040
6149,sraillard,23,0.00053,3852937,89.37372,4311040
6150,stefanodoni,23,0.00053,3852960,89.37426,4311040
6151,Tabrizian,23,0.00053,3852983,89.37479,4311040
6152,tback,23,0.00053,3853006,89.37532,4311040
6153,TekTimmy,23,0.00053,3853029,89.37586,4311040
6154,terrytangyuan,23,0.00053,3853052,89.37639,4311040
6155,thatsk,23,0.00053,3853075,89.37693,4311040
6156,thejasbabu,23,0.00053,3853098,89.37746,4311040
6157,ThomasK33,23,0.00053,3853121,89.37799,4311040
6158,tiukhtinvladimir,23,0.00053,3853144,89.37853,4311040
6159,tmc,23,0.00053,3853167,89.37906,4311040
6160,tsahiduek,23,0.00053,3853190,89.37959,4311040
6161,uberj,23,0.00053,3853213,89.38013,4311040
6162,uditgaurav,23,0.00053,3853236,89.38066,4311040
6163,veshij,23,0.00053,3853259,89.38119,4311040
6164,xpepermint,23,0.00053,3853282,89.38173,4311040
6165,yann-soubeyrand,23,0.00053,3853305,89.38226,4311040
6166,yaronr,23,0.00053,3853328,89.38279,4311040
6167,ytakaya,23,0.00053,3853351,89.38333,4311040
6168,zoncoen,23,0.00053,3853374,89.38386,4311040
6169,99BenGardner,22,0.00051,3853396,89.38437,4311040
6170,activars,22,0.00051,3853418,89.38488,4311040
6171,alexpekurovsky,22,0.00051,3853440,89.38539,4311040
6172,amej,22,0.00051,3853462,89.38590,4311040
6173,Amit-PivotalLabs,22,0.00051,3853484,89.38641,4311040
6174,AnaCarolinaRodriguesLeite,22,0.00051,3853506,89.38692,4311040
6175,andyp1per,22,0.00051,3853528,89.38743,4311040
6176,annp1987,22,0.00051,3853550,89.38794,4311040
6177,anoopcs9,22,0.00051,3853572,89.38845,4311040
6178,apsinha,22,0.00051,3853594,89.38896,4311040
6179,arsheelsheikh,22,0.00051,3853616,89.38947,4311040
6180,baikai,22,0.00051,3853638,89.38998,4311040
6181,bradjones1,22,0.00051,3853660,89.39050,4311040
6182,brandong954,22,0.00051,3853682,89.39101,4311040
6183,bthurber,22,0.00051,3853704,89.39152,4311040
6184,bwplotka,22,0.00051,3853726,89.39203,4311040
6185,c4po,22,0.00051,3853748,89.39254,4311040
6186,calixwu,22,0.00051,3853770,89.39305,4311040
6187,cameronattard,22,0.00051,3853792,89.39356,4311040
6188,cfryanr,22,0.00051,3853814,89.39407,4311040
6189,chenyangxueHDU,22,0.00051,3853836,89.39458,4311040
6190,chrisghill,22,0.00051,3853858,89.39509,4311040
6191,chulkilee,22,0.00051,3853880,89.39560,4311040
6192,cnvergence,22,0.00051,3853902,89.39611,4311040
6193,coresolve,22,0.00051,3853924,89.39662,4311040
6194,craigwillis85,22,0.00051,3853946,89.39713,4311040
6195,crawford,22,0.00051,3853968,89.39764,4311040
6196,danpopSD,22,0.00051,3853990,89.39815,4311040
6197,darron,22,0.00051,3854012,89.39866,4311040
6198,Datamance,22,0.00051,3854034,89.39917,4311040
6199,dbolkensteyn,22,0.00051,3854056,89.39968,4311040
6200,deedubs,22,0.00051,3854078,89.40019,4311040
6201,dettervt,22,0.00051,3854100,89.40070,4311040
6202,dgoldssfo,22,0.00051,3854122,89.40121,4311040
6203,dhanvi,22,0.00051,3854144,89.40172,4311040
6204,diwu1989,22,0.00051,3854166,89.40223,4311040
6205,donmccasland,22,0.00051,3854188,89.40274,4311040
6206,droccom,22,0.00051,3854210,89.40325,4311040
6207,dservgun,22,0.00051,3854232,89.40376,4311040
6208,dsymonds,22,0.00051,3854254,89.40427,4311040
6209,ecojuntak,22,0.00051,3854276,89.40478,4311040
6210,edsonmarquezani,22,0.00051,3854298,89.40529,4311040
6211,elblivion,22,0.00051,3854320,89.40580,4311040
6212,erikstmartin,22,0.00051,3854342,89.40631,4311040
6213,eytankidron,22,0.00051,3854364,89.40683,4311040
6214,FaKod,22,0.00051,3854386,89.40734,4311040
6215,ffilippopoulos,22,0.00051,3854408,89.40785,4311040
6216,fllaca,22,0.00051,3854430,89.40836,4311040
6217,Fodoj,22,0.00051,3854452,89.40887,4311040
6218,frelon,22,0.00051,3854474,89.40938,4311040
6219,fuergaosi233,22,0.00051,3854496,89.40989,4311040
6220,fyangd,22,0.00051,3854518,89.41040,4311040
6221,GauntletWizard,22,0.00051,3854540,89.41091,4311040
6222,ggm-at-apnic,22,0.00051,3854562,89.41142,4311040
6223,glikson,22,0.00051,3854584,89.41193,4311040
6224,hakanmemisoglu,22,0.00051,3854606,89.41244,4311040
6225,hjkatz,22,0.00051,3854628,89.41295,4311040
6226,hsaputra,22,0.00051,3854650,89.41346,4311040
6227,huxcrux,22,0.00051,3854672,89.41397,4311040
6228,imikushin,22,0.00051,3854694,89.41448,4311040
6229,IvanBiv,22,0.00051,3854716,89.41499,4311040
6230,james-masson,22,0.00051,3854738,89.41550,4311040
6231,jbilliau-rcd,22,0.00051,3854760,89.41601,4311040
6232,jbowes,22,0.00051,3854782,89.41652,4311040
6233,jcsirot,22,0.00051,3854804,89.41703,4311040
6234,Jean-Daniel,22,0.00051,3854826,89.41754,4311040
6235,jeffwubj,22,0.00051,3854848,89.41805,4311040
6236,jelmersnoeck,22,0.00051,3854870,89.41856,4311040
6237,jeruane,22,0.00051,3854892,89.41907,4311040
6238,jfernancordova,22,0.00051,3854914,89.41958,4311040
6239,jgoclawski,22,0.00051,3854936,89.42009,4311040
6240,jiria,22,0.00051,3854958,89.42060,4311040
6241,joostas,22,0.00051,3854980,89.42111,4311040
6242,josephholsten,22,0.00051,3855002,89.42162,4311040
6243,joshphp,22,0.00051,3855024,89.42213,4311040
6244,jpreese,22,0.00051,3855046,89.42265,4311040
6245,jsanda,22,0.00051,3855068,89.42316,4311040
6246,justincormack,22,0.00051,3855090,89.42367,4311040
6247,karmab,22,0.00051,3855112,89.42418,4311040
6248,kartoch,22,0.00051,3855134,89.42469,4311040
6249,kehao95,22,0.00051,3855156,89.42520,4311040
6250,ketkulka,22,0.00051,3855178,89.42571,4311040
6251,kfaseela,22,0.00051,3855200,89.42622,4311040
6252,KilimAnnejaro,22,0.00051,3855222,89.42673,4311040
6253,kireledan,22,0.00051,3855244,89.42724,4311040
6254,knarayan,22,0.00051,3855266,89.42775,4311040
6255,knrt10,22,0.00051,3855288,89.42826,4311040
6256,krobertson,22,0.00051,3855310,89.42877,4311040
6257,kskewes,22,0.00051,3855332,89.42928,4311040
6258,kuba--,22,0.00051,3855354,89.42979,4311040
6259,leifcr,22,0.00051,3855376,89.43030,4311040
6260,ligc,22,0.00051,3855398,89.43081,4311040
6261,lining2020x,22,0.00051,3855420,89.43132,4311040
6262,llibicpep,22,0.00051,3855442,89.43183,4311040
6263,loffing,22,0.00051,3855464,89.43234,4311040
6264,Loki-Afro,22,0.00051,3855486,89.43285,4311040
6265,lvicentesanchez,22,0.00051,3855508,89.43336,4311040
6266,lvnilesh,22,0.00051,3855530,89.43387,4311040
6267,lwr20,22,0.00051,3855552,89.43438,4311040
6268,MachineEmpathist,22,0.00051,3855574,89.43489,4311040
6269,madhurranjan,22,0.00051,3855596,89.43540,4311040
6270,marcportabellaclotet-mt,22,0.00051,3855618,89.43591,4311040
6271,MattJeanes,22,0.00051,3855640,89.43642,4311040
6272,mattwelke,22,0.00051,3855662,89.43693,4311040
6273,maver1ck,22,0.00051,3855684,89.43744,4311040
6274,maximumG,22,0.00051,3855706,89.43795,4311040
6275,maxisam,22,0.00051,3855728,89.43846,4311040
6276,maxpain,22,0.00051,3855750,89.43898,4311040
6277,maxwell92,22,0.00051,3855772,89.43949,4311040
6278,mcastellin,22,0.00051,3855794,89.44000,4311040
6279,mcortinas,22,0.00051,3855816,89.44051,4311040
6280,mdgreenwald,22,0.00051,3855838,89.44102,4311040
6281,mechpen,22,0.00051,3855860,89.44153,4311040
6282,mengfanjiebay,22,0.00051,3855882,89.44204,4311040
6283,meyskens,22,0.00051,3855904,89.44255,4311040
6284,mprahl,22,0.00051,3855926,89.44306,4311040
6285,mrc-rius,22,0.00051,3855948,89.44357,4311040
6286,MrD2,22,0.00051,3855970,89.44408,4311040
6287,nabheet,22,0.00051,3855992,89.44459,4311040
6288,neoakris,22,0.00051,3856014,89.44510,4311040
6289,nerusnayleinad,22,0.00051,3856036,89.44561,4311040
6290,nickgerace,22,0.00051,3856058,89.44612,4311040
6291,nmvega,22,0.00051,3856080,89.44663,4311040
6292,pallabi-sutradhar,22,0.00051,3856102,89.44714,4311040
6293,paologallinaharbur,22,0.00051,3856124,89.44765,4311040
6294,paurullan,22,0.00051,3856146,89.44816,4311040
6295,pgier,22,0.00051,3856168,89.44867,4311040
6296,pjsawicki,22,0.00051,3856190,89.44918,4311040
6297,posox,22,0.00051,3856212,89.44969,4311040
6298,prachetasp,22,0.00051,3856234,89.45020,4311040
6299,praparn,22,0.00051,3856256,89.45071,4311040
6300,RafalKorepta,22,0.00051,3856278,89.45122,4311040
6301,rapenchukd,22,0.00051,3856300,89.45173,4311040
6302,renich,22,0.00051,3856322,89.45224,4311040
6303,richarddli,22,0.00051,3856344,89.45275,4311040
6304,richardsliu,22,0.00051,3856366,89.45326,4311040
6305,rochdev,22,0.00051,3856388,89.45377,4311040
6306,RPing,22,0.00051,3856410,89.45428,4311040
6307,sachinparihar,22,0.00051,3856432,89.45480,4311040
6308,salilgupta1,22,0.00051,3856454,89.45531,4311040
6309,sarandia,22,0.00051,3856476,89.45582,4311040
6310,schu,22,0.00051,3856498,89.45633,4311040
6311,sdkfzv,22,0.00051,3856520,89.45684,4311040
6312,sdputurn,22,0.00051,3856542,89.45735,4311040
6313,sectorsize512,22,0.00051,3856564,89.45786,4311040
6314,shikanon,22,0.00051,3856586,89.45837,4311040
6315,simonpasquier,22,0.00051,3856608,89.45888,4311040
6316,simrangupta234,22,0.00051,3856630,89.45939,4311040
6317,sjevs,22,0.00051,3856652,89.45990,4311040
6318,snorwin,22,0.00051,3856674,89.46041,4311040
6319,spawnia,22,0.00051,3856696,89.46092,4311040
6320,suneeta-mall,22,0.00051,3856718,89.46143,4311040
6321,SuxiangYundi,22,0.00051,3856740,89.46194,4311040
6322,tcf909,22,0.00051,3856762,89.46245,4311040
6323,tdeheurles,22,0.00051,3856784,89.46296,4311040
6324,tegioz,22,0.00051,3856806,89.46347,4311040
6325,tejal29,22,0.00051,3856828,89.46398,4311040
6326,thisisobate,22,0.00051,3856850,89.46449,4311040
6327,tobernguyen,22,0.00051,3856872,89.46500,4311040
6328,tommyvn,22,0.00051,3856894,89.46551,4311040
6329,totallyunknown,22,0.00051,3856916,89.46602,4311040
6330,twpayne,22,0.00051,3856938,89.46653,4311040
6331,vaibhavk,22,0.00051,3856960,89.46704,4311040
6332,vincentwoo,22,0.00051,3856982,89.46755,4311040
6333,voyalab,22,0.00051,3857004,89.46806,4311040
6334,vryzhenkin,22,0.00051,3857026,89.46857,4311040
6335,wirwolf,22,0.00051,3857048,89.46908,4311040
6336,wmengRH,22,0.00051,3857070,89.46959,4311040
6337,xauthulei,22,0.00051,3857092,89.47010,4311040
6338,xcompass,22,0.00051,3857114,89.47061,4311040
6339,xinfengliu,22,0.00051,3857136,89.47113,4311040
6340,xuto2,22,0.00051,3857158,89.47164,4311040
6341,yojay11717,22,0.00051,3857180,89.47215,4311040
6342,yoshioterada,22,0.00051,3857202,89.47266,4311040
6343,yylin1,22,0.00051,3857224,89.47317,4311040
6344,zakkg3,22,0.00051,3857246,89.47368,4311040
6345,zerefwayne,22,0.00051,3857268,89.47419,4311040
6346,zhipengzuo,22,0.00051,3857290,89.47470,4311040
6347,03cranec,21,0.00049,3857311,89.47518,4311040
6348,abelbarrera15,21,0.00049,3857332,89.47567,4311040
6349,adolphlwq,21,0.00049,3857353,89.47616,4311040
6350,aegixx,21,0.00049,3857374,89.47665,4311040
6351,agtogna,21,0.00049,3857395,89.47713,4311040
6352,alecjacobs5401,21,0.00049,3857416,89.47762,4311040
6353,alexnederlof,21,0.00049,3857437,89.47811,4311040
6354,alirezaDavid,21,0.00049,3857458,89.47859,4311040
6355,andrewsav-datacom,21,0.00049,3857479,89.47908,4311040
6356,AnirudhPanda,21,0.00049,3857500,89.47957,4311040
6357,asarenkansah,21,0.00049,3857521,89.48006,4311040
6358,avigailof,21,0.00049,3857542,89.48054,4311040
6359,awh,21,0.00049,3857563,89.48103,4311040
6360,azhurbilo,21,0.00049,3857584,89.48152,4311040
6361,azkore,21,0.00049,3857605,89.48200,4311040
6362,azr,21,0.00049,3857626,89.48249,4311040
6363,BenGalewsky,21,0.00049,3857647,89.48298,4311040
6364,Benjamin-Dobell,21,0.00049,3857668,89.48347,4311040
6365,benjaminguttmann-avtq,21,0.00049,3857689,89.48395,4311040
6366,bluecmd,21,0.00049,3857710,89.48444,4311040
6367,bmizerany,21,0.00049,3857731,89.48493,4311040
6368,bootc,21,0.00049,3857752,89.48541,4311040
6369,brejoc,21,0.00049,3857773,89.48590,4311040
6370,brunzefb,21,0.00049,3857794,89.48639,4311040
6371,caleb15,21,0.00049,3857815,89.48688,4311040
6372,captainkerk,21,0.00049,3857836,89.48736,4311040
6373,cehoffman,21,0.00049,3857857,89.48785,4311040
6374,chinazj,21,0.00049,3857878,89.48834,4311040
6375,ChipWolf,21,0.00049,3857899,89.48882,4311040
6376,coffiney,21,0.00049,3857920,89.48931,4311040
6377,Cool-Coder174,21,0.00049,3857941,89.48980,4311040
6378,cordoval,21,0.00049,3857962,89.49029,4311040
6379,crodetsky,21,0.00049,3857983,89.49077,4311040
6380,cydu-cloud,21,0.00049,3858004,89.49126,4311040
6381,dczombera,21,0.00049,3858025,89.49175,4311040
6382,DenisBiondic,21,0.00049,3858046,89.49223,4311040
6383,d-mo,21,0.00049,3858067,89.49272,4311040
6384,dongjoon-hyun,21,0.00049,3858088,89.49321,4311040
6385,dosmanak,21,0.00049,3858109,89.49370,4311040
6386,dsbos,21,0.00049,3858130,89.49418,4311040
6387,earlruby,21,0.00049,3858151,89.49467,4311040
6388,ebati,21,0.00049,3858172,89.49516,4311040
6389,echarles,21,0.00049,3858193,89.49564,4311040
6390,ekovacs,21,0.00049,3858214,89.49613,4311040
6391,entropitor,21,0.00049,3858235,89.49662,4311040
6392,epotex,21,0.00049,3858256,89.49711,4311040
6393,etsangsplk,21,0.00049,3858277,89.49759,4311040
6394,fbac,21,0.00049,3858298,89.49808,4311040
6395,fenngineering,21,0.00049,3858319,89.49857,4311040
6396,fenngwd,21,0.00049,3858340,89.49905,4311040
6397,fernandocarletti,21,0.00049,3858361,89.49954,4311040
6398,from-nibly,21,0.00049,3858382,89.50003,4311040
6399,GeertJohan,21,0.00049,3858403,89.50051,4311040
6400,gfaugere,21,0.00049,3858424,89.50100,4311040
6401,gintautassulskus,21,0.00049,3858445,89.50149,4311040
6402,gmflau,21,0.00049,3858466,89.50198,4311040
6403,gridworkz,21,0.00049,3858487,89.50246,4311040
6404,GrooveCS,21,0.00049,3858508,89.50295,4311040
6405,Gsantomaggio,21,0.00049,3858529,89.50344,4311040
6406,Guneetconvent2002,21,0.00049,3858550,89.50392,4311040
6407,hakoerber,21,0.00049,3858571,89.50441,4311040
6408,hanks,21,0.00049,3858592,89.50490,4311040
6409,himanshu007-creator,21,0.00049,3858613,89.50539,4311040
6410,hongshibao,21,0.00049,3858634,89.50587,4311040
6411,huazhihao,21,0.00049,3858655,89.50636,4311040
6412,hvenev-vmware,21,0.00049,3858676,89.50685,4311040
6413,imorti,21,0.00049,3858697,89.50733,4311040
6414,itamaro,21,0.00049,3858718,89.50782,4311040
6415,ITD27M01,21,0.00049,3858739,89.50831,4311040
6416,jandubois,21,0.00049,3858760,89.50880,4311040
6417,Jaswir,21,0.00049,3858781,89.50928,4311040
6418,jazzsir,21,0.00049,3858802,89.50977,4311040
6419,jennwah,21,0.00049,3858823,89.51026,4311040
6420,Jeremy-Boyle,21,0.00049,3858844,89.51074,4311040
6421,jjmaestro,21,0.00049,3858865,89.51123,4311040
6422,jlz27,21,0.00049,3858886,89.51172,4311040
6423,JuneZhao,21,0.00049,3858907,89.51221,4311040
6424,jwickens,21,0.00049,3858928,89.51269,4311040
6425,kalbasit,21,0.00049,3858949,89.51318,4311040
6426,kars7e,21,0.00049,3858970,89.51367,4311040
6427,kasunt-nixdev,21,0.00049,3858991,89.51415,4311040
6428,kaushik229,21,0.00049,3859012,89.51464,4311040
6429,khushbuparakh,21,0.00049,3859033,89.51513,4311040
6430,king6cong,21,0.00049,3859054,89.51562,4311040
6431,KomorkinMikhail,21,0.00049,3859075,89.51610,4311040
6432,kplimack,21,0.00049,3859096,89.51659,4311040
6433,krallistic,21,0.00049,3859117,89.51708,4311040
6434,krisdock,21,0.00049,3859138,89.51756,4311040
6435,lastcoolnameleft,21,0.00049,3859159,89.51805,4311040
6436,lattwood,21,0.00049,3859180,89.51854,4311040
6437,lfundaro,21,0.00049,3859201,89.51903,4311040
6438,lilnate22,21,0.00049,3859222,89.51951,4311040
6439,LouisPlisso,21,0.00049,3859243,89.52000,4311040
6440,LucasBoisserie,21,0.00049,3859264,89.52049,4311040
6441,lulf,21,0.00049,3859285,89.52097,4311040
6442,MaikuMori,21,0.00049,3859306,89.52146,4311040
6443,majewsky,21,0.00049,3859327,89.52195,4311040
6444,matthewmichihara,21,0.00049,3859348,89.52244,4311040
6445,mauri870,21,0.00049,3859369,89.52292,4311040
6446,mhenriks,21,0.00049,3859390,89.52341,4311040
6447,mikesparr,21,0.00049,3859411,89.52390,4311040
6448,miles-,21,0.00049,3859432,89.52438,4311040
6449,mJace,21,0.00049,3859453,89.52487,4311040
6450,mlambert890b,21,0.00049,3859474,89.52536,4311040
6451,mmdriley,21,0.00049,3859495,89.52585,4311040
6452,mofirouz,21,0.00049,3859516,89.52633,4311040
6453,mohamed-mehany,21,0.00049,3859537,89.52682,4311040
6454,monicagangwar,21,0.00049,3859558,89.52731,4311040
6455,monstercy,21,0.00049,3859579,89.52779,4311040
6456,morshielt,21,0.00049,3859600,89.52828,4311040
6457,mountkin,21,0.00049,3859621,89.52877,4311040
6458,Mr-Howard-Roark,21,0.00049,3859642,89.52926,4311040
6459,mrpre,21,0.00049,3859663,89.52974,4311040
6460,mysticaltech,21,0.00049,3859684,89.53023,4311040
6461,naxhh,21,0.00049,3859705,89.53072,4311040
6462,neelance,21,0.00049,3859726,89.53120,4311040
6463,NMFR,21,0.00049,3859747,89.53169,4311040
6464,nmnellis,21,0.00049,3859768,89.53218,4311040
6465,normanjoyner,21,0.00049,3859789,89.53266,4311040
6466,nqbao,21,0.00049,3859810,89.53315,4311040
6467,olegsu,21,0.00049,3859831,89.53364,4311040
6468,opsnull,21,0.00049,3859852,89.53413,4311040
6469,pantelis-karamolegkos,21,0.00049,3859873,89.53461,4311040
6470,paudirac,21,0.00049,3859894,89.53510,4311040
6471,paulbattagliag,21,0.00049,3859915,89.53559,4311040
6472,pothos,21,0.00049,3859936,89.53607,4311040
6473,povils,21,0.00049,3859957,89.53656,4311040
6474,ProTip,21,0.00049,3859978,89.53705,4311040
6475,pyama86,21,0.00049,3859999,89.53754,4311040
6476,raggi,21,0.00049,3860020,89.53802,4311040
6477,rakeshreddybandi,21,0.00049,3860041,89.53851,4311040
6478,rastut,21,0.00049,3860062,89.53900,4311040
6479,ratanboddu,21,0.00049,3860083,89.53948,4311040
6480,ravens,21,0.00049,3860104,89.53997,4311040
6481,renaudguerin,21,0.00049,3860125,89.54046,4311040
6482,Rishka,21,0.00049,3860146,89.54095,4311040
6483,robtaylor,21,0.00049,3860167,89.54143,4311040
6484,rossigee,21,0.00049,3860188,89.54192,4311040
6485,sajanjswl,21,0.00049,3860209,89.54241,4311040
6486,Samze,21,0.00049,3860230,89.54289,4311040
6487,sbose78,21,0.00049,3860251,89.54338,4311040
6488,scheeles,21,0.00049,3860272,89.54387,4311040
6489,scheuk,21,0.00049,3860293,89.54436,4311040
6490,Scukerman,21,0.00049,3860314,89.54484,4311040
6491,sdague,21,0.00049,3860335,89.54533,4311040
6492,seomago,21,0.00049,3860356,89.54582,4311040
6493,shakeelrao,21,0.00049,3860377,89.54630,4311040
6494,silverbackdan,21,0.00049,3860398,89.54679,4311040
6495,SimonTheLeg,21,0.00049,3860419,89.54728,4311040
6496,sipian,21,0.00049,3860440,89.54777,4311040
6497,sl1pm4t,21,0.00049,3860461,89.54825,4311040
6498,snebel29,21,0.00049,3860482,89.54874,4311040
6499,solarkennedy,21,0.00049,3860503,89.54923,4311040
6500,stepanstipl,21,0.00049,3860524,89.54971,4311040
6501,sufuf3,21,0.00049,3860545,89.55020,4311040
6502,Sunnatillo,21,0.00049,3860566,89.55069,4311040
6503,suvsap,21,0.00049,3860587,89.55118,4311040
6504,szpak,21,0.00049,3860608,89.55166,4311040
6505,tadas-subonis,21,0.00049,3860629,89.55215,4311040
6506,taharah,21,0.00049,3860650,89.55264,4311040
6507,thedebugger,21,0.00049,3860671,89.55312,4311040
6508,thesteve0,21,0.00049,3860692,89.55361,4311040
6509,throrin19,21,0.00049,3860713,89.55410,4311040
6510,tpetr,21,0.00049,3860734,89.55459,4311040
6511,vdboor,21,0.00049,3860755,89.55507,4311040
6512,vincentheet,21,0.00049,3860776,89.55556,4311040
6513,vincentjorgensen,21,0.00049,3860797,89.55605,4311040
6514,vishnuitta,21,0.00049,3860818,89.55653,4311040
6515,vishvananda,21,0.00049,3860839,89.55702,4311040
6516,vnugent,21,0.00049,3860860,89.55751,4311040
6517,w3st3ry,21,0.00049,3860881,89.55800,4311040
6518,wenzong,21,0.00049,3860902,89.55848,4311040
6519,wonderflow,21,0.00049,3860923,89.55897,4311040
6520,WoodProgrammer,21,0.00049,3860944,89.55946,4311040
6521,wppzxc,21,0.00049,3860965,89.55994,4311040
6522,Yancey1989,21,0.00049,3860986,89.56043,4311040
6523,yangy2000,21,0.00049,3861007,89.56092,4311040
6524,ybelMekk,21,0.00049,3861028,89.56141,4311040
6525,yoz2326,21,0.00049,3861049,89.56189,4311040
6526,zaneb,21,0.00049,3861070,89.56238,4311040
6527,zawachte,21,0.00049,3861091,89.56287,4311040
6528,zeleena,21,0.00049,3861112,89.56335,4311040
6529,zeph,21,0.00049,3861133,89.56384,4311040
6530,ZhangZhenhua,21,0.00049,3861154,89.56433,4311040
6531,21stio,20,0.00046,3861174,89.56479,4311040
6532,283713406,20,0.00046,3861194,89.56526,4311040
6533,4406arthur,20,0.00046,3861214,89.56572,4311040
6534,adam-marek,20,0.00046,3861234,89.56618,4311040
6535,admssa,20,0.00046,3861254,89.56665,4311040
6536,agolomoodysaada,20,0.00046,3861274,89.56711,4311040
6537,aim-for-better,20,0.00046,3861294,89.56758,4311040
6538,AliMirlou,20,0.00046,3861314,89.56804,4311040
6539,allantargino,20,0.00046,3861334,89.56850,4311040
6540,alpe,20,0.00046,3861354,89.56897,4311040
6541,amarts,20,0.00046,3861374,89.56943,4311040
6542,amorey,20,0.00046,3861394,89.56989,4311040
6543,anitgandhi,20,0.00046,3861414,89.57036,4311040
6544,ankur0904,20,0.00046,3861434,89.57082,4311040
6545,antoineozenne,20,0.00046,3861454,89.57129,4311040
6546,anushkamittal20,20,0.00046,3861474,89.57175,4311040
6547,Arano-kai,20,0.00046,3861494,89.57221,4311040
6548,argais,20,0.00046,3861514,89.57268,4311040
6549,arief-hidayat,20,0.00046,3861534,89.57314,4311040
6550,Ashraf-Hassan,20,0.00046,3861554,89.57361,4311040
6551,AugustasV,20,0.00046,3861574,89.57407,4311040
6552,autarchprinceps,20,0.00046,3861594,89.57453,4311040
6553,bagrat,20,0.00046,3861614,89.57500,4311040
6554,bartelsb,20,0.00046,3861634,89.57546,4311040
6555,bartlaarhoven,20,0.00046,3861654,89.57593,4311040
6556,bbreslauer,20,0.00046,3861674,89.57639,4311040
6557,berrange,20,0.00046,3861694,89.57685,4311040
6558,biswars,20,0.00046,3861714,89.57732,4311040
6559,boynux,20,0.00046,3861734,89.57778,4311040
6560,brusMX,20,0.00046,3861754,89.57825,4311040
6561,brycecr,20,0.00046,3861774,89.57871,4311040
6562,cap10morgan,20,0.00046,3861794,89.57917,4311040
6563,chechiachang,20,0.00046,3861814,89.57964,4311040
6564,chintan8saaras,20,0.00046,3861834,89.58010,4311040
6565,christophetd,20,0.00046,3861854,89.58057,4311040
6566,ciwang,20,0.00046,3861874,89.58103,4311040
6567,claudiajh,20,0.00046,3861894,89.58149,4311040
6568,Code0x58,20,0.00046,3861914,89.58196,4311040
6569,combor,20,0.00046,3861934,89.58242,4311040
6570,copumpkin,20,0.00046,3861954,89.58288,4311040
6571,cwsolee,20,0.00046,3861974,89.58335,4311040
6572,dacohen,20,0.00046,3861994,89.58381,4311040
6573,dapengJacky,20,0.00046,3862014,89.58428,4311040
6574,donghui12,20,0.00046,3862034,89.58474,4311040
6575,dragoneena12,20,0.00046,3862054,89.58520,4311040
6576,DukeXar,20,0.00046,3862074,89.58567,4311040
6577,EdanSneh,20,0.00046,3862094,89.58613,4311040
6578,eightlimbed,20,0.00046,3862114,89.58660,4311040
6579,elafontaine,20,0.00046,3862134,89.58706,4311040
6580,erickt,20,0.00046,3862154,89.58752,4311040
6581,ernoaapa,20,0.00046,3862174,89.58799,4311040
6582,eyalzek,20,0.00046,3862194,89.58845,4311040
6583,faheem-cliqz,20,0.00046,3862214,89.58892,4311040
6584,fgbreel,20,0.00046,3862234,89.58938,4311040
6585,flokli,20,0.00046,3862254,89.58984,4311040
6586,fxposter,20,0.00046,3862274,89.59031,4311040
6587,gedimitr,20,0.00046,3862294,89.59077,4311040
6588,geegeea,20,0.00046,3862314,89.59124,4311040
6589,gkohen,20,0.00046,3862334,89.59170,4311040
6590,glennschmidt,20,0.00046,3862354,89.59216,4311040
6591,grimmy,20,0.00046,3862374,89.59263,4311040
6592,groner,20,0.00046,3862394,89.59309,4311040
6593,gugahoi,20,0.00046,3862414,89.59356,4311040
6594,guybrush,20,0.00046,3862434,89.59402,4311040
6595,harisanker1780,20,0.00046,3862454,89.59448,4311040
6596,harobed,20,0.00046,3862474,89.59495,4311040
6597,IamPrvn,20,0.00046,3862494,89.59541,4311040
6598,indhupriya,20,0.00046,3862514,89.59587,4311040
6599,innovate-invent,20,0.00046,3862534,89.59634,4311040
6600,instantlinux,20,0.00046,3862554,89.59680,4311040
6601,ishangupta-ds,20,0.00046,3862574,89.59727,4311040
6602,it-svit,20,0.00046,3862594,89.59773,4311040
6603,jackzampolin,20,0.00046,3862614,89.59819,4311040
6604,jaredledvina,20,0.00046,3862634,89.59866,4311040
6605,JasonMorgan,20,0.00046,3862654,89.59912,4311040
6606,jgeraerts,20,0.00046,3862674,89.59959,4311040
6607,jhou1,20,0.00046,3862694,89.60005,4311040
6608,jlk,20,0.00046,3862714,89.60051,4311040
6609,jmcarp,20,0.00046,3862734,89.60098,4311040
6610,johnstudarus,20,0.00046,3862754,89.60144,4311040
6611,JoshVanL,20,0.00046,3862774,89.60191,4311040
6612,jpweber,20,0.00046,3862794,89.60237,4311040
6613,jvalencia,20,0.00046,3862814,89.60283,4311040
6614,jwierzbo,20,0.00046,3862834,89.60330,4311040
6615,kabakaev,20,0.00046,3862854,89.60376,4311040
6616,KadenLNelson,20,0.00046,3862874,89.60423,4311040
6617,Kami-no,20,0.00046,3862894,89.60469,4311040
6618,Kart121,20,0.00046,3862914,89.60515,4311040
6619,kdomanski,20,0.00046,3862934,89.60562,4311040
6620,kennethredler,20,0.00046,3862954,89.60608,4311040
6621,kesslerdev,20,0.00046,3862974,89.60655,4311040
6622,kevinliuzhong,20,0.00046,3862994,89.60701,4311040
6623,khogeland,20,0.00046,3863014,89.60747,4311040
6624,kitos9112,20,0.00046,3863034,89.60794,4311040
6625,kwoodson,20,0.00046,3863054,89.60840,4311040
6626,kzmrv,20,0.00046,3863074,89.60886,4311040
6627,lanandra,20,0.00046,3863094,89.60933,4311040
6628,lanchongyizu,20,0.00046,3863114,89.60979,4311040
6629,Lawouach,20,0.00046,3863134,89.61026,4311040
6630,lluunn,20,0.00046,3863154,89.61072,4311040
6631,loe,20,0.00046,3863174,89.61118,4311040
6632,madorn,20,0.00046,3863194,89.61165,4311040
6633,maksim-paskal,20,0.00046,3863214,89.61211,4311040
6634,mariomarin,20,0.00046,3863234,89.61258,4311040
6635,markus1189,20,0.00046,3863254,89.61304,4311040
6636,marratj,20,0.00046,3863274,89.61350,4311040
6637,masterkain,20,0.00046,3863294,89.61397,4311040
6638,matjazp,20,0.00046,3863314,89.61443,4311040
6639,mattxwang,20,0.00046,3863334,89.61490,4311040
6640,mcadam,20,0.00046,3863354,89.61536,4311040
6641,mmack,20,0.00046,3863374,89.61582,4311040
6642,mohang6770,20,0.00046,3863394,89.61629,4311040
6643,monojit18,20,0.00046,3863414,89.61675,4311040
6644,mpatters72,20,0.00046,3863434,89.61722,4311040
6645,mrdunski,20,0.00046,3863454,89.61768,4311040
6646,mtparet,20,0.00046,3863474,89.61814,4311040
6647,mward29,20,0.00046,3863494,89.61861,4311040
6648,nitindagar0,20,0.00046,3863514,89.61907,4311040
6649,n-marton,20,0.00046,3863534,89.61953,4311040
6650,nobbs,20,0.00046,3863554,89.62000,4311040
6651,odelucca,20,0.00046,3863574,89.62046,4311040
6652,olmoser,20,0.00046,3863594,89.62093,4311040
6653,ovidiucp,20,0.00046,3863614,89.62139,4311040
6654,pathcl,20,0.00046,3863634,89.62185,4311040
6655,paultyng,20,0.00046,3863654,89.62232,4311040
6656,penberg,20,0.00046,3863674,89.62278,4311040
6657,perljedi,20,0.00046,3863694,89.62325,4311040
6658,pichouk,20,0.00046,3863714,89.62371,4311040
6659,pipo02mix,20,0.00046,3863734,89.62417,4311040
6660,pmendelski,20,0.00046,3863754,89.62464,4311040
6661,prestonvanloon,20,0.00046,3863774,89.62510,4311040
6662,qckzr,20,0.00046,3863794,89.62557,4311040
6663,Raghunandan16,20,0.00046,3863814,89.62603,4311040
6664,rlmcpherson,20,0.00046,3863834,89.62649,4311040
6665,rmarcum,20,0.00046,3863854,89.62696,4311040
6666,ryan4yin,20,0.00046,3863874,89.62742,4311040
6667,ryanj,20,0.00046,3863894,89.62789,4311040
6668,sakajunquality,20,0.00046,3863914,89.62835,4311040
6669,samuelmanzer,20,0.00046,3863934,89.62881,4311040
6670,sanicheev,20,0.00046,3863954,89.62928,4311040
6671,scardena,20,0.00046,3863974,89.62974,4311040
6672,searsaw,20,0.00046,3863994,89.63021,4311040
6673,ServerNinja,20,0.00046,3864014,89.63067,4311040
6674,sfotony,20,0.00046,3864034,89.63113,4311040
6675,Shahard2,20,0.00046,3864054,89.63160,4311040
6676,shaynewang,20,0.00046,3864074,89.63206,4311040
6677,shiftky,20,0.00046,3864094,89.63252,4311040
6678,shiliangxue,20,0.00046,3864114,89.63299,4311040
6679,shoukathmd,20,0.00046,3864134,89.63345,4311040
6680,shriyasankhyan,20,0.00046,3864154,89.63392,4311040
6681,ShuYingya,20,0.00046,3864174,89.63438,4311040
6682,smelchior,20,0.00046,3864194,89.63484,4311040
6683,squillace,20,0.00046,3864214,89.63531,4311040
6684,stevenbower,20,0.00046,3864234,89.63577,4311040
6685,StingyJack,20,0.00046,3864254,89.63624,4311040
6686,suntorytimed,20,0.00046,3864274,89.63670,4311040
6687,svennela,20,0.00046,3864294,89.63716,4311040
6688,swade1987,20,0.00046,3864314,89.63763,4311040
6689,swiftslee,20,0.00046,3864334,89.63809,4311040
6690,tavisma,20,0.00046,3864354,89.63856,4311040
6691,tcnghia,20,0.00046,3864374,89.63902,4311040
6692,thanasisk,20,0.00046,3864394,89.63948,4311040
6693,thesandlord,20,0.00046,3864414,89.63995,4311040
6694,thtanaka,20,0.00046,3864434,89.64041,4311040
6695,tleyden,20,0.00046,3864454,89.64088,4311040
6696,tnachen,20,0.00046,3864474,89.64134,4311040
6697,tobilarscheid,20,0.00046,3864494,89.64180,4311040
6698,vagharsh,20,0.00046,3864514,89.64227,4311040
6699,VincentFF,20,0.00046,3864534,89.64273,4311040
6700,viteksafronov,20,0.00046,3864554,89.64320,4311040
6701,vjsamuel,20,0.00046,3864574,89.64366,4311040
6702,walkafwalka,20,0.00046,3864594,89.64412,4311040
6703,WalkerGriggs,20,0.00046,3864614,89.64459,4311040
6704,woohhan,20,0.00046,3864634,89.64505,4311040
6705,wuestkamp,20,0.00046,3864654,89.64551,4311040
6706,wwitzel3,20,0.00046,3864674,89.64598,4311040
6707,xiechengsheng,20,0.00046,3864694,89.64644,4311040
6708,yogi-sagar,20,0.00046,3864714,89.64691,4311040
6709,YouriT,20,0.00046,3864734,89.64737,4311040
6710,yuvraj9,20,0.00046,3864754,89.64783,4311040
6711,zhang8473,20,0.00046,3864774,89.64830,4311040
6712,zhaohuabing,20,0.00046,3864794,89.64876,4311040
6713,zr-msft,20,0.00046,3864814,89.64923,4311040
6714,zwwhdls,20,0.00046,3864834,89.64969,4311040
6715,8398a7,19,0.00044,3864853,89.65013,4311040
6716,abushoeb,19,0.00044,3864872,89.65057,4311040
6717,adevjoe,19,0.00044,3864891,89.65101,4311040
6718,adimania,19,0.00044,3864910,89.65145,4311040
6719,adyanth,19,0.00044,3864929,89.65189,4311040
6720,akhilesh2410,19,0.00044,3864948,89.65233,4311040
6721,alanbchristie,19,0.00044,3864967,89.65278,4311040
6722,alen-z,19,0.00044,3864986,89.65322,4311040
6723,alexppg,19,0.00044,3865005,89.65366,4311040
6724,alghe-global,19,0.00044,3865024,89.65410,4311040
6725,alitoufighi,19,0.00044,3865043,89.65454,4311040
6726,allamand,19,0.00044,3865062,89.65498,4311040
6727,andreyshestakov,19,0.00044,3865081,89.65542,4311040
6728,AndrienkoAleksandr,19,0.00044,3865100,89.65586,4311040
6729,ankitsinhaiiitg,19,0.00044,3865119,89.65630,4311040
6730,apeschel,19,0.00044,3865138,89.65674,4311040
6731,ardnaxelarak,19,0.00044,3865157,89.65718,4311040
6732,arturo-c,19,0.00044,3865176,89.65762,4311040
6733,at1984z,19,0.00044,3865195,89.65806,4311040
6734,auxten,19,0.00044,3865214,89.65850,4311040
6735,azell,19,0.00044,3865233,89.65895,4311040
6736,benpriestman,19,0.00044,3865252,89.65939,4311040
6737,bksteiny,19,0.00044,3865271,89.65983,4311040
6738,blakestoddard,19,0.00044,3865290,89.66027,4311040
6739,blues-man,19,0.00044,3865309,89.66071,4311040
6740,bobfuru,19,0.00044,3865328,89.66115,4311040
6741,bonifaido,19,0.00044,3865347,89.66159,4311040
6742,BryanStenson-okta,19,0.00044,3865366,89.66203,4311040
6743,bussyjd,19,0.00044,3865385,89.66247,4311040
6744,bviolier,19,0.00044,3865404,89.66291,4311040
6745,cabrinha,19,0.00044,3865423,89.66335,4311040
6746,caitong93,19,0.00044,3865442,89.66379,4311040
6747,calder,19,0.00044,3865461,89.66423,4311040
6748,caraboides,19,0.00044,3865480,89.66467,4311040
6749,ccamacho,19,0.00044,3865499,89.66512,4311040
6750,chengshiwen,19,0.00044,3865518,89.66556,4311040
6751,chenhong0129,19,0.00044,3865537,89.66600,4311040
6752,cjbradfield,19,0.00044,3865556,89.66644,4311040
6753,danielloczi,19,0.00044,3865575,89.66688,4311040
6754,DesmondHoLLM,19,0.00044,3865594,89.66732,4311040
6755,djdongjin,19,0.00044,3865613,89.66776,4311040
6756,dminkovsky,19,0.00044,3865632,89.66820,4311040
6757,douglascamata,19,0.00044,3865651,89.66864,4311040
6758,Ed87,19,0.00044,3865670,89.66908,4311040
6759,emanic,19,0.00044,3865689,89.66952,4311040
6760,ErikLundJensen,19,0.00044,3865708,89.66996,4311040
6761,ernestoalejo,19,0.00044,3865727,89.67040,4311040
6762,erwbgy,19,0.00044,3865746,89.67085,4311040
6763,evaldasou,19,0.00044,3865765,89.67129,4311040
6764,fasthall,19,0.00044,3865784,89.67173,4311040
6765,ffahri,19,0.00044,3865803,89.67217,4311040
6766,FlorianLudwig,19,0.00044,3865822,89.67261,4311040
6767,flylo,19,0.00044,3865841,89.67305,4311040
6768,fragtom,19,0.00044,3865860,89.67349,4311040
6769,frittenlab,19,0.00044,3865879,89.67393,4311040
6770,fsommar,19,0.00044,3865898,89.67437,4311040
6771,gdetal,19,0.00044,3865917,89.67481,4311040
6772,gmrodgers,19,0.00044,3865936,89.67525,4311040
6773,gouravbansal11,19,0.00044,3865955,89.67569,4311040
6774,harshapic,19,0.00044,3865974,89.67613,4311040
6775,hongkunyoo,19,0.00044,3865993,89.67657,4311040
6776,iam404,19,0.00044,3866012,89.67702,4311040
6777,iheanyi1,19,0.00044,3866031,89.67746,4311040
6778,imranrazakhan,19,0.00044,3866050,89.67790,4311040
6779,inge4pres,19,0.00044,3866069,89.67834,4311040
6780,italofernandes13,19,0.00044,3866088,89.67878,4311040
6781,iverberk,19,0.00044,3866107,89.67922,4311040
6782,jagregory,19,0.00044,3866126,89.67966,4311040
6783,jakolehm,19,0.00044,3866145,89.68010,4311040
6784,jatinTyagi98,19,0.00044,3866164,89.68054,4311040
6785,jayme-github,19,0.00044,3866183,89.68098,4311040
6786,jdfless,19,0.00044,3866202,89.68142,4311040
6787,jeffb4,19,0.00044,3866221,89.68186,4311040
6788,jmcshane,19,0.00044,3866240,89.68230,4311040
6789,johnlinp,19,0.00044,3866259,89.68274,4311040
6790,joostschriek,19,0.00044,3866278,89.68319,4311040
6791,jose5918,19,0.00044,3866297,89.68363,4311040
6792,joshmue,19,0.00044,3866316,89.68407,4311040
6793,jpatel-pivotal,19,0.00044,3866335,89.68451,4311040
6794,jumpkick,19,0.00044,3866354,89.68495,4311040
6795,JustinAzoff,19,0.00044,3866373,89.68539,4311040
6796,jwmatthews,19,0.00044,3866392,89.68583,4311040
6797,Kaijun,19,0.00044,3866411,89.68627,4311040
6798,karlschriek,19,0.00044,3866430,89.68671,4311040
6799,Karthik-PM,19,0.00044,3866449,89.68715,4311040
6800,keisukesakasai,19,0.00044,3866468,89.68759,4311040
6801,kenperkins,19,0.00044,3866487,89.68803,4311040
6802,keypointt,19,0.00044,3866506,89.68847,4311040
6803,kkimdev,19,0.00044,3866525,89.68891,4311040
6804,kostko,19,0.00044,3866544,89.68936,4311040
6805,kpgriffith,19,0.00044,3866563,89.68980,4311040
6806,kumiDa,19,0.00044,3866582,89.69024,4311040
6807,KurtStam,19,0.00044,3866601,89.69068,4311040
6808,kuznero,19,0.00044,3866620,89.69112,4311040
6809,kweisamx,19,0.00044,3866639,89.69156,4311040
6810,KyleAMathews,19,0.00044,3866658,89.69200,4311040
6811,lander2k2,19,0.00044,3866677,89.69244,4311040
6812,LaumiH,19,0.00044,3866696,89.69288,4311040
6813,Legion2,19,0.00044,3866715,89.69332,4311040
6814,lgg42,19,0.00044,3866734,89.69376,4311040
6815,lghinet,19,0.00044,3866753,89.69420,4311040
6816,LingxianKong,19,0.00044,3866772,89.69464,4311040
6817,LinuxGit,19,0.00044,3866791,89.69509,4311040
6818,liuyangc3,19,0.00044,3866810,89.69553,4311040
6819,livelace,19,0.00044,3866829,89.69597,4311040
6820,lloeki,19,0.00044,3866848,89.69641,4311040
6821,loftkun,19,0.00044,3866867,89.69685,4311040
6822,lukasheinrich,19,0.00044,3866886,89.69729,4311040
6823,madhukar93,19,0.00044,3866905,89.69773,4311040
6824,marek-obuchowicz,19,0.00044,3866924,89.69817,4311040
6825,matthewg,19,0.00044,3866943,89.69861,4311040
6826,MatthiasLohr,19,0.00044,3866962,89.69905,4311040
6827,matthughes,19,0.00044,3866981,89.69949,4311040
6828,maxkondr,19,0.00044,3867000,89.69993,4311040
6829,mbabker,19,0.00044,3867019,89.70037,4311040
6830,mhumeSF,19,0.00044,3867038,89.70081,4311040
6831,microadam,19,0.00044,3867057,89.70126,4311040
6832,moander,19,0.00044,3867076,89.70170,4311040
6833,moondev,19,0.00044,3867095,89.70214,4311040
6834,mpashka,19,0.00044,3867114,89.70258,4311040
6835,n1koo,19,0.00044,3867133,89.70302,4311040
6836,nathforge,19,0.00044,3867152,89.70346,4311040
6837,nesl247,19,0.00044,3867171,89.70390,4311040
6838,nikita15p,19,0.00044,3867190,89.70434,4311040
6839,nitinkansal1984,19,0.00044,3867209,89.70478,4311040
6840,njegosrailic,19,0.00044,3867228,89.70522,4311040
6841,nxf5025,19,0.00044,3867247,89.70566,4311040
6842,Oats87,19,0.00044,3867266,89.70610,4311040
6843,okryvoshapka-connyun,19,0.00044,3867285,89.70654,4311040
6844,OliverMKing,19,0.00044,3867304,89.70698,4311040
6845,olix0r,19,0.00044,3867323,89.70743,4311040
6846,opera443399,19,0.00044,3867342,89.70787,4311040
6847,pastjean,19,0.00044,3867361,89.70831,4311040
6848,patstrom,19,0.00044,3867380,89.70875,4311040
6849,pavolloffay,19,0.00044,3867399,89.70919,4311040
6850,pdhamdhere,19,0.00044,3867418,89.70963,4311040
6851,pdoreau,19,0.00044,3867437,89.71007,4311040
6852,peter-edge,19,0.00044,3867456,89.71051,4311040
6853,piwi91,19,0.00044,3867475,89.71095,4311040
6854,pompomJuice,19,0.00044,3867494,89.71139,4311040
6855,pythonpowerd,19,0.00044,3867513,89.71183,4311040
6856,quinton-hoole-google,19,0.00044,3867532,89.71227,4311040
6857,rafariossaa,19,0.00044,3867551,89.71271,4311040
6858,rahuldhide,19,0.00044,3867570,89.71316,4311040
6859,raphael,19,0.00044,3867589,89.71360,4311040
6860,rbrishabh,19,0.00044,3867608,89.71404,4311040
6861,Rcluoyi,19,0.00044,3867627,89.71448,4311040
6862,rnburn,19,0.00044,3867646,89.71492,4311040
6863,robinbraemer,19,0.00044,3867665,89.71536,4311040
6864,RohanNagar,19,0.00044,3867684,89.71580,4311040
6865,rohansingh,19,0.00044,3867703,89.71624,4311040
6866,rollandf,19,0.00044,3867722,89.71668,4311040
6867,ronakpandya7,19,0.00044,3867741,89.71712,4311040
6868,rul3m4k3r,19,0.00044,3867760,89.71756,4311040
6869,rushabh268,19,0.00044,3867779,89.71800,4311040
6870,sandaymin123,19,0.00044,3867798,89.71844,4311040
6871,sandeen,19,0.00044,3867817,89.71888,4311040
6872,scf0920,19,0.00044,3867836,89.71933,4311040
6873,shamsher31,19,0.00044,3867855,89.71977,4311040
6874,shinji62,19,0.00044,3867874,89.72021,4311040
6875,shufanhao,19,0.00044,3867893,89.72065,4311040
6876,silentred,19,0.00044,3867912,89.72109,4311040
6877,slashr,19,0.00044,3867931,89.72153,4311040
6878,slinkydeveloper,19,0.00044,3867950,89.72197,4311040
6879,snarlysodboxer,19,0.00044,3867969,89.72241,4311040
6880,soorena776,19,0.00044,3867988,89.72285,4311040
6881,sradco,19,0.00044,3868007,89.72329,4311040
6882,srakesh28,19,0.00044,3868026,89.72373,4311040
6883,steve-fraser,19,0.00044,3868045,89.72417,4311040
6884,stevezau,19,0.00044,3868064,89.72461,4311040
6885,Sturgelose,19,0.00044,3868083,89.72505,4311040
6886,stylianosrigas,19,0.00044,3868102,89.72550,4311040
6887,su225,19,0.00044,3868121,89.72594,4311040
6888,subhamkrai,19,0.00044,3868140,89.72638,4311040
6889,tcahill,19,0.00044,3868159,89.72682,4311040
6890,teoyaomiqui,19,0.00044,3868178,89.72726,4311040
6891,The-Loeki,19,0.00044,3868197,89.72770,4311040
6892,Thor-wl,19,0.00044,3868216,89.72814,4311040
6893,tianquan23,19,0.00044,3868235,89.72858,4311040
6894,tkatila,19,0.00044,3868254,89.72902,4311040
6895,tmmorin,19,0.00044,3868273,89.72946,4311040
6896,torstenwalter,19,0.00044,3868292,89.72990,4311040
6897,twexler,19,0.00044,3868311,89.73034,4311040
6898,ultimateboy,19,0.00044,3868330,89.73078,4311040
6899,unrolled,19,0.00044,3868349,89.73122,4311040
6900,utsav2307,19,0.00044,3868368,89.73167,4311040
6901,venilnoronha,19,0.00044,3868387,89.73211,4311040
6902,vgunapati,19,0.00044,3868406,89.73255,4311040
6903,vincenthcui,19,0.00044,3868425,89.73299,4311040
6904,violet2016,19,0.00044,3868444,89.73343,4311040
6905,vipulsabhaya,19,0.00044,3868463,89.73387,4311040
6906,virtuman,19,0.00044,3868482,89.73431,4311040
6907,viveksinghggits,19,0.00044,3868501,89.73475,4311040
6908,vthapar,19,0.00044,3868520,89.73519,4311040
6909,w9n,19,0.00044,3868539,89.73563,4311040
6910,yanwei2019,19,0.00044,3868558,89.73607,4311040
6911,yasensim,19,0.00044,3868577,89.73651,4311040
6912,Yiyiyimu,19,0.00044,3868596,89.73695,4311040
6913,ytinirt,19,0.00044,3868615,89.73740,4311040
6914,yuzisun,19,0.00044,3868634,89.73784,4311040
6915,yuzp1996,19,0.00044,3868653,89.73828,4311040
6916,zqm19941101,19,0.00044,3868672,89.73872,4311040
6917,0x2b3bfa0,18,0.00042,3868690,89.73913,4311040
6918,aakarshg,18,0.00042,3868708,89.73955,4311040
6919,abhyuditjain,18,0.00042,3868726,89.73997,4311040
6920,achanda,18,0.00042,3868744,89.74039,4311040
6921,acoshift,18,0.00042,3868762,89.74081,4311040
6922,adamhjk,18,0.00042,3868780,89.74122,4311040
6923,adberger,18,0.00042,3868798,89.74164,4311040
6924,ahmadnurus,18,0.00042,3868816,89.74206,4311040
6925,alanhartless,18,0.00042,3868834,89.74248,4311040
6926,alexanderilyin,18,0.00042,3868852,89.74289,4311040
6927,alicek106,18,0.00042,3868870,89.74331,4311040
6928,amitbitcse,18,0.00042,3868888,89.74373,4311040
6929,ansilh,18,0.00042,3868906,89.74415,4311040
6930,antonmarin,18,0.00042,3868924,89.74456,4311040
6931,arijitr-citrix,18,0.00042,3868942,89.74498,4311040
6932,artburkart,18,0.00042,3868960,89.74540,4311040
6933,aserdean,18,0.00042,3868978,89.74582,4311040
6934,asmacdo,18,0.00042,3868996,89.74623,4311040
6935,avmohan,18,0.00042,3869014,89.74665,4311040
6936,awaddiz,18,0.00042,3869032,89.74707,4311040
6937,balboah,18,0.00042,3869050,89.74749,4311040
6938,balibebas,18,0.00042,3869068,89.74790,4311040
6939,BartoszZawadzki,18,0.00042,3869086,89.74832,4311040
6940,benbalter,18,0.00042,3869104,89.74874,4311040
6941,ben-krieger,18,0.00042,3869122,89.74916,4311040
6942,bitscuit,18,0.00042,3869140,89.74957,4311040
6943,BlueMonday,18,0.00042,3869158,89.74999,4311040
6944,BlueShells,18,0.00042,3869176,89.75041,4311040
6945,bobhenkel,18,0.00042,3869194,89.75083,4311040
6946,borismattijssen,18,0.00042,3869212,89.75124,4311040
6947,Bowenislandsong,18,0.00042,3869230,89.75166,4311040
6948,BrianChristie,18,0.00042,3869248,89.75208,4311040
6949,brosner,18,0.00042,3869266,89.75250,4311040
6950,bttger,18,0.00042,3869284,89.75291,4311040
6951,caiohasouza,18,0.00042,3869302,89.75333,4311040
6952,Callisto13,18,0.00042,3869320,89.75375,4311040
6953,caseeker,18,0.00042,3869338,89.75417,4311040
6954,cdobbyn,18,0.00042,3869356,89.75458,4311040
6955,cglacet,18,0.00042,3869374,89.75500,4311040
6956,Chandan-Abhyankar,18,0.00042,3869392,89.75542,4311040
6957,christomas1,18,0.00042,3869410,89.75584,4311040
6958,chuckpiercey,18,0.00042,3869428,89.75625,4311040
6959,clux,18,0.00042,3869446,89.75667,4311040
6960,CodeLingoBot,18,0.00042,3869464,89.75709,4311040
6961,craigcomstock,18,0.00042,3869482,89.75751,4311040
6962,cwocwo,18,0.00042,3869500,89.75792,4311040
6963,danpaik,18,0.00042,3869518,89.75834,4311040
6964,danwent,18,0.00042,3869536,89.75876,4311040
6965,davidarcher,18,0.00042,3869554,89.75918,4311040
6966,davidlanouette,18,0.00042,3869572,89.75959,4311040
6967,devaii,18,0.00042,3869590,89.76001,4311040
6968,dgonyeo,18,0.00042,3869608,89.76043,4311040
6969,dharmit,18,0.00042,3869626,89.76085,4311040
6970,dijitali,18,0.00042,3869644,89.76126,4311040
6971,djkormo,18,0.00042,3869662,89.76168,4311040
6972,dkerwin,18,0.00042,3869680,89.76210,4311040
6973,DockToFuture,18,0.00042,3869698,89.76252,4311040
6974,dstroot,18,0.00042,3869716,89.76293,4311040
6975,dulltz,18,0.00042,3869734,89.76335,4311040
6976,DWSR,18,0.00042,3869752,89.76377,4311040
6977,eclipseo,18,0.00042,3869770,89.76419,4311040
6978,EdSchouten,18,0.00042,3869788,89.76460,4311040
6979,eicnix,18,0.00042,3869806,89.76502,4311040
6980,eikaas,18,0.00042,3869824,89.76544,4311040
6981,emsearcy,18,0.00042,3869842,89.76586,4311040
6982,fische,18,0.00042,3869860,89.76627,4311040
6983,Flowkap,18,0.00042,3869878,89.76669,4311040
6984,flyer103,18,0.00042,3869896,89.76711,4311040
6985,ForestCold,18,0.00042,3869914,89.76753,4311040
6986,FranklinYu,18,0.00042,3869932,89.76794,4311040
6987,fraserdarwent,18,0.00042,3869950,89.76836,4311040
6988,frosenberg,18,0.00042,3869968,89.76878,4311040
6989,funkypenguin,18,0.00042,3869986,89.76920,4311040
6990,gabriel-samfira,18,0.00042,3870004,89.76961,4311040
6991,gberche-orange,18,0.00042,3870022,89.77003,4311040
6992,gdsoumya,18,0.00042,3870040,89.77045,4311040
6993,ghakazian,18,0.00042,3870058,89.77087,4311040
6994,gin419,18,0.00042,3870076,89.77128,4311040
6995,gkGaneshR,18,0.00042,3870094,89.77170,4311040
6996,gluke77,18,0.00042,3870112,89.77212,4311040
6997,gnarea,18,0.00042,3870130,89.77254,4311040
6998,gregwebs,18,0.00042,3870148,89.77296,4311040
6999,gsacavdm,18,0.00042,3870166,89.77337,4311040
7000,gytisgreitai,18,0.00042,3870184,89.77379,4311040
7001,haad,18,0.00042,3870202,89.77421,4311040
7002,Halamix2,18,0.00042,3870220,89.77463,4311040
7003,harlowja,18,0.00042,3870238,89.77504,4311040
7004,harsh4870,18,0.00042,3870256,89.77546,4311040
7005,harsha544,18,0.00042,3870274,89.77588,4311040
7006,HerrNaN,18,0.00042,3870292,89.77630,4311040
7007,Himanshuxone,18,0.00042,3870310,89.77671,4311040
7008,hjanuschka,18,0.00042,3870328,89.77713,4311040
7009,hougangliu,18,0.00042,3870346,89.77755,4311040
7010,i02sopop,18,0.00042,3870364,89.77797,4311040
7011,iahmad-khan,18,0.00042,3870382,89.77838,4311040
7012,i-am-yuvi,18,0.00042,3870400,89.77880,4311040
7013,iantalarico,18,0.00042,3870418,89.77922,4311040
7014,ikruglov,18,0.00042,3870436,89.77964,4311040
7015,jaalle,18,0.00042,3870454,89.78005,4311040
7016,jamielennox,18,0.00042,3870472,89.78047,4311040
7017,jamstar,18,0.00042,3870490,89.78089,4311040
7018,janlauber,18,0.00042,3870508,89.78131,4311040
7019,jeremyxu2010,18,0.00042,3870526,89.78172,4311040
7020,jessesanford,18,0.00042,3870544,89.78214,4311040
7021,jfcg,18,0.00042,3870562,89.78256,4311040
7022,jflory7,18,0.00042,3870580,89.78298,4311040
7023,Jille,18,0.00042,3870598,89.78339,4311040
7024,jkbschmid,18,0.00042,3870616,89.78381,4311040
7025,jl2005,18,0.00042,3870634,89.78423,4311040
7026,JMesser81,18,0.00042,3870652,89.78465,4311040
7027,JnMik,18,0.00042,3870670,89.78506,4311040
7028,joelbyronbarker,18,0.00042,3870688,89.78548,4311040
7029,jonassteinberg1,18,0.00042,3870706,89.78590,4311040
7030,jonstelly,18,0.00042,3870724,89.78632,4311040
7031,joshuabezaleel,18,0.00042,3870742,89.78673,4311040
7032,jpalomaki,18,0.00042,3870760,89.78715,4311040
7033,jrnp7,18,0.00042,3870778,89.78757,4311040
7034,justenwalker,18,0.00042,3870796,89.78799,4311040
7035,kgignatyev-inspur,18,0.00042,3870814,89.78840,4311040
7036,kgtw,18,0.00042,3870832,89.78882,4311040
7037,KimMcMahon,18,0.00042,3870850,89.78924,4311040
7038,KSanthanam,18,0.00042,3870868,89.78966,4311040
7039,kwladyka,18,0.00042,3870886,89.79007,4311040
7040,kwodzynski,18,0.00042,3870904,89.79049,4311040
7041,kychool,18,0.00042,3870922,89.79091,4311040
7042,liggetm,18,0.00042,3870940,89.79133,4311040
7043,liu4480,18,0.00042,3870958,89.79174,4311040
7044,liudalibj,18,0.00042,3870976,89.79216,4311040
7045,looztra,18,0.00042,3870994,89.79258,4311040
7046,lsowen,18,0.00042,3871012,89.79300,4311040
7047,lucj,18,0.00042,3871030,89.79341,4311040
7048,luolanzone,18,0.00042,3871048,89.79383,4311040
7049,lyda,18,0.00042,3871066,89.79425,4311040
7050,majinghe,18,0.00042,3871084,89.79467,4311040
7051,mariusv,18,0.00042,3871102,89.79508,4311040
7052,MarkSRobinson,18,0.00042,3871120,89.79550,4311040
7053,marsavela,18,0.00042,3871138,89.79592,4311040
7054,mathieu-benoit,18,0.00042,3871156,89.79634,4311040
7055,matzew,18,0.00042,3871174,89.79675,4311040
7056,maxb,18,0.00042,3871192,89.79717,4311040
7057,meringu,18,0.00042,3871210,89.79759,4311040
7058,MichaelSp,18,0.00042,3871228,89.79801,4311040
7059,mihnjong,18,0.00042,3871246,89.79842,4311040
7060,mikesimos,18,0.00042,3871264,89.79884,4311040
7061,mikestef9,18,0.00042,3871282,89.79926,4311040
7062,mlycore,18,0.00042,3871300,89.79968,4311040
7063,moensch,18,0.00042,3871318,89.80009,4311040
7064,moustafab,18,0.00042,3871336,89.80051,4311040
7065,mr-salty,18,0.00042,3871354,89.80093,4311040
7066,mshitrit,18,0.00042,3871372,89.80135,4311040
7067,mstarostik,18,0.00042,3871390,89.80176,4311040
7068,nadenf,18,0.00042,3871408,89.80218,4311040
7069,nakamasato,18,0.00042,3871426,89.80260,4311040
7070,ndeloof,18,0.00042,3871444,89.80302,4311040
7071,ngbinh,18,0.00042,3871462,89.80343,4311040
7072,Nick-Triller,18,0.00042,3871480,89.80385,4311040
7073,NickyMateev,18,0.00042,3871498,89.80427,4311040
7074,nicr9,18,0.00042,3871516,89.80469,4311040
7075,nielsbasjes,18,0.00042,3871534,89.80511,4311040
7076,nirroz93,18,0.00042,3871552,89.80552,4311040
7077,npentrel,18,0.00042,3871570,89.80594,4311040
7078,ohbus,18,0.00042,3871588,89.80636,4311040
7079,opowbow,18,0.00042,3871606,89.80678,4311040
7080,pabloguerrero,18,0.00042,3871624,89.80719,4311040
7081,pablokbs,18,0.00042,3871642,89.80761,4311040
7082,Paige49,18,0.00042,3871660,89.80803,4311040
7083,paranoidsp,18,0.00042,3871678,89.80845,4311040
7084,pedrobizzotto,18,0.00042,3871696,89.80886,4311040
7085,pedrosland,18,0.00042,3871714,89.80928,4311040
7086,pengzhisun,18,0.00042,3871732,89.80970,4311040
7087,phemmer,18,0.00042,3871750,89.81012,4311040
7088,photra,18,0.00042,3871768,89.81053,4311040
7089,prashantkalkar,18,0.00042,3871786,89.81095,4311040
7090,prudhvigodithi,18,0.00042,3871804,89.81137,4311040
7091,radkat,18,0.00042,3871822,89.81179,4311040
7092,radu-matei,18,0.00042,3871840,89.81220,4311040
7093,rafaeljesus,18,0.00042,3871858,89.81262,4311040
7094,RafalSkolasinski,18,0.00042,3871876,89.81304,4311040
7095,raisaat,18,0.00042,3871894,89.81346,4311040
7096,rblaine95,18,0.00042,3871912,89.81387,4311040
7097,reinvantveer,18,0.00042,3871930,89.81429,4311040
7098,ricktbaker,18,0.00042,3871948,89.81471,4311040
7099,RijulGulati,18,0.00042,3871966,89.81513,4311040
7100,robotjellyzone,18,0.00042,3871984,89.81554,4311040
7101,rombert,18,0.00042,3872002,89.81596,4311040
7102,ROunofF,18,0.00042,3872020,89.81638,4311040
7103,rskrishnar,18,0.00042,3872038,89.81680,4311040
7104,rubenhak,18,0.00042,3872056,89.81721,4311040
7105,rui5i,18,0.00042,3872074,89.81763,4311040
7106,rushi47,18,0.00042,3872092,89.81805,4311040
7107,sadortun,18,0.00042,3872110,89.81847,4311040
7108,saheienko,18,0.00042,3872128,89.81888,4311040
7109,satishbellapu,18,0.00042,3872146,89.81930,4311040
7110,satoru-takeuchi,18,0.00042,3872164,89.81972,4311040
7111,seankhliao,18,0.00042,3872182,89.82014,4311040
7112,serngawy,18,0.00042,3872200,89.82055,4311040
7113,shashankram,18,0.00042,3872218,89.82097,4311040
7114,shivam-sharma7,18,0.00042,3872236,89.82139,4311040
7115,Silvanoc,18,0.00042,3872254,89.82181,4311040
7116,skoef,18,0.00042,3872272,89.82222,4311040
7117,skyscooby,18,0.00042,3872290,89.82264,4311040
7118,somejfn,18,0.00042,3872308,89.82306,4311040
7119,spiddy,18,0.00042,3872326,89.82348,4311040
7120,steffengy,18,0.00042,3872344,89.82389,4311040
7121,steveizzle,18,0.00042,3872362,89.82431,4311040
7122,steven166,18,0.00042,3872380,89.82473,4311040
7123,SunWeicheng0001,18,0.00042,3872398,89.82515,4311040
7124,swestcott,18,0.00042,3872416,89.82556,4311040
7125,tedmiston,18,0.00042,3872434,89.82598,4311040
7126,teozkr,18,0.00042,3872452,89.82640,4311040
7127,thanos1983,18,0.00042,3872470,89.82682,4311040
7128,thickforest,18,0.00042,3872488,89.82723,4311040
7129,tianon,18,0.00042,3872506,89.82765,4311040
7130,TimJones,18,0.00042,3872524,89.82807,4311040
7131,toricls,18,0.00042,3872542,89.82849,4311040
7132,trnl,18,0.00042,3872560,89.82890,4311040
7133,tuapuikia,18,0.00042,3872578,89.82932,4311040
7134,u2mejc,18,0.00042,3872596,89.82974,4311040
7135,utkarsh2102,18,0.00042,3872614,89.83016,4311040
7136,vagababov,18,0.00042,3872632,89.83057,4311040
7137,vbalazs,18,0.00042,3872650,89.83099,4311040
7138,viniciussaturnino,18,0.00042,3872668,89.83141,4311040
7139,vishleshpatel,18,0.00042,3872686,89.83183,4311040
7140,viveksahu26,18,0.00042,3872704,89.83224,4311040
7141,vroetman,18,0.00042,3872722,89.83266,4311040
7142,vuil,18,0.00042,3872740,89.83308,4311040
7143,waldman,18,0.00042,3872758,89.83350,4311040
7144,wanghonglei5181,18,0.00042,3872776,89.83391,4311040
7145,wedsonaf,18,0.00042,3872794,89.83433,4311040
7146,weihanglo,18,0.00042,3872812,89.83475,4311040
7147,withlin,18,0.00042,3872830,89.83517,4311040
7148,wswcfan,18,0.00042,3872848,89.83558,4311040
7149,xclud,18,0.00042,3872866,89.83600,4311040
7150,xingfeng1234,18,0.00042,3872884,89.83642,4311040
7151,xulike666,18,0.00042,3872902,89.83684,4311040
7152,YanTingLittleCute,18,0.00042,3872920,89.83726,4311040
7153,yaron-idan,18,0.00042,3872938,89.83767,4311040
7154,yuhongwex,18,0.00042,3872956,89.83809,4311040
7155,4c74356b41,17,0.00039,3872973,89.83848,4311040
7156,aanoaa,17,0.00039,3872990,89.83888,4311040
7157,aaronmell,17,0.00039,3873007,89.83927,4311040
7158,abdoo,17,0.00039,3873024,89.83967,4311040
7159,AdminTurnedDevOps,17,0.00039,3873041,89.84006,4311040
7160,agustincastanio,17,0.00039,3873058,89.84046,4311040
7161,Akshit42-hue,17,0.00039,3873075,89.84085,4311040
7162,alcohol,17,0.00039,3873092,89.84124,4311040
7163,alessbn,17,0.00039,3873109,89.84164,4311040
7164,alexanderKhaustov,17,0.00039,3873126,89.84203,4311040
7165,alexanderkjeldaas,17,0.00039,3873143,89.84243,4311040
7166,AlexeyKupershtokh,17,0.00039,3873160,89.84282,4311040
7167,AlexShemeshWix,17,0.00039,3873177,89.84322,4311040
7168,aliakbar-hemmati,17,0.00039,3873194,89.84361,4311040
7169,alicefr,17,0.00039,3873211,89.84401,4311040
7170,amontalban,17,0.00039,3873228,89.84440,4311040
7171,anamika-avinash,17,0.00039,3873245,89.84479,4311040
7172,AnatolyRugalev,17,0.00039,3873262,89.84519,4311040
7173,andelhie,17,0.00039,3873279,89.84558,4311040
7174,andrebraitc,17,0.00039,3873296,89.84598,4311040
7175,antcs,17,0.00039,3873313,89.84637,4311040
7176,aravindputrevu,17,0.00039,3873330,89.84677,4311040
7177,arielvinas,17,0.00039,3873347,89.84716,4311040
7178,ariskou,17,0.00039,3873364,89.84755,4311040
7179,arturobrzut,17,0.00039,3873381,89.84795,4311040
7180,arunraman,17,0.00039,3873398,89.84834,4311040
7181,AtkinsChang,17,0.00039,3873415,89.84874,4311040
7182,atzannes,17,0.00039,3873432,89.84913,4311040
7183,autostatic,17,0.00039,3873449,89.84953,4311040
7184,axinojolais,17,0.00039,3873466,89.84992,4311040
7185,balusarakesh,17,0.00039,3873483,89.85031,4311040
7186,barnettZQG,17,0.00039,3873500,89.85071,4311040
7187,bartosh,17,0.00039,3873517,89.85110,4311040
7188,bassco,17,0.00039,3873534,89.85150,4311040
7189,benlangfeld,17,0.00039,3873551,89.85189,4311040
7190,bjornswift,17,0.00039,3873568,89.85229,4311040
7191,bluebrown,17,0.00039,3873585,89.85268,4311040
7192,bobh66,17,0.00039,3873602,89.85307,4311040
7193,bobintornado,17,0.00039,3873619,89.85347,4311040
7194,boredabdel,17,0.00039,3873636,89.85386,4311040
7195,boz,17,0.00039,3873653,89.85426,4311040
7196,brennerm,17,0.00039,3873670,89.85465,4311040
7197,brian-avery,17,0.00039,3873687,89.85505,4311040
7198,brianredbeard,17,0.00039,3873704,89.85544,4311040
7199,CandiedCode,17,0.00039,3873721,89.85584,4311040
7200,ChakshuGupta13,17,0.00039,3873738,89.85623,4311040
7201,chaten,17,0.00039,3873755,89.85662,4311040
7202,chenqz1987,17,0.00039,3873772,89.85702,4311040
7203,CheyiLin,17,0.00039,3873789,89.85741,4311040
7204,chowmean,17,0.00039,3873806,89.85781,4311040
7205,cjheppell,17,0.00039,3873823,89.85820,4311040
7206,cjlarose,17,0.00039,3873840,89.85860,4311040
7207,cmosgh,17,0.00039,3873857,89.85899,4311040
7208,colek42,17,0.00039,3873874,89.85938,4311040
7209,corrieb,17,0.00039,3873891,89.85978,4311040
7210,cwilkers,17,0.00039,3873908,89.86017,4311040
7211,damienleger,17,0.00039,3873925,89.86057,4311040
7212,DanielMSchmidt,17,0.00039,3873942,89.86096,4311040
7213,datianshi,17,0.00039,3873959,89.86136,4311040
7214,daurnimator,17,0.00039,3873976,89.86175,4311040
7215,davidblum,17,0.00039,3873993,89.86214,4311040
7216,DevasiaThomas,17,0.00039,3874010,89.86254,4311040
7217,devincd,17,0.00039,3874027,89.86293,4311040
7218,digitalcoyote,17,0.00039,3874044,89.86333,4311040
7219,dmitry-irtegov,17,0.00039,3874061,89.86372,4311040
7220,dmitrytokarev,17,0.00039,3874078,89.86412,4311040
7221,dmoonskim,17,0.00039,3874095,89.86451,4311040
7222,dprabhua,17,0.00039,3874112,89.86490,4311040
7223,dubuc,17,0.00039,3874129,89.86530,4311040
7224,dumlutimuralp,17,0.00039,3874146,89.86569,4311040
7225,Duologic,17,0.00039,3874163,89.86609,4311040
7226,dvianello,17,0.00039,3874180,89.86648,4311040
7227,eahydra,17,0.00039,3874197,89.86688,4311040
7228,erikgrinaker,17,0.00039,3874214,89.86727,4311040
7229,ermitovski,17,0.00039,3874231,89.86767,4311040
7230,evandbrown,17,0.00039,3874248,89.86806,4311040
7231,Fabian-K,17,0.00039,3874265,89.86845,4311040
7232,falzm,17,0.00039,3874282,89.86885,4311040
7233,fediazgon,17,0.00039,3874299,89.86924,4311040
7234,felixbuenemann,17,0.00039,3874316,89.86964,4311040
7235,Fizzadar,17,0.00039,3874333,89.87003,4311040
7236,flavio,17,0.00039,3874350,89.87043,4311040
7237,forkbomber,17,0.00039,3874367,89.87082,4311040
7238,ganeshniyer,17,0.00039,3874384,89.87121,4311040
7239,git001,17,0.00039,3874401,89.87161,4311040
7240,gitvinit,17,0.00039,3874418,89.87200,4311040
7241,grv231,17,0.00039,3874435,89.87240,4311040
7242,hausdorff,17,0.00039,3874452,89.87279,4311040
7243,Heena-PyCloud,17,0.00039,3874469,89.87319,4311040
7244,hemanthmalla,17,0.00039,3874486,89.87358,4311040
7245,highb,17,0.00039,3874503,89.87397,4311040
7246,hiroshi,17,0.00039,3874520,89.87437,4311040
7247,hossainemruz,17,0.00039,3874537,89.87476,4311040
7248,huweihuang,17,0.00039,3874554,89.87516,4311040
7249,hvnsweeting,17,0.00039,3874571,89.87555,4311040
7250,hwinkel,17,0.00039,3874588,89.87595,4311040
7251,hyder,17,0.00039,3874605,89.87634,4311040
7252,invino4,17,0.00039,3874622,89.87674,4311040
7253,it-praktyk,17,0.00039,3874639,89.87713,4311040
7254,JakubJecminek,17,0.00039,3874656,89.87752,4311040
7255,janitha09,17,0.00039,3874673,89.87792,4311040
7256,jcvenegas,17,0.00039,3874690,89.87831,4311040
7257,jefferai,17,0.00039,3874707,89.87871,4311040
7258,jeffmhastings,17,0.00039,3874724,89.87910,4311040
7259,jessestuart,17,0.00039,3874741,89.87950,4311040
7260,jingai-db,17,0.00039,3874758,89.87989,4311040
7261,jmickey,17,0.00039,3874775,89.88028,4311040
7262,joerocklin,17,0.00039,3874792,89.88068,4311040
7263,john-delivuk,17,0.00039,3874809,89.88107,4311040
7264,jonlangemak,17,0.00039,3874826,89.88147,4311040
7265,juchem,17,0.00039,3874843,89.88186,4311040
7266,july2993,17,0.00039,3874860,89.88226,4311040
7267,kevin85421,17,0.00039,3874877,89.88265,4311040
7268,kigawas,17,0.00039,3874894,89.88304,4311040
7269,kiranchavala,17,0.00039,3874911,89.88344,4311040
7270,kkirsche,17,0.00039,3874928,89.88383,4311040
7271,kppullin,17,0.00039,3874945,89.88423,4311040
7272,krichter722,17,0.00039,3874962,89.88462,4311040
7273,kron4eg,17,0.00039,3874979,89.88502,4311040
7274,KushalBeniwal,17,0.00039,3874996,89.88541,4311040
7275,laimison,17,0.00039,3875013,89.88580,4311040
7276,Lakshya8066,17,0.00039,3875030,89.88620,4311040
7277,lboix,17,0.00039,3875047,89.88659,4311040
7278,lelenanam,17,0.00039,3875064,89.88699,4311040
7279,leosunmo,17,0.00039,3875081,89.88738,4311040
7280,lhw,17,0.00039,3875098,89.88778,4311040
7281,LinAnt,17,0.00039,3875115,89.88817,4311040
7282,LinEricYang,17,0.00039,3875132,89.88857,4311040
7283,lishaokai1995,17,0.00039,3875149,89.88896,4311040
7284,literalice,17,0.00039,3875166,89.88935,4311040
7285,lizebang,17,0.00039,3875183,89.88975,4311040
7286,MalcolmSanders,17,0.00039,3875200,89.89014,4311040
7287,MalteJ,17,0.00039,3875217,89.89054,4311040
7288,mamoit,17,0.00039,3875234,89.89093,4311040
7289,marcofranssen,17,0.00039,3875251,89.89133,4311040
7290,Markbnj,17,0.00039,3875268,89.89172,4311040
7291,martinhoefling,17,0.00039,3875285,89.89211,4311040
7292,masaeedu,17,0.00039,3875302,89.89251,4311040
7293,massenz,17,0.00039,3875319,89.89290,4311040
7294,mattlqx,17,0.00039,3875336,89.89330,4311040
7295,matt-potter,17,0.00039,3875353,89.89369,4311040
7296,mattthias,17,0.00039,3875370,89.89409,4311040
7297,mccricardo,17,0.00039,3875387,89.89448,4311040
7298,mcwarman,17,0.00039,3875404,89.89487,4311040
7299,mellowplace,17,0.00039,3875421,89.89527,4311040
7300,MiaoZhou,17,0.00039,3875438,89.89566,4311040
7301,michaelbannister,17,0.00039,3875455,89.89606,4311040
7302,MichaelWasher,17,0.00039,3875472,89.89645,4311040
7303,MichielDeMey,17,0.00039,3875489,89.89685,4311040
7304,mikefaille,17,0.00039,3875506,89.89724,4311040
7305,mikn,17,0.00039,3875523,89.89763,4311040
7306,minjungsung1994,17,0.00039,3875540,89.89803,4311040
7307,MisterTimn,17,0.00039,3875557,89.89842,4311040
7308,morhook,17,0.00039,3875574,89.89882,4311040
7309,MrAmbiG,17,0.00039,3875591,89.89921,4311040
7310,mshahat,17,0.00039,3875608,89.89961,4311040
7311,mtsr,17,0.00039,3875625,89.90000,4311040
7312,Multiply,17,0.00039,3875642,89.90040,4311040
7313,mvasilenko,17,0.00039,3875659,89.90079,4311040
7314,mwitkow,17,0.00039,3875676,89.90118,4311040
7315,nathanleclaire,17,0.00039,3875693,89.90158,4311040
7316,nefelim4ag,17,0.00039,3875710,89.90197,4311040
7317,nick-oconnor,17,0.00039,3875727,89.90237,4311040
7318,nikolay,17,0.00039,3875744,89.90276,4311040
7319,nirmoy,17,0.00039,3875761,89.90316,4311040
7320,OguzPastirmaci,17,0.00039,3875778,89.90355,4311040
7321,omerh,17,0.00039,3875795,89.90394,4311040
7322,OneCricketeer,17,0.00039,3875812,89.90434,4311040
7323,palasanu,17,0.00039,3875829,89.90473,4311040
7324,perhapszzy,17,0.00039,3875846,89.90513,4311040
7325,prabhu43,17,0.00039,3875863,89.90552,4311040
7326,prashantokochavara,17,0.00039,3875880,89.90592,4311040
7327,ptemmer,17,0.00039,3875897,89.90631,4311040
7328,pwillie,17,0.00039,3875914,89.90670,4311040
7329,qinguoan,17,0.00039,3875931,89.90710,4311040
7330,qwang1,17,0.00039,3875948,89.90749,4311040
7331,Raboo,17,0.00039,3875965,89.90789,4311040
7332,rabun788,17,0.00039,3875982,89.90828,4311040
7333,RafaelMoreira1180778,17,0.00039,3875999,89.90868,4311040
7334,rafagsiqueira,17,0.00039,3876016,89.90907,4311040
7335,RajGM,17,0.00039,3876033,89.90947,4311040
7336,rgunaseknokia,17,0.00039,3876050,89.90986,4311040
7337,rhummelmose,17,0.00039,3876067,89.91025,4311040
7338,richerve,17,0.00039,3876084,89.91065,4311040
7339,rocktavious,17,0.00039,3876101,89.91104,4311040
7340,rombie,17,0.00039,3876118,89.91144,4311040
7341,rosskusler,17,0.00039,3876135,89.91183,4311040
7342,rtmie,17,0.00039,3876152,89.91223,4311040
7343,rynowak,17,0.00039,3876169,89.91262,4311040
7344,salanki,17,0.00039,3876186,89.91301,4311040
7345,salva-gglez,17,0.00039,3876203,89.91341,4311040
7346,sanderploegsma,17,0.00039,3876220,89.91380,4311040
7347,santinoncs,17,0.00039,3876237,89.91420,4311040
7348,scher200,17,0.00039,3876254,89.91459,4311040
7349,scottstensland,17,0.00039,3876271,89.91499,4311040
7350,SenXuDC,17,0.00039,3876288,89.91538,4311040
7351,sfc-gh-jelsesiy,17,0.00039,3876305,89.91577,4311040
7352,shaoxt,17,0.00039,3876322,89.91617,4311040
7353,Shpectator,17,0.00039,3876339,89.91656,4311040
7354,ShubhamTatvamasi,17,0.00039,3876356,89.91696,4311040
7355,sidharta-s,17,0.00039,3876373,89.91735,4311040
7356,SimenB,17,0.00039,3876390,89.91775,4311040
7357,simonklb,17,0.00039,3876407,89.91814,4311040
7358,sonant,17,0.00039,3876424,89.91853,4311040
7359,spangenberg,17,0.00039,3876441,89.91893,4311040
7360,spinus,17,0.00039,3876458,89.91932,4311040
7361,steeling,17,0.00039,3876475,89.91972,4311040
7362,Steniaz,17,0.00039,3876492,89.92011,4311040
7363,stepyu,17,0.00039,3876509,89.92051,4311040
7364,sthaha,17,0.00039,3876526,89.92090,4311040
7365,StianOvrevage,17,0.00039,3876543,89.92130,4311040
7366,Szymongib,17,0.00039,3876560,89.92169,4311040
7367,ta1meng,17,0.00039,3876577,89.92208,4311040
7368,thegreenbear,17,0.00039,3876594,89.92248,4311040
7369,theobarberbany,17,0.00039,3876611,89.92287,4311040
7370,therealmitchconnors,17,0.00039,3876628,89.92327,4311040
7371,thoraxe,17,0.00039,3876645,89.92366,4311040
7372,tiewei,17,0.00039,3876662,89.92406,4311040
7373,tliron,17,0.00039,3876679,89.92445,4311040
7374,tomaszkiewicz,17,0.00039,3876696,89.92484,4311040
7375,Trane9991,17,0.00039,3876713,89.92524,4311040
7376,travisn,17,0.00039,3876730,89.92563,4311040
7377,tsloughter,17,0.00039,3876747,89.92603,4311040
7378,twilfong,17,0.00039,3876764,89.92642,4311040
7379,Typositoire,17,0.00039,3876781,89.92682,4311040
7380,UlaganathanNamachivayam,17,0.00039,3876798,89.92721,4311040
7381,utkuozdemir,17,0.00039,3876815,89.92760,4311040
7382,vadimInshakov,17,0.00039,3876832,89.92800,4311040
7383,vaibhavsingh97,17,0.00039,3876849,89.92839,4311040
7384,vaibhavsood,17,0.00039,3876866,89.92879,4311040
7385,victornoel,17,0.00039,3876883,89.92918,4311040
7386,vin,17,0.00039,3876900,89.92958,4311040
7387,vivekzhere,17,0.00039,3876917,89.92997,4311040
7388,vivian-xu,17,0.00039,3876934,89.93036,4311040
7389,walkley,17,0.00039,3876951,89.93076,4311040
7390,wattli,17,0.00039,3876968,89.93115,4311040
7391,whithajess,17,0.00039,3876985,89.93155,4311040
7392,Xieql,17,0.00039,3877002,89.93194,4311040
7393,xinyanmsft,17,0.00039,3877019,89.93234,4311040
7394,zwtop,17,0.00039,3877036,89.93273,4311040
7395,aanandr,16,0.00037,3877052,89.93310,4311040
7396,a-berahman,16,0.00037,3877068,89.93347,4311040
7397,abhishekjiitr,16,0.00037,3877084,89.93384,4311040
7398,adam-sandor,16,0.00037,3877100,89.93422,4311040
7399,adilfulara,16,0.00037,3877116,89.93459,4311040
7400,alekc,16,0.00037,3877132,89.93496,4311040
7401,alexpilotti,16,0.00037,3877148,89.93533,4311040
7402,alexxa,16,0.00037,3877164,89.93570,4311040
7403,allir,16,0.00037,3877180,89.93607,4311040
7404,amlinux,16,0.00037,3877196,89.93644,4311040
7405,Anil-YadavK8s,16,0.00037,3877212,89.93681,4311040
7406,anmolbabu,16,0.00037,3877228,89.93718,4311040
7407,anothertobi,16,0.00037,3877244,89.93756,4311040
7408,Anuj2512,16,0.00037,3877260,89.93793,4311040
7409,aodj,16,0.00037,3877276,89.93830,4311040
7410,Ascendance,16,0.00037,3877292,89.93867,4311040
7411,ashrayjain,16,0.00037,3877308,89.93904,4311040
7412,atsuky,16,0.00037,3877324,89.93941,4311040
7413,avielb,16,0.00037,3877340,89.93978,4311040
7414,bechampion,16,0.00037,3877356,89.94015,4311040
7415,behos,16,0.00037,3877372,89.94052,4311040
7416,benoitf,16,0.00037,3877388,89.94090,4311040
7417,bill-warshaw,16,0.00037,3877404,89.94127,4311040
7418,bingosummer,16,0.00037,3877420,89.94164,4311040
7419,Binyang2014,16,0.00037,3877436,89.94201,4311040
7420,bittner,16,0.00037,3877452,89.94238,4311040
7421,bottkars,16,0.00037,3877468,89.94275,4311040
7422,brokenjacobs,16,0.00037,3877484,89.94312,4311040
7423,bronislav,16,0.00037,3877500,89.94349,4311040
7424,camper42,16,0.00037,3877516,89.94387,4311040
7425,Charlie17Li,16,0.00037,3877532,89.94424,4311040
7426,charly37,16,0.00037,3877548,89.94461,4311040
7427,chiehmin,16,0.00037,3877564,89.94498,4311040
7428,choffmeister,16,0.00037,3877580,89.94535,4311040
7429,ciis0,16,0.00037,3877596,89.94572,4311040
7430,clearnicki,16,0.00037,3877612,89.94609,4311040
7431,cmattoon,16,0.00037,3877628,89.94646,4311040
7432,cohadar,16,0.00037,3877644,89.94683,4311040
7433,commixon,16,0.00037,3877660,89.94721,4311040
7434,coutinhop,16,0.00037,3877676,89.94758,4311040
7435,CristianPop,16,0.00037,3877692,89.94795,4311040
7436,cu12,16,0.00037,3877708,89.94832,4311040
7437,dalgibbard,16,0.00037,3877724,89.94869,4311040
7438,daniel-yavorovich,16,0.00037,3877740,89.94906,4311040
7439,danil-smirnov,16,0.00037,3877756,89.94943,4311040
7440,davidquarles,16,0.00037,3877772,89.94980,4311040
7441,dbirks,16,0.00037,3877788,89.95017,4311040
7442,deepakm-ntnx,16,0.00037,3877804,89.95055,4311040
7443,denist-huma,16,0.00037,3877820,89.95092,4311040
7444,desek,16,0.00037,3877836,89.95129,4311040
7445,Devin-Holland,16,0.00037,3877852,89.95166,4311040
7446,dfateyev,16,0.00037,3877868,89.95203,4311040
7447,dictvm,16,0.00037,3877884,89.95240,4311040
7448,dimpavloff,16,0.00037,3877900,89.95277,4311040
7449,dineshbhor,16,0.00037,3877916,89.95314,4311040
7450,dkalleg,16,0.00037,3877932,89.95351,4311040
7451,dkorzuno,16,0.00037,3877948,89.95389,4311040
7452,dkrzyszczyk,16,0.00037,3877964,89.95426,4311040
7453,dntczdx,16,0.00037,3877980,89.95463,4311040
7454,Docteur-RS,16,0.00037,3877996,89.95500,4311040
7455,dradetsky,16,0.00037,3878012,89.95537,4311040
7456,drzero42,16,0.00037,3878028,89.95574,4311040
7457,ds-ms,16,0.00037,3878044,89.95611,4311040
7458,dwatrous,16,0.00037,3878060,89.95648,4311040
7459,ecthelion77,16,0.00037,3878076,89.95685,4311040
7460,electroma,16,0.00037,3878092,89.95723,4311040
7461,elmariofredo,16,0.00037,3878108,89.95760,4311040
7462,emmayang,16,0.00037,3878124,89.95797,4311040
7463,enoodle,16,0.00037,3878140,89.95834,4311040
7464,farmdawgnation,16,0.00037,3878156,89.95871,4311040
7465,farmer-hutao,16,0.00037,3878172,89.95908,4311040
7466,felix0080,16,0.00037,3878188,89.95945,4311040
7467,Frassle,16,0.00037,3878204,89.95982,4311040
7468,fredr,16,0.00037,3878220,89.96020,4311040
7469,fshot,16,0.00037,3878236,89.96057,4311040
7470,gantanikhilraj,16,0.00037,3878252,89.96094,4311040
7471,gautamdivgi,16,0.00037,3878268,89.96131,4311040
7472,glennslaven,16,0.00037,3878284,89.96168,4311040
7473,gree-gorey,16,0.00037,3878300,89.96205,4311040
7474,greenstatic,16,0.00037,3878316,89.96242,4311040
7475,gregbkr,16,0.00037,3878332,89.96279,4311040
7476,guillomep,16,0.00037,3878348,89.96316,4311040
7477,halmai,16,0.00037,3878364,89.96354,4311040
7478,hazim1093,16,0.00037,3878380,89.96391,4311040
7479,helinbo2015,16,0.00037,3878396,89.96428,4311040
7480,hiscal2015,16,0.00037,3878412,89.96465,4311040
7481,honi,16,0.00037,3878428,89.96502,4311040
7482,hreidar,16,0.00037,3878444,89.96539,4311040
7483,ianmiell,16,0.00037,3878460,89.96576,4311040
7484,icygalz,16,0.00037,3878476,89.96613,4311040
7485,imduffy15,16,0.00037,3878492,89.96650,4311040
7486,inetkiller,16,0.00037,3878508,89.96688,4311040
7487,infra-monkey,16,0.00037,3878524,89.96725,4311040
7488,iphutch,16,0.00037,3878540,89.96762,4311040
7489,IRCody,16,0.00037,3878556,89.96799,4311040
7490,jakerobb,16,0.00037,3878572,89.96836,4311040
7491,jakon89,16,0.00037,3878588,89.96873,4311040
7492,jason-kane,16,0.00037,3878604,89.96910,4311040
7493,jasonliu747,16,0.00037,3878620,89.96947,4311040
7494,JasonvanBrackel,16,0.00037,3878636,89.96984,4311040
7495,jcstanaway,16,0.00037,3878652,89.97022,4311040
7496,jdziat,16,0.00037,3878668,89.97059,4311040
7497,joerg84,16,0.00037,3878684,89.97096,4311040
7498,joeycumines,16,0.00037,3878700,89.97133,4311040
7499,JohnStrunk,16,0.00037,3878716,89.97170,4311040
7500,JonathanLachapelle,16,0.00037,3878732,89.97207,4311040
7501,joonathan,16,0.00037,3878748,89.97244,4311040
7502,julian7,16,0.00037,3878764,89.97281,4311040
7503,juniorz,16,0.00037,3878780,89.97319,4311040
7504,kaladaOpuiyo,16,0.00037,3878796,89.97356,4311040
7505,kamsz,16,0.00037,3878812,89.97393,4311040
7506,KashishLakhara04,16,0.00037,3878828,89.97430,4311040
7507,Kenblair1226,16,0.00037,3878844,89.97467,4311040
7508,keperry,16,0.00037,3878860,89.97504,4311040
7509,kerneljack,16,0.00037,3878876,89.97541,4311040
7510,KiranAminPanjwani,16,0.00037,3878892,89.97578,4311040
7511,klihub,16,0.00037,3878908,89.97615,4311040
7512,klustria,16,0.00037,3878924,89.97653,4311040
7513,koudaiii,16,0.00037,3878940,89.97690,4311040
7514,krasi-georgiev,16,0.00037,3878956,89.97727,4311040
7515,ktateish,16,0.00037,3878972,89.97764,4311040
7516,kumaravanish,16,0.00037,3878988,89.97801,4311040
7517,kylegoch,16,0.00037,3879004,89.97838,4311040
7518,lenalebt,16,0.00037,3879020,89.97875,4311040
7519,lmm,16,0.00037,3879036,89.97912,4311040
7520,lmq1999,16,0.00037,3879052,89.97949,4311040
7521,lostick,16,0.00037,3879068,89.97987,4311040
7522,ltellesfl,16,0.00037,3879084,89.98024,4311040
7523,lucab85,16,0.00037,3879100,89.98061,4311040
7524,madddi,16,0.00037,3879116,89.98098,4311040
7525,marcincuber,16,0.00037,3879132,89.98135,4311040
7526,marco-jantke,16,0.00037,3879148,89.98172,4311040
7527,masroorhasan,16,0.00037,3879164,89.98209,4311040
7528,Matei207,16,0.00037,3879180,89.98246,4311040
7529,mathieuherbert,16,0.00037,3879196,89.98283,4311040
7530,mcastelino,16,0.00037,3879212,89.98321,4311040
7531,metachris,16,0.00037,3879228,89.98358,4311040
7532,metasim,16,0.00037,3879244,89.98395,4311040
7533,mgiessing,16,0.00037,3879260,89.98432,4311040
7534,mingzhaodotname,16,0.00037,3879276,89.98469,4311040
7535,mistydemeo,16,0.00037,3879292,89.98506,4311040
7536,mkorejo,16,0.00037,3879308,89.98543,4311040
7537,mnuttall,16,0.00037,3879324,89.98580,4311040
7538,mschurenko,16,0.00037,3879340,89.98618,4311040
7539,mwhittington21,16,0.00037,3879356,89.98655,4311040
7540,myhro,16,0.00037,3879372,89.98692,4311040
7541,nambrot,16,0.00037,3879388,89.98729,4311040
7542,NaraVen,16,0.00037,3879404,89.98766,4311040
7543,NargiT,16,0.00037,3879420,89.98803,4311040
7544,nbjohnson,16,0.00037,3879436,89.98840,4311040
7545,nfnt,16,0.00037,3879452,89.98877,4311040
7546,nhooyr,16,0.00037,3879468,89.98914,4311040
7547,nkubala,16,0.00037,3879484,89.98952,4311040
7548,nyarly,16,0.00037,3879500,89.98989,4311040
7549,oshalygin,16,0.00037,3879516,89.99026,4311040
7550,osxi,16,0.00037,3879532,89.99063,4311040
7551,owenthereal,16,0.00037,3879548,89.99100,4311040
7552,papiveron,16,0.00037,3879564,89.99137,4311040
7553,pbecotte,16,0.00037,3879580,89.99174,4311040
7554,pblaas,16,0.00037,3879596,89.99211,4311040
7555,pepov,16,0.00037,3879612,89.99248,4311040
7556,perryao,16,0.00037,3879628,89.99286,4311040
7557,pestebogdan,16,0.00037,3879644,89.99323,4311040
7558,pfremm,16,0.00037,3879660,89.99360,4311040
7559,Phanindra48,16,0.00037,3879676,89.99397,4311040
7560,philipbjorge,16,0.00037,3879692,89.99434,4311040
7561,pluradj,16,0.00037,3879708,89.99471,4311040
7562,pnegahdar,16,0.00037,3879724,89.99508,4311040
7563,pokerfaceSad,16,0.00037,3879740,89.99545,4311040
7564,poussa,16,0.00037,3879756,89.99582,4311040
7565,pradeepnnv,16,0.00037,3879772,89.99620,4311040
7566,pragyamehta,16,0.00037,3879788,89.99657,4311040
7567,pramchan,16,0.00037,3879804,89.99694,4311040
7568,pratikmota,16,0.00037,3879820,89.99731,4311040
7569,R3DRUN3,16,0.00037,3879836,89.99768,4311040
7570,rayfoss,16,0.00037,3879852,89.99805,4311040
7571,Revolution1,16,0.00037,3879868,89.99842,4311040
7572,ricardomaraschini,16,0.00037,3879884,89.99879,4311040
7573,Rio,16,0.00037,3879900,89.99916,4311040
7574,robbyt,16,0.00037,3879916,89.99954,4311040
7575,rojer,16,0.00037,3879932,89.99991,4311040
7576,ruanxin,16,0.00037,3879948,90.00028,4311040
7577,rudeigerc,16,0.00037,3879964,90.00065,4311040
7578,sailingwithoutwind,16,0.00037,3879980,90.00102,4311040
7579,sandflee,16,0.00037,3879996,90.00139,4311040
7580,sanketjpatel,16,0.00037,3880012,90.00176,4311040
7581,SchwarzM,16,0.00037,3880028,90.00213,4311040
7582,seunghunee,16,0.00037,3880044,90.00251,4311040
7583,sgielen,16,0.00037,3880060,90.00288,4311040
7584,SharpEdgeMarshall,16,0.00037,3880076,90.00325,4311040
7585,shatil,16,0.00037,3880092,90.00362,4311040
7586,Shubh28698,16,0.00037,3880108,90.00399,4311040
7587,SihengCui,16,0.00037,3880124,90.00436,4311040
7588,siwyd,16,0.00037,3880140,90.00473,4311040
7589,skdwriting,16,0.00037,3880156,90.00510,4311040
7590,slaws,16,0.00037,3880172,90.00547,4311040
7591,smukherj1,16,0.00037,3880188,90.00585,4311040
7592,SpencerBrown,16,0.00037,3880204,90.00622,4311040
7593,srinivasev,16,0.00037,3880220,90.00659,4311040
7594,srueg,16,0.00037,3880236,90.00696,4311040
7595,st4nson,16,0.00037,3880252,90.00733,4311040
7596,steinybot,16,0.00037,3880268,90.00770,4311040
7597,stephen-dahl,16,0.00037,3880284,90.00807,4311040
7598,stevenjm,16,0.00037,3880300,90.00844,4311040
7599,strideynet,16,0.00037,3880316,90.00881,4311040
7600,strugglingyouth,16,0.00037,3880332,90.00919,4311040
7601,Szetty,16,0.00037,3880348,90.00956,4311040
7602,tcnt,16,0.00037,3880364,90.00993,4311040
7603,theatrus,16,0.00037,3880380,90.01030,4311040
7604,tiurikov,16,0.00037,3880396,90.01067,4311040
7605,tnguyen-rh,16,0.00037,3880412,90.01104,4311040
7606,tombenner,16,0.00037,3880428,90.01141,4311040
7607,tomberget,16,0.00037,3880444,90.01178,4311040
7608,tomxor,16,0.00037,3880460,90.01215,4311040
7609,tsl0922,16,0.00037,3880476,90.01253,4311040
7610,tvs,16,0.00037,3880492,90.01290,4311040
7611,tvvignesh,16,0.00037,3880508,90.01327,4311040
7612,uromahn,16,0.00037,3880524,90.01364,4311040
7613,utkarsh-pro,16,0.00037,3880540,90.01401,4311040
7614,Vad1mo,16,0.00037,3880556,90.01438,4311040
7615,vaijab,16,0.00037,3880572,90.01475,4311040
7616,valdisrigdon,16,0.00037,3880588,90.01512,4311040
7617,valentin-krasontovitsch,16,0.00037,3880604,90.01550,4311040
7618,vgramer,16,0.00037,3880620,90.01587,4311040
7619,victortrac,16,0.00037,3880636,90.01624,4311040
7620,vitalyzhakov,16,0.00037,3880652,90.01661,4311040
7621,vladikr,16,0.00037,3880668,90.01698,4311040
7622,wanghanlin,16,0.00037,3880684,90.01735,4311040
7623,wangxin311,16,0.00037,3880700,90.01772,4311040
7624,wrfly,16,0.00037,3880716,90.01809,4311040
7625,xakraz,16,0.00037,3880732,90.01846,4311040
7626,xint6,16,0.00037,3880748,90.01884,4311040
7627,xtineskim,16,0.00037,3880764,90.01921,4311040
7628,xUnholy,16,0.00037,3880780,90.01958,4311040
7629,yktsubo,16,0.00037,3880796,90.01995,4311040
7630,yogeswaran,16,0.00037,3880812,90.02032,4311040
7631,yolo3301,16,0.00037,3880828,90.02069,4311040
7632,zachpuck,16,0.00037,3880844,90.02106,4311040
7633,zeronone,16,0.00037,3880860,90.02143,4311040
7634,zhangdb-git,16,0.00037,3880876,90.02180,4311040
7635,zhougw001,16,0.00037,3880892,90.02218,4311040
7636,zhouhao3,16,0.00037,3880908,90.02255,4311040
7637,zhsj,16,0.00037,3880924,90.02292,4311040
7638,zoumo,16,0.00037,3880940,90.02329,4311040
7639,zqzzq,16,0.00037,3880956,90.02366,4311040
7640,zrss,16,0.00037,3880972,90.02403,4311040
7641,zuquan-song,16,0.00037,3880988,90.02440,4311040
7642,zzxwill,16,0.00037,3881004,90.02477,4311040
7643,0robustus1,15,0.00035,3881019,90.02512,4311040
7644,3cky,15,0.00035,3881034,90.02547,4311040
7645,a1dutch,15,0.00035,3881049,90.02582,4311040
7646,abessifi,15,0.00035,3881064,90.02617,4311040
7647,abuehrle,15,0.00035,3881079,90.02651,4311040
7648,ace-n,15,0.00035,3881094,90.02686,4311040
7649,achetronic,15,0.00035,3881109,90.02721,4311040
7650,achiverram28,15,0.00035,3881124,90.02756,4311040
7651,aclevername,15,0.00035,3881139,90.02791,4311040
7652,adiri,15,0.00035,3881154,90.02825,4311040
7653,adjackura,15,0.00035,3881169,90.02860,4311040
7654,adrianchifor,15,0.00035,3881184,90.02895,4311040
7655,adyada,15,0.00035,3881199,90.02930,4311040
7656,aleerizw,15,0.00035,3881214,90.02964,4311040
7657,AlexB138,15,0.00035,3881229,90.02999,4311040
7658,alexkreidler,15,0.00035,3881244,90.03034,4311040
7659,aliartiza75,15,0.00035,3881259,90.03069,4311040
7660,amitpd,15,0.00035,3881274,90.03104,4311040
7661,AmoVanB,15,0.00035,3881289,90.03138,4311040
7662,anastaruno,15,0.00035,3881304,90.03173,4311040
7663,andreadecorte,15,0.00035,3881319,90.03208,4311040
7664,andylibrian,15,0.00035,3881334,90.03243,4311040
7665,antonincms,15,0.00035,3881349,90.03278,4311040
7666,archcosmo,15,0.00035,3881364,90.03312,4311040
7667,armagankaratosun,15,0.00035,3881379,90.03347,4311040
7668,arthurlm44,15,0.00035,3881394,90.03382,4311040
7669,aruneli,15,0.00035,3881409,90.03417,4311040
7670,ashw7n,15,0.00035,3881424,90.03452,4311040
7671,avodaqstephan,15,0.00035,3881439,90.03486,4311040
7672,Azadehkhojandi,15,0.00035,3881454,90.03521,4311040
7673,b1zzu,15,0.00035,3881469,90.03556,4311040
7674,bcg62,15,0.00035,3881484,90.03591,4311040
7675,bhegazy,15,0.00035,3881499,90.03626,4311040
7676,bilby91,15,0.00035,3881514,90.03660,4311040
7677,bison,15,0.00035,3881529,90.03695,4311040
7678,bitfield,15,0.00035,3881544,90.03730,4311040
7679,BjoernT,15,0.00035,3881559,90.03765,4311040
7680,blacksails,15,0.00035,3881574,90.03800,4311040
7681,bleech1,15,0.00035,3881589,90.03834,4311040
7682,bobveznat,15,0.00035,3881604,90.03869,4311040
7683,bobychaudhary,15,0.00035,3881619,90.03904,4311040
7684,bostrt,15,0.00035,3881634,90.03939,4311040
7685,bpicolo,15,0.00035,3881649,90.03974,4311040
7686,burdzwastaken,15,0.00035,3881664,90.04008,4311040
7687,butterv,15,0.00035,3881679,90.04043,4311040
7688,cagataygurturk,15,0.00035,3881694,90.04078,4311040
7689,carllhw,15,0.00035,3881709,90.04113,4311040
7690,CarlosLanderas,15,0.00035,3881724,90.04147,4311040
7691,carlosonunez,15,0.00035,3881739,90.04182,4311040
7692,Celthi,15,0.00035,3881754,90.04217,4311040
7693,Chazzledazzle1,15,0.00035,3881769,90.04252,4311040
7694,chensun,15,0.00035,3881784,90.04287,4311040
7695,CindyXing,15,0.00035,3881799,90.04321,4311040
7696,colachg,15,0.00035,3881814,90.04356,4311040
7697,craigbilner,15,0.00035,3881829,90.04391,4311040
7698,cristim,15,0.00035,3881844,90.04426,4311040
7699,CrossBound,15,0.00035,3881859,90.04461,4311040
7700,CSdread,15,0.00035,3881874,90.04495,4311040
7701,dangen-effy,15,0.00035,3881889,90.04530,4311040
7702,danielfbm,15,0.00035,3881904,90.04565,4311040
7703,darkobas2,15,0.00035,3881919,90.04600,4311040
7704,davidmichaelkarr,15,0.00035,3881934,90.04635,4311040
7705,davisford,15,0.00035,3881949,90.04669,4311040
7706,dchusovitin,15,0.00035,3881964,90.04704,4311040
7707,derberg,15,0.00035,3881979,90.04739,4311040
7708,dex4er,15,0.00035,3881994,90.04774,4311040
7709,dillaman,15,0.00035,3882009,90.04809,4311040
7710,dkpeall,15,0.00035,3882024,90.04843,4311040
7711,dmakeroam,15,0.00035,3882039,90.04878,4311040
7712,dmcgowan,15,0.00035,3882054,90.04913,4311040
7713,dmitrievav,15,0.00035,3882069,90.04948,4311040
7714,domcyrus,15,0.00035,3882084,90.04983,4311040
7715,donspaulding,15,0.00035,3882099,90.05017,4311040
7716,dramich,15,0.00035,3882114,90.05052,4311040
7717,duttaANI,15,0.00035,3882129,90.05087,4311040
7718,dwbrown2,15,0.00035,3882144,90.05122,4311040
7719,elafarge,15,0.00035,3882159,90.05157,4311040
7720,ericln,15,0.00035,3882174,90.05191,4311040
7721,erleene,15,0.00035,3882189,90.05226,4311040
7722,euroelessar,15,0.00035,3882204,90.05261,4311040
7723,evanj,15,0.00035,3882219,90.05296,4311040
7724,evgkrsk,15,0.00035,3882234,90.05331,4311040
7725,exploitht,15,0.00035,3882249,90.05365,4311040
7726,fourstepper,15,0.00035,3882264,90.05400,4311040
7727,fubar,15,0.00035,3882279,90.05435,4311040
7728,gaoning777,15,0.00035,3882294,90.05470,4311040
7729,garo,15,0.00035,3882309,90.05504,4311040
7730,gavrie,15,0.00035,3882324,90.05539,4311040
7731,git4suvendu,15,0.00035,3882339,90.05574,4311040
7732,GitBytes,15,0.00035,3882354,90.05609,4311040
7733,glensc,15,0.00035,3882369,90.05644,4311040
7734,gmauleon,15,0.00035,3882384,90.05678,4311040
7735,gregoiremahe,15,0.00035,3882399,90.05713,4311040
7736,Grillz,15,0.00035,3882414,90.05748,4311040
7737,gugdewescale,15,0.00035,3882429,90.05783,4311040
7738,Gui13,15,0.00035,3882444,90.05818,4311040
7739,h00130372,15,0.00035,3882459,90.05852,4311040
7740,HagaiBarel,15,0.00035,3882474,90.05887,4311040
7741,hamees-sayed,15,0.00035,3882489,90.05922,4311040
7742,HaraldNordgren,15,0.00035,3882504,90.05957,4311040
7743,hellwen,15,0.00035,3882519,90.05992,4311040
7744,hex0punk,15,0.00035,3882534,90.06026,4311040
7745,heyleke,15,0.00035,3882549,90.06061,4311040
7746,hnrytrn,15,0.00035,3882564,90.06096,4311040
7747,Hronom,15,0.00035,3882579,90.06131,4311040
7748,hshitomi,15,0.00035,3882594,90.06166,4311040
7749,huisebug,15,0.00035,3882609,90.06200,4311040
7750,HuiWang0025,15,0.00035,3882624,90.06235,4311040
7751,ikaven1024,15,0.00035,3882639,90.06270,4311040
7752,imcsk8,15,0.00035,3882654,90.06305,4311040
7753,ImJasonH,15,0.00035,3882669,90.06340,4311040
7754,imrenagi,15,0.00035,3882684,90.06374,4311040
7755,intelfx,15,0.00035,3882699,90.06409,4311040
7756,jacek-jablonski,15,0.00035,3882714,90.06444,4311040
7757,jaytaylor,15,0.00035,3882729,90.06479,4311040
7758,jbayer,15,0.00035,3882744,90.06514,4311040
7759,jeffreybrowning,15,0.00035,3882759,90.06548,4311040
7760,jgmize,15,0.00035,3882774,90.06583,4311040
7761,jgsqware,15,0.00035,3882789,90.06618,4311040
7762,jhughes2112,15,0.00035,3882804,90.06653,4311040
7763,jiwq,15,0.00035,3882819,90.06687,4311040
7764,jkld11,15,0.00035,3882834,90.06722,4311040
7765,johnjjung,15,0.00035,3882849,90.06757,4311040
7766,johnsca,15,0.00035,3882864,90.06792,4311040
7767,Jokero,15,0.00035,3882879,90.06827,4311040
7768,joseph-lanoux,15,0.00035,3882894,90.06861,4311040
7769,joshsouza,15,0.00035,3882909,90.06896,4311040
7770,kallisti5,15,0.00035,3882924,90.06931,4311040
7771,katerinapat,15,0.00035,3882939,90.06966,4311040
7772,killfill,15,0.00035,3882954,90.07001,4311040
7773,kkasravi,15,0.00035,3882969,90.07035,4311040
7774,kminehart,15,0.00035,3882984,90.07070,4311040
7775,kramvan1,15,0.00035,3882999,90.07105,4311040
7776,ksimon1,15,0.00035,3883014,90.07140,4311040
7777,ksingh7,15,0.00035,3883029,90.07175,4311040
7778,kskumgk63,15,0.00035,3883044,90.07209,4311040
7779,kuzaxak,15,0.00035,3883059,90.07244,4311040
7780,kyanar,15,0.00035,3883074,90.07279,4311040
7781,lachlancooper,15,0.00035,3883089,90.07314,4311040
7782,lalitc375,15,0.00035,3883104,90.07349,4311040
7783,lanord,15,0.00035,3883119,90.07383,4311040
7784,larhauga,15,0.00035,3883134,90.07418,4311040
7785,libesz,15,0.00035,3883149,90.07453,4311040
7786,life1347,15,0.00035,3883164,90.07488,4311040
7787,lifupan,15,0.00035,3883179,90.07523,4311040
7788,llamerada-jp,15,0.00035,3883194,90.07557,4311040
7789,LoicMahieu,15,0.00035,3883209,90.07592,4311040
7790,Luke035,15,0.00035,3883224,90.07627,4311040
7791,luohoufu,15,0.00035,3883239,90.07662,4311040
7792,Malet,15,0.00035,3883254,90.07697,4311040
7793,mamiu,15,0.00035,3883269,90.07731,4311040
7794,mansona,15,0.00035,3883284,90.07766,4311040
7795,manuelbuil,15,0.00035,3883299,90.07801,4311040
7796,matthewhembree,15,0.00035,3883314,90.07836,4311040
7797,mattparkes,15,0.00035,3883329,90.07870,4311040
7798,MaxKam,15,0.00035,3883344,90.07905,4311040
7799,max-lobur,15,0.00035,3883359,90.07940,4311040
7800,membphis,15,0.00035,3883374,90.07975,4311040
7801,miguelaferreira,15,0.00035,3883389,90.08010,4311040
7802,miheer,15,0.00035,3883404,90.08044,4311040
7803,minac,15,0.00035,3883419,90.08079,4311040
7804,mjura,15,0.00035,3883434,90.08114,4311040
7805,mmueen,15,0.00035,3883449,90.08149,4311040
7806,mogthesprog,15,0.00035,3883464,90.08184,4311040
7807,mohideen,15,0.00035,3883479,90.08218,4311040
7808,montmanu,15,0.00035,3883494,90.08253,4311040
7809,muhlba91,15,0.00035,3883509,90.08288,4311040
7810,multilinear,15,0.00035,3883524,90.08323,4311040
7811,nickbp,15,0.00035,3883539,90.08358,4311040
7812,nickvth,15,0.00035,3883554,90.08392,4311040
7813,nicomitchell,15,0.00035,3883569,90.08427,4311040
7814,nitingadekar,15,0.00035,3883584,90.08462,4311040
7815,oba11,15,0.00035,3883599,90.08497,4311040
7816,ohtake,15,0.00035,3883614,90.08532,4311040
7817,OleksandrBerezianskyi,15,0.00035,3883629,90.08566,4311040
7818,paulnivin,15,0.00035,3883644,90.08601,4311040
7819,pbialon,15,0.00035,3883659,90.08636,4311040
7820,pehlert,15,0.00035,3883674,90.08671,4311040
7821,Poor12,15,0.00035,3883689,90.08706,4311040
7822,ppcololo,15,0.00035,3883704,90.08740,4311040
7823,qinlifeiustack,15,0.00035,3883719,90.08775,4311040
7824,ragunathan23,15,0.00035,3883734,90.08810,4311040
7825,Rakshith-R,15,0.00035,3883749,90.08845,4311040
7826,RamLavi,15,0.00035,3883764,90.08880,4311040
7827,raxod502-plaid,15,0.00035,3883779,90.08914,4311040
7828,rchernobelskiy,15,0.00035,3883794,90.08949,4311040
7829,realdimas,15,0.00035,3883809,90.08984,4311040
7830,realfake,15,0.00035,3883824,90.09019,4311040
7831,ReggieCarey,15,0.00035,3883839,90.09053,4311040
7832,Reifier,15,0.00035,3883854,90.09088,4311040
7833,RemingtonReackhof,15,0.00035,3883869,90.09123,4311040
7834,ricosega,15,0.00035,3883884,90.09158,4311040
7835,rihardssceredins,15,0.00035,3883899,90.09193,4311040
7836,rishi-anand,15,0.00035,3883914,90.09227,4311040
7837,rjanovski,15,0.00035,3883929,90.09262,4311040
7838,Robbilie,15,0.00035,3883944,90.09297,4311040
7839,rsalmond,15,0.00035,3883959,90.09332,4311040
7840,rubenv,15,0.00035,3883974,90.09367,4311040
7841,Ruminateer,15,0.00035,3883989,90.09401,4311040
7842,ryandawsonuk,15,0.00035,3884004,90.09436,4311040
7843,SaaldjorMike,15,0.00035,3884019,90.09471,4311040
7844,sachincab,15,0.00035,3884034,90.09506,4311040
7845,saksham0808,15,0.00035,3884049,90.09541,4311040
7846,sandeepbhojwani,15,0.00035,3884064,90.09575,4311040
7847,sangam14,15,0.00035,3884079,90.09610,4311040
7848,sarahhodne,15,0.00035,3884094,90.09645,4311040
7849,sc-chad,15,0.00035,3884109,90.09680,4311040
7850,sedflix,15,0.00035,3884124,90.09715,4311040
7851,seemethere,15,0.00035,3884139,90.09749,4311040
7852,seongpyoHong,15,0.00035,3884154,90.09784,4311040
7853,sfabel,15,0.00035,3884169,90.09819,4311040
7854,sh0rez,15,0.00035,3884184,90.09854,4311040
7855,Shivaniiiiiiiiiii,15,0.00035,3884199,90.09889,4311040
7856,siggy,15,0.00035,3884214,90.09923,4311040
7857,simon,15,0.00035,3884229,90.09958,4311040
7858,simt2,15,0.00035,3884244,90.09993,4311040
7859,skaslev,15,0.00035,3884259,90.10028,4311040
7860,skikkh,15,0.00035,3884274,90.10063,4311040
7861,SMillerDev,15,0.00035,3884289,90.10097,4311040
7862,snormore,15,0.00035,3884304,90.10132,4311040
7863,sobi3ch,15,0.00035,3884319,90.10167,4311040
7864,sppwf,15,0.00035,3884334,90.10202,4311040
7865,ssergiienko,15,0.00035,3884349,90.10237,4311040
7866,stacyped,15,0.00035,3884364,90.10271,4311040
7867,StefanLobbenmeier,15,0.00035,3884379,90.10306,4311040
7868,supriyagarg,15,0.00035,3884394,90.10341,4311040
7869,switchboardOp,15,0.00035,3884409,90.10376,4311040
7870,system51,15,0.00035,3884424,90.10410,4311040
7871,talonx,15,0.00035,3884439,90.10445,4311040
7872,taoyu27,15,0.00035,3884454,90.10480,4311040
7873,tareqhs,15,0.00035,3884469,90.10515,4311040
7874,the-gigi,15,0.00035,3884484,90.10550,4311040
7875,TheLastProject,15,0.00035,3884499,90.10584,4311040
7876,thirdeyenick,15,0.00035,3884514,90.10619,4311040
7877,thuandt,15,0.00035,3884529,90.10654,4311040
7878,timthelion,15,0.00035,3884544,90.10689,4311040
7879,tomocy,15,0.00035,3884559,90.10724,4311040
7880,tomsucho,15,0.00035,3884574,90.10758,4311040
7881,tony612,15,0.00035,3884589,90.10793,4311040
7882,uMartinXu,15,0.00035,3884604,90.10828,4311040
7883,unguiculus,15,0.00035,3884619,90.10863,4311040
7884,utka,15,0.00035,3884634,90.10898,4311040
7885,Vimal-Raghubir,15,0.00035,3884649,90.10932,4311040
7886,Vlatombe,15,0.00035,3884664,90.10967,4311040
7887,vromero,15,0.00035,3884679,90.11002,4311040
7888,vzemtsov,15,0.00035,3884694,90.11037,4311040
7889,WanzenBug,15,0.00035,3884709,90.11072,4311040
7890,Wenfeng-GAO,15,0.00035,3884724,90.11106,4311040
7891,wimo7083,15,0.00035,3884739,90.11141,4311040
7892,wizard580,15,0.00035,3884754,90.11176,4311040
7893,wolffberg,15,0.00035,3884769,90.11211,4311040
7894,xiaopeng-han,15,0.00035,3884784,90.11246,4311040
7895,xuezhaojun,15,0.00035,3884799,90.11280,4311040
7896,yan-dblinf,15,0.00035,3884814,90.11315,4311040
7897,yaron2,15,0.00035,3884829,90.11350,4311040
7898,youssefazrak,15,0.00035,3884844,90.11385,4311040
7899,zchenyu,15,0.00035,3884859,90.11420,4311040
7900,zoobab,15,0.00035,3884874,90.11454,4311040
7901,123tap,14,0.00032,3884888,90.11487,4311040
7902,aarondav,14,0.00032,3884902,90.11519,4311040
7903,absoludity,14,0.00032,3884916,90.11552,4311040
7904,aclowkey,14,0.00032,3884930,90.11584,4311040
7905,adrian,14,0.00032,3884944,90.11617,4311040
7906,ADustyOldMuffin,14,0.00032,3884958,90.11649,4311040
7907,ailurarctos,14,0.00032,3884972,90.11682,4311040
7908,akamac,14,0.00032,3884986,90.11714,4311040
7909,akoenig,14,0.00032,3885000,90.11747,4311040
7910,Alex-Waring,14,0.00032,3885014,90.11779,4311040
7911,alikhil,14,0.00032,3885028,90.11812,4311040
7912,aliusmiles,14,0.00032,3885042,90.11844,4311040
7913,alkar,14,0.00032,3885056,90.11876,4311040
7914,amarrella,14,0.00032,3885070,90.11909,4311040
7915,ameena007,14,0.00032,3885084,90.11941,4311040
7916,anarcher,14,0.00032,3885098,90.11974,4311040
7917,andrewwebber,14,0.00032,3885112,90.12006,4311040
7918,andybons,14,0.00032,3885126,90.12039,4311040
7919,ashokponkumar,14,0.00032,3885140,90.12071,4311040
7920,asierHuawei,14,0.00032,3885154,90.12104,4311040
7921,avlitman,14,0.00032,3885168,90.12136,4311040
7922,awsprof,14,0.00032,3885182,90.12169,4311040
7923,ayaz,14,0.00032,3885196,90.12201,4311040
7924,benjaminhuo,14,0.00032,3885210,90.12234,4311040
7925,bennythejudge,14,0.00032,3885224,90.12266,4311040
7926,ben-turner,14,0.00032,3885238,90.12299,4311040
7927,bharrisau,14,0.00032,3885252,90.12331,4311040
7928,bigkevmcd,14,0.00032,3885266,90.12364,4311040
7929,billykwooten,14,0.00032,3885280,90.12396,4311040
7930,bjoernhaeuser,14,0.00032,3885294,90.12429,4311040
7931,blackwith,14,0.00032,3885308,90.12461,4311040
7932,blixtra,14,0.00032,3885322,90.12494,4311040
7933,blockloop,14,0.00032,3885336,90.12526,4311040
7934,bobbytables,14,0.00032,3885350,90.12558,4311040
7935,BoBiene,14,0.00032,3885364,90.12591,4311040
7936,bobrik,14,0.00032,3885378,90.12623,4311040
7937,bouaouda-achraf,14,0.00032,3885392,90.12656,4311040
7938,braceinhz,14,0.00032,3885406,90.12688,4311040
7939,bradenwright,14,0.00032,3885420,90.12721,4311040
7940,BrendanThompson,14,0.00032,3885434,90.12753,4311040
7941,brettplarson,14,0.00032,3885448,90.12786,4311040
7942,bronhaim,14,0.00032,3885462,90.12818,4311040
7943,bsctl,14,0.00032,3885476,90.12851,4311040
7944,c1t1d0s7,14,0.00032,3885490,90.12883,4311040
7945,caiobegotti,14,0.00032,3885504,90.12916,4311040
7946,carpenterm,14,0.00032,3885518,90.12948,4311040
7947,caulagi,14,0.00032,3885532,90.12981,4311040
7948,ChaningHwang,14,0.00032,3885546,90.13013,4311040
7949,ChetHosey,14,0.00032,3885560,90.13046,4311040
7950,chicocvenancio,14,0.00032,3885574,90.13078,4311040
7951,chiehpower,14,0.00032,3885588,90.13111,4311040
7952,chino,14,0.00032,3885602,90.13143,4311040
7953,chiradeep,14,0.00032,3885616,90.13175,4311040
7954,chunliu,14,0.00032,3885630,90.13208,4311040
7955,clairew,14,0.00032,3885644,90.13240,4311040
7956,codeblooded,14,0.00032,3885658,90.13273,4311040
7957,crunk1,14,0.00032,3885672,90.13305,4311040
7958,curx,14,0.00032,3885686,90.13338,4311040
7959,dabcoder,14,0.00032,3885700,90.13370,4311040
7960,daconstenla,14,0.00032,3885714,90.13403,4311040
7961,dahovey,14,0.00032,3885728,90.13435,4311040
7962,dasarathirout,14,0.00032,3885742,90.13468,4311040
7963,DaspawnW,14,0.00032,3885756,90.13500,4311040
7964,david92rl,14,0.00032,3885770,90.13533,4311040
7965,davidsbond,14,0.00032,3885784,90.13565,4311040
7966,Demonsthere,14,0.00032,3885798,90.13598,4311040
7967,deveshgoyal1000,14,0.00032,3885812,90.13630,4311040
7968,devilcrises,14,0.00032,3885826,90.13663,4311040
7969,dgrizzanti,14,0.00032,3885840,90.13695,4311040
7970,dlaidlaw,14,0.00032,3885854,90.13728,4311040
7971,dmarkey,14,0.00032,3885868,90.13760,4311040
7972,dmeytin,14,0.00032,3885882,90.13792,4311040
7973,dnavre,14,0.00032,3885896,90.13825,4311040
7974,dominikbraun,14,0.00032,3885910,90.13857,4311040
7975,dominikh,14,0.00032,3885924,90.13890,4311040
7976,dpb587-pivotal,14,0.00032,3885938,90.13922,4311040
7977,dragon9783,14,0.00032,3885952,90.13955,4311040
7978,dwerder,14,0.00032,3885966,90.13987,4311040
7979,dyema,14,0.00032,3885980,90.14020,4311040
7980,ebabani,14,0.00032,3885994,90.14052,4311040
7981,echoboomer,14,0.00032,3886008,90.14085,4311040
7982,edbergavera,14,0.00032,3886022,90.14117,4311040
7983,ekalinin,14,0.00032,3886036,90.14150,4311040
7984,eknudtson,14,0.00032,3886050,90.14182,4311040
7985,ElanHasson,14,0.00032,3886064,90.14215,4311040
7986,elyscape,14,0.00032,3886078,90.14247,4311040
7987,eroldan,14,0.00032,3886092,90.14280,4311040
7988,evanrich,14,0.00032,3886106,90.14312,4311040
7989,excavador,14,0.00032,3886120,90.14345,4311040
7990,fawaz-moh,14,0.00032,3886134,90.14377,4311040
7991,fdawg4l,14,0.00032,3886148,90.14410,4311040
7992,Fgruntjes,14,0.00032,3886162,90.14442,4311040
7993,fkorotkov,14,0.00032,3886176,90.14474,4311040
7994,fog1985,14,0.00032,3886190,90.14507,4311040
7995,fredgate,14,0.00032,3886204,90.14539,4311040
7996,frioux,14,0.00032,3886218,90.14572,4311040
7997,frostzt,14,0.00032,3886232,90.14604,4311040
7998,fukuta-tatsuya-intec,14,0.00032,3886246,90.14637,4311040
7999,gaffneyd4,14,0.00032,3886260,90.14669,4311040
8000,gautamkmr,14,0.00032,3886274,90.14702,4311040
8001,gavinB-orange,14,0.00032,3886288,90.14734,4311040
8002,gburton1,14,0.00032,3886302,90.14767,4311040
8003,giannisalinetti,14,0.00032,3886316,90.14799,4311040
8004,giovanism,14,0.00032,3886330,90.14832,4311040
8005,GitHubxsy,14,0.00032,3886344,90.14864,4311040
8006,gongx,14,0.00032,3886358,90.14897,4311040
8007,govinda-attal,14,0.00032,3886372,90.14929,4311040
8008,GrigorievNick,14,0.00032,3886386,90.14962,4311040
8009,gtseres,14,0.00032,3886400,90.14994,4311040
8010,hari819,14,0.00032,3886414,90.15027,4311040
8011,HeavenTonight,14,0.00032,3886428,90.15059,4311040
8012,Hexcles,14,0.00032,3886442,90.15091,4311040
8013,hferentschik,14,0.00032,3886456,90.15124,4311040
8014,Horgix,14,0.00032,3886470,90.15156,4311040
8015,howinator,14,0.00032,3886484,90.15189,4311040
8016,hpedrorodrigues,14,0.00032,3886498,90.15221,4311040
8017,husky-parul,14,0.00032,3886512,90.15254,4311040
8018,hustshawn,14,0.00032,3886526,90.15286,4311040
8019,ianbuss,14,0.00032,3886540,90.15319,4311040
8020,ignertic,14,0.00032,3886554,90.15351,4311040
8021,ilyasotkov,14,0.00032,3886568,90.15384,4311040
8022,irl-segfault,14,0.00032,3886582,90.15416,4311040
8023,ismferd,14,0.00032,3886596,90.15449,4311040
8024,IxDay,14,0.00032,3886610,90.15481,4311040
8025,jacobmarble,14,0.00032,3886624,90.15514,4311040
8026,jaymccon,14,0.00032,3886638,90.15546,4311040
8027,jbehrends,14,0.00032,3886652,90.15579,4311040
8028,jbw976,14,0.00032,3886666,90.15611,4311040
8029,jeffqwb2017,14,0.00032,3886680,90.15644,4311040
8030,jkotalik,14,0.00032,3886694,90.15676,4311040
8031,jocatalin,14,0.00032,3886708,90.15709,4311040
8032,joeblackwaslike,14,0.00032,3886722,90.15741,4311040
8033,joestringer,14,0.00032,3886736,90.15773,4311040
8034,JonathanSun,14,0.00032,3886750,90.15806,4311040
8035,JordanFaust,14,0.00032,3886764,90.15838,4311040
8036,josepdcs,14,0.00032,3886778,90.15871,4311040
8037,josephjacks,14,0.00032,3886792,90.15903,4311040
8038,joshperry,14,0.00032,3886806,90.15936,4311040
8039,joulaud,14,0.00032,3886820,90.15968,4311040
8040,jputrino,14,0.00032,3886834,90.16001,4311040
8041,jryberg,14,0.00032,3886848,90.16033,4311040
8042,jrynyt,14,0.00032,3886862,90.16066,4311040
8043,julienperignon,14,0.00032,3886876,90.16098,4311040
8044,justinlindh,14,0.00032,3886890,90.16131,4311040
8045,jwm,14,0.00032,3886904,90.16163,4311040
8046,kaleocheng,14,0.00032,3886918,90.16196,4311040
8047,kenmoore,14,0.00032,3886932,90.16228,4311040
8048,kevin-lindsay-1,14,0.00032,3886946,90.16261,4311040
8049,kierenj,14,0.00032,3886960,90.16293,4311040
8050,kirrmann,14,0.00032,3886974,90.16326,4311040
8051,klxfeiyang,14,0.00032,3886988,90.16358,4311040
8052,krishna-mk,14,0.00032,3887002,90.16390,4311040
8053,KristianWindsor,14,0.00032,3887016,90.16423,4311040
8054,krsakshi,14,0.00032,3887030,90.16455,4311040
8055,kvendingoldo,14,0.00032,3887044,90.16488,4311040
8056,lbernick,14,0.00032,3887058,90.16520,4311040
8057,lcostea,14,0.00032,3887072,90.16553,4311040
8058,Leo7654,14,0.00032,3887086,90.16585,4311040
8059,levi106,14,0.00032,3887100,90.16618,4311040
8060,levigross,14,0.00032,3887114,90.16650,4311040
8061,liangxiaoping,14,0.00032,3887128,90.16683,4311040
8062,librannk,14,0.00032,3887142,90.16715,4311040
8063,lmzqwer2,14,0.00032,3887156,90.16748,4311040
8064,longkai,14,0.00032,3887170,90.16780,4311040
8065,louiscryan,14,0.00032,3887184,90.16813,4311040
8066,ltagliamonte,14,0.00032,3887198,90.16845,4311040
8067,lundbird,14,0.00032,3887212,90.16878,4311040
8068,macrozone,14,0.00032,3887226,90.16910,4311040
8069,mahendrakariya,14,0.00032,3887240,90.16943,4311040
8070,maht,14,0.00032,3887254,90.16975,4311040
8071,maoyangLiu,14,0.00032,3887268,90.17007,4311040
8072,marcacohen,14,0.00032,3887282,90.17040,4311040
8073,matheusneder,14,0.00032,3887296,90.17072,4311040
8074,matthewfischer,14,0.00032,3887310,90.17105,4311040
8075,mfilotto,14,0.00032,3887324,90.17137,4311040
8076,MichaelVL,14,0.00032,3887338,90.17170,4311040
8077,minhhungit,14,0.00032,3887352,90.17202,4311040
8078,minjs,14,0.00032,3887366,90.17235,4311040
8079,miracle2k,14,0.00032,3887380,90.17267,4311040
8080,Mistobaan,14,0.00032,3887394,90.17300,4311040
8081,mm0,14,0.00032,3887408,90.17332,4311040
8082,Modulus,14,0.00032,3887422,90.17365,4311040
8083,moutai,14,0.00032,3887436,90.17397,4311040
8084,mrichmon,14,0.00032,3887450,90.17430,4311040
8085,mudasar187,14,0.00032,3887464,90.17462,4311040
8086,muenchdo,14,0.00032,3887478,90.17495,4311040
8087,mugdha-adhav,14,0.00032,3887492,90.17527,4311040
8088,mustafaakin,14,0.00032,3887506,90.17560,4311040
8089,mvaal,14,0.00032,3887520,90.17592,4311040
8090,mychen66,14,0.00032,3887534,90.17625,4311040
8091,n0rad,14,0.00032,3887548,90.17657,4311040
8092,ncri,14,0.00032,3887562,90.17689,4311040
8093,nehagup,14,0.00032,3887576,90.17722,4311040
8094,nemobis,14,0.00032,3887590,90.17754,4311040
8095,Nessex,14,0.00032,3887604,90.17787,4311040
8096,Nick-Harvey,14,0.00032,3887618,90.17819,4311040
8097,NicklasWallgren,14,0.00032,3887632,90.17852,4311040
8098,niedbalski,14,0.00032,3887646,90.17884,4311040
8099,nikimanoledaki,14,0.00032,3887660,90.17917,4311040
8100,nlopezgi,14,0.00032,3887674,90.17949,4311040
8101,nrmitchi,14,0.00032,3887688,90.17982,4311040
8102,ntcong,14,0.00032,3887702,90.18014,4311040
8103,nutchalum,14,0.00032,3887716,90.18047,4311040
8104,odino,14,0.00032,3887730,90.18079,4311040
8105,OlivierMary,14,0.00032,3887744,90.18112,4311040
8106,orthros,14,0.00032,3887758,90.18144,4311040
8107,osela,14,0.00032,3887772,90.18177,4311040
8108,paulbdavis,14,0.00032,3887786,90.18209,4311040
8109,perrywang,14,0.00032,3887800,90.18242,4311040
8110,peterbale,14,0.00032,3887814,90.18274,4311040
8111,phoenix-bjoern,14,0.00032,3887828,90.18306,4311040
8112,piotrkpc,14,0.00032,3887842,90.18339,4311040
8113,pmoncadaisla,14,0.00032,3887856,90.18371,4311040
8114,pmontanari,14,0.00032,3887870,90.18404,4311040
8115,postmaxin,14,0.00032,3887884,90.18436,4311040
8116,pshanoop,14,0.00032,3887898,90.18469,4311040
8117,psyhomb,14,0.00032,3887912,90.18501,4311040
8118,qmhu,14,0.00032,3887926,90.18534,4311040
8119,QuinceyJames,14,0.00032,3887940,90.18566,4311040
8120,r0ushann,14,0.00032,3887954,90.18599,4311040
8121,radeksimko,14,0.00032,3887968,90.18631,4311040
8122,rafadc,14,0.00032,3887982,90.18664,4311040
8123,RahulMahale,14,0.00032,3887996,90.18696,4311040
8124,rassie,14,0.00032,3888010,90.18729,4311040
8125,ratnopamc,14,0.00032,3888024,90.18761,4311040
8126,rbankston,14,0.00032,3888038,90.18794,4311040
8127,rca,14,0.00032,3888052,90.18826,4311040
8128,rhafer,14,0.00032,3888066,90.18859,4311040
8129,robinlieb,14,0.00032,3888080,90.18891,4311040
8130,robsonpeixoto,14,0.00032,3888094,90.18924,4311040
8131,robstoll,14,0.00032,3888108,90.18956,4311040
8132,RoelVanNyen,14,0.00032,3888122,90.18988,4311040
8133,rolpat,14,0.00032,3888136,90.19021,4311040
8134,rvacaru,14,0.00032,3888150,90.19053,4311040
8135,rwehner,14,0.00032,3888164,90.19086,4311040
8136,s4rd1nh4,14,0.00032,3888178,90.19118,4311040
8137,sachithmuhandiram,14,0.00032,3888192,90.19151,4311040
8138,sam-cogan,14,0.00032,3888206,90.19183,4311040
8139,sameer2800,14,0.00032,3888220,90.19216,4311040
8140,sargun,14,0.00032,3888234,90.19248,4311040
8141,S-Chan,14,0.00032,3888248,90.19281,4311040
8142,schlichtanders,14,0.00032,3888262,90.19313,4311040
8143,scottmwebber,14,0.00032,3888276,90.19346,4311040
8144,seaneagan,14,0.00032,3888290,90.19378,4311040
8145,selvik,14,0.00032,3888304,90.19411,4311040
8146,seunggs,14,0.00032,3888318,90.19443,4311040
8147,sgnn7,14,0.00032,3888332,90.19476,4311040
8148,shpwrck,14,0.00032,3888346,90.19508,4311040
8149,shubhamavi,14,0.00032,3888360,90.19541,4311040
8150,si458,14,0.00032,3888374,90.19573,4311040
8151,SimonCqk,14,0.00032,3888388,90.19605,4311040
8152,sjmudd,14,0.00032,3888402,90.19638,4311040
8153,skaven81,14,0.00032,3888416,90.19670,4311040
8154,spkane,14,0.00032,3888430,90.19703,4311040
8155,srinivas-pokala,14,0.00032,3888444,90.19735,4311040
8156,starlightromero,14,0.00032,3888458,90.19768,4311040
8157,StefanCenusa,14,0.00032,3888472,90.19800,4311040
8158,steved,14,0.00032,3888486,90.19833,4311040
8159,stevo-f3,14,0.00032,3888500,90.19865,4311040
8160,sthulb,14,0.00032,3888514,90.19898,4311040
8161,sudeeshjohn,14,0.00032,3888528,90.19930,4311040
8162,suleisl2000,14,0.00032,3888542,90.19963,4311040
8163,superdave,14,0.00032,3888556,90.19995,4311040
8164,Svendegroote91,14,0.00032,3888570,90.20028,4311040
8165,svozza,14,0.00032,3888584,90.20060,4311040
8166,sykesm,14,0.00032,3888598,90.20093,4311040
8167,tarvip,14,0.00032,3888612,90.20125,4311040
8168,taxpon,14,0.00032,3888626,90.20158,4311040
8169,Tea4menono,14,0.00032,3888640,90.20190,4311040
8170,teddyking,14,0.00032,3888654,90.20222,4311040
8171,thagikura,14,0.00032,3888668,90.20255,4311040
8172,timhughes,14,0.00032,3888682,90.20287,4311040
8173,tim-zju,14,0.00032,3888696,90.20320,4311040
8174,tiny1990,14,0.00032,3888710,90.20352,4311040
8175,tomerleib,14,0.00032,3888724,90.20385,4311040
8176,toninis,14,0.00032,3888738,90.20417,4311040
8177,tony-kerz,14,0.00032,3888752,90.20450,4311040
8178,tonylambiris,14,0.00032,3888766,90.20482,4311040
8179,tormath1,14,0.00032,3888780,90.20515,4311040
8180,tsasaki609,14,0.00032,3888794,90.20547,4311040
8181,ulyssessouza,14,0.00032,3888808,90.20580,4311040
8182,vadimeisenbergibm,14,0.00032,3888822,90.20612,4311040
8183,vainkop,14,0.00032,3888836,90.20645,4311040
8184,vanhtuan0409,14,0.00032,3888850,90.20677,4311040
8185,vasicvuk,14,0.00032,3888864,90.20710,4311040
8186,vhurtevent,14,0.00032,3888878,90.20742,4311040
8187,vikramk7,14,0.00032,3888892,90.20775,4311040
8188,vixus0,14,0.00032,3888906,90.20807,4311040
8189,vladimirtiukhtin,14,0.00032,3888920,90.20840,4311040
8190,vladlosev,14,0.00032,3888934,90.20872,4311040
8191,w1ndy,14,0.00032,3888948,90.20904,4311040
8192,wannabesrevenge,14,0.00032,3888962,90.20937,4311040
8193,weibaohui,14,0.00032,3888976,90.20969,4311040
8194,weizhouBlue,14,0.00032,3888990,90.21002,4311040
8195,WoLpH,14,0.00032,3889004,90.21034,4311040
8196,woodgear,14,0.00032,3889018,90.21067,4311040
8197,XinhaiWang,14,0.00032,3889032,90.21099,4311040
8198,xinzhangcmu,14,0.00032,3889046,90.21132,4311040
8199,Xuxe,14,0.00032,3889060,90.21164,4311040
8200,Xyaren,14,0.00032,3889074,90.21197,4311040
8201,yacinelazaar,14,0.00032,3889088,90.21229,4311040
8202,yanhongwang,14,0.00032,3889102,90.21262,4311040
8203,yanivpaz,14,0.00032,3889116,90.21294,4311040
8204,yankcrime,14,0.00032,3889130,90.21327,4311040
8205,yaronha,14,0.00032,3889144,90.21359,4311040
8206,yasra002,14,0.00032,3889158,90.21392,4311040
8207,yongtang,14,0.00032,3889172,90.21424,4311040
8208,yuansisi,14,0.00032,3889186,90.21457,4311040
8209,yuvalk,14,0.00032,3889200,90.21489,4311040
8210,zachomedia,14,0.00032,3889214,90.21521,4311040
8211,zafs23,14,0.00032,3889228,90.21554,4311040
8212,zeta2030,14,0.00032,3889242,90.21586,4311040
8213,zhanghuidinah,14,0.00032,3889256,90.21619,4311040
8214,zxkane,14,0.00032,3889270,90.21651,4311040
8215,a4abhishek,13,0.00030,3889283,90.21682,4311040
8216,abayer,13,0.00030,3889296,90.21712,4311040
8217,abejide001,13,0.00030,3889309,90.21742,4311040
8218,abhilipsasahoo03,13,0.00030,3889322,90.21772,4311040
8219,adamwg,13,0.00030,3889335,90.21802,4311040
8220,aditya-konarde,13,0.00030,3889348,90.21832,4311040
8221,adnanh,13,0.00030,3889361,90.21862,4311040
8222,ag237,13,0.00030,3889374,90.21893,4311040
8223,akloss-cibo,13,0.00030,3889387,90.21923,4311040
8224,AlawnWong,13,0.00030,3889400,90.21953,4311040
8225,alekssaul,13,0.00030,3889413,90.21983,4311040
8226,alexcope,13,0.00030,3889426,90.22013,4311040
8227,alexjg,13,0.00030,3889439,90.22043,4311040
8228,alinaryan,13,0.00030,3889452,90.22074,4311040
8229,amanchourasiya,13,0.00030,3889465,90.22104,4311040
8230,AndreaGiardini,13,0.00030,3889478,90.22134,4311040
8231,andrewklau,13,0.00030,3889491,90.22164,4311040
8232,angegar,13,0.00030,3889504,90.22194,4311040
8233,ansd,13,0.00030,3889517,90.22224,4311040
8234,antoinne85,13,0.00030,3889530,90.22254,4311040
8235,anuragprafulla,13,0.00030,3889543,90.22285,4311040
8236,anwarchk,13,0.00030,3889556,90.22315,4311040
8237,apsega,13,0.00030,3889569,90.22345,4311040
8238,asdf2014,13,0.00030,3889582,90.22375,4311040
8239,b2jrock,13,0.00030,3889595,90.22405,4311040
8240,baurmatt,13,0.00030,3889608,90.22435,4311040
8241,bbeaudreault,13,0.00030,3889621,90.22466,4311040
8242,Berndinox,13,0.00030,3889634,90.22496,4311040
8243,binman-docker,13,0.00030,3889647,90.22526,4311040
8244,bitgandtter,13,0.00030,3889660,90.22556,4311040
8245,brosander,13,0.00030,3889673,90.22586,4311040
8246,bryanhanner,13,0.00030,3889686,90.22616,4311040
8247,btoonk,13,0.00030,3889699,90.22647,4311040
8248,bugok,13,0.00030,3889712,90.22677,4311040
8249,buraksekili,13,0.00030,3889725,90.22707,4311040
8250,candlerb,13,0.00030,3889738,90.22737,4311040
8251,caoyingjunz,13,0.00030,3889751,90.22767,4311040
8252,carnei-ro,13,0.00030,3889764,90.22797,4311040
8253,cedricve,13,0.00030,3889777,90.22827,4311040
8254,CelsoSantos,13,0.00030,3889790,90.22858,4311040
8255,challapradyumna,13,0.00030,3889803,90.22888,4311040
8256,ChanYiLin,13,0.00030,3889816,90.22918,4311040
8257,chetanguptaa,13,0.00030,3889829,90.22948,4311040
8258,chris93111,13,0.00030,3889842,90.22978,4311040
8259,chrispatmore,13,0.00030,3889855,90.23008,4311040
8260,chungktran,13,0.00030,3889868,90.23039,4311040
8261,ckeyer,13,0.00030,3889881,90.23069,4311040
8262,clayrisser,13,0.00030,3889894,90.23099,4311040
8263,clintonk,13,0.00030,3889907,90.23129,4311040
8264,cmoad,13,0.00030,3889920,90.23159,4311040
8265,cnadolny,13,0.00030,3889933,90.23189,4311040
8266,costela,13,0.00030,3889946,90.23219,4311040
8267,csnitker,13,0.00030,3889959,90.23250,4311040
8268,cvallance,13,0.00030,3889972,90.23280,4311040
8269,danielfoehrKn,13,0.00030,3889985,90.23310,4311040
8270,danielhoherd,13,0.00030,3889998,90.23340,4311040
8271,daniel-kun,13,0.00030,3890011,90.23370,4311040
8272,danilorsilva,13,0.00030,3890024,90.23400,4311040
8273,danniel1205,13,0.00030,3890037,90.23431,4311040
8274,davidchua,13,0.00030,3890050,90.23461,4311040
8275,davidkazuhiro,13,0.00030,3890063,90.23491,4311040
8276,dbkegley,13,0.00030,3890076,90.23521,4311040
8277,dealboy,13,0.00030,3890089,90.23551,4311040
8278,DerrickMartinez,13,0.00030,3890102,90.23581,4311040
8279,devth,13,0.00030,3890115,90.23611,4311040
8280,dgkanatsios,13,0.00030,3890128,90.23642,4311040
8281,difro,13,0.00030,3890141,90.23672,4311040
8282,digeler,13,0.00030,3890154,90.23702,4311040
8283,dimara,13,0.00030,3890167,90.23732,4311040
8284,dimberman,13,0.00030,3890180,90.23762,4311040
8285,djensen47,13,0.00030,3890193,90.23792,4311040
8286,djsd123,13,0.00030,3890206,90.23823,4311040
8287,dkusidlo,13,0.00030,3890219,90.23853,4311040
8288,dlouzan,13,0.00030,3890232,90.23883,4311040
8289,dnaeon,13,0.00030,3890245,90.23913,4311040
8290,dougbtv,13,0.00030,3890258,90.23943,4311040
8291,drewpca,13,0.00030,3890271,90.23973,4311040
8292,dvdmuckle,13,0.00030,3890284,90.24003,4311040
8293,DVGY,13,0.00030,3890297,90.24034,4311040
8294,dzmitry-lahoda,13,0.00030,3890310,90.24064,4311040
8295,Ecsy,13,0.00030,3890323,90.24094,4311040
8296,electrofelix,13,0.00030,3890336,90.24124,4311040
8297,elevran,13,0.00030,3890349,90.24154,4311040
8298,EliZucker,13,0.00030,3890362,90.24184,4311040
8299,erick-thompson,13,0.00030,3890375,90.24215,4311040
8300,erkolson,13,0.00030,3890388,90.24245,4311040
8301,Estherbdf,13,0.00030,3890401,90.24275,4311040
8302,evanfoster,13,0.00030,3890414,90.24305,4311040
8303,evgenii-petrov-arrival,13,0.00030,3890427,90.24335,4311040
8304,FangyuanCaiWork,13,0.00030,3890440,90.24365,4311040
8305,fbsolo,13,0.00030,3890453,90.24396,4311040
8306,fcvarela,13,0.00030,3890466,90.24426,4311040
8307,filintod,13,0.00030,3890479,90.24456,4311040
8308,FlipEnergy,13,0.00030,3890492,90.24486,4311040
8309,foobarto,13,0.00030,3890505,90.24516,4311040
8310,fredsted,13,0.00030,3890518,90.24546,4311040
8311,ganchandrasekaran,13,0.00030,3890531,90.24576,4311040
8312,gavin-stackrox,13,0.00030,3890544,90.24607,4311040
8313,gmannos,13,0.00030,3890557,90.24637,4311040
8314,goern,13,0.00030,3890570,90.24667,4311040
8315,gravis,13,0.00030,3890583,90.24697,4311040
8316,gutek9,13,0.00030,3890596,90.24727,4311040
8317,guyguy333,13,0.00030,3890609,90.24757,4311040
8318,gwind,13,0.00030,3890622,90.24788,4311040
8319,hadim,13,0.00030,3890635,90.24818,4311040
8320,halfrost,13,0.00030,3890648,90.24848,4311040
8321,hardys,13,0.00030,3890661,90.24878,4311040
8322,hasahni,13,0.00030,3890674,90.24908,4311040
8323,hbokh,13,0.00030,3890687,90.24938,4311040
8324,HelmutLety,13,0.00030,3890700,90.24968,4311040
8325,henrynash,13,0.00030,3890713,90.24999,4311040
8326,heshamMassoud,13,0.00030,3890726,90.25029,4311040
8327,hexfusion,13,0.00030,3890739,90.25059,4311040
8328,holyhope,13,0.00030,3890752,90.25089,4311040
8329,hoozecn,13,0.00030,3890765,90.25119,4311040
8330,hTrap,13,0.00030,3890778,90.25149,4311040
8331,huoqifeng,13,0.00030,3890791,90.25180,4311040
8332,iastewar,13,0.00030,3890804,90.25210,4311040
8333,iftachsc,13,0.00030,3890817,90.25240,4311040
8334,ikogan,13,0.00030,3890830,90.25270,4311040
8335,Ileriayo,13,0.00030,3890843,90.25300,4311040
8336,imilchev,13,0.00030,3890856,90.25330,4311040
8337,ismacasti,13,0.00030,3890869,90.25360,4311040
8338,ivange94,13,0.00030,3890882,90.25391,4311040
8339,Jai-Solania-29,13,0.00030,3890895,90.25421,4311040
8340,janzantinge,13,0.00030,3890908,90.25451,4311040
8341,jashandeep-sohi,13,0.00030,3890921,90.25481,4311040
8342,jasondewitt,13,0.00030,3890934,90.25511,4311040
8343,jaysonsantos,13,0.00030,3890947,90.25541,4311040
8344,jbguerraz,13,0.00030,3890960,90.25572,4311040
8345,jeffhubLR,13,0.00030,3890973,90.25602,4311040
8346,jeremyvisser,13,0.00030,3890986,90.25632,4311040
8347,jeroenvisser101,13,0.00030,3890999,90.25662,4311040
8348,jiayihu,13,0.00030,3891012,90.25692,4311040
8349,jimbobby5,13,0.00030,3891025,90.25722,4311040
8350,jjdiazgarcia,13,0.00030,3891038,90.25752,4311040
8351,JochenFriedrich,13,0.00030,3891051,90.25783,4311040
8352,joedborg,13,0.00030,3891064,90.25813,4311040
8353,johannes-gehrs,13,0.00030,3891077,90.25843,4311040
8354,johnmarcou,13,0.00030,3891090,90.25873,4311040
8355,JohnVillalovos,13,0.00030,3891103,90.25903,4311040
8356,Joibel,13,0.00030,3891116,90.25933,4311040
8357,Jojoooo1,13,0.00030,3891129,90.25964,4311040
8358,joshes,13,0.00030,3891142,90.25994,4311040
8359,joshwget,13,0.00030,3891155,90.26024,4311040
8360,jouros,13,0.00030,3891168,90.26054,4311040
8361,jsrz,13,0.00030,3891181,90.26084,4311040
8362,jwhitcraft,13,0.00030,3891194,90.26114,4311040
8363,jwhy89,13,0.00030,3891207,90.26145,4311040
8364,KelvinAkpobome,13,0.00030,3891220,90.26175,4311040
8365,kevinfrommelt,13,0.00030,3891233,90.26205,4311040
8366,kivio,13,0.00030,3891246,90.26235,4311040
8367,knee-berts,13,0.00030,3891259,90.26265,4311040
8368,kopper,13,0.00030,3891272,90.26295,4311040
8369,kvmware,13,0.00030,3891285,90.26325,4311040
8370,kylegordon,13,0.00030,3891298,90.26356,4311040
8371,lamw,13,0.00030,3891311,90.26386,4311040
8372,leventogut,13,0.00030,3891324,90.26416,4311040
8373,lewismarshall,13,0.00030,3891337,90.26446,4311040
8374,loewenstein,13,0.00030,3891350,90.26476,4311040
8375,logicfox,13,0.00030,3891363,90.26506,4311040
8376,lookuptable,13,0.00030,3891376,90.26537,4311040
8377,Lookyan,13,0.00030,3891389,90.26567,4311040
8378,louis-murray,13,0.00030,3891402,90.26597,4311040
8379,lrakai,13,0.00030,3891415,90.26627,4311040
8380,LukasGentele,13,0.00030,3891428,90.26657,4311040
8381,lukeweber,13,0.00030,3891441,90.26687,4311040
8382,makhov,13,0.00030,3891454,90.26717,4311040
8383,manav014,13,0.00030,3891467,90.26748,4311040
8384,marineam,13,0.00030,3891480,90.26778,4311040
8385,MarkMorsing,13,0.00030,3891493,90.26808,4311040
8386,mars64,13,0.00030,3891506,90.26838,4311040
8387,masudur-rahman,13,0.00030,3891519,90.26868,4311040
8388,mcanevet,13,0.00030,3891532,90.26898,4311040
8389,mcapuccini,13,0.00030,3891545,90.26929,4311040
8390,mdevilliers,13,0.00030,3891558,90.26959,4311040
8391,megastef,13,0.00030,3891571,90.26989,4311040
8392,messiahUA,13,0.00030,3891584,90.27019,4311040
8393,mestery,13,0.00030,3891597,90.27049,4311040
8394,mhuxtable,13,0.00030,3891610,90.27079,4311040
8395,midoblgsm,13,0.00030,3891623,90.27109,4311040
8396,migueloller,13,0.00030,3891636,90.27140,4311040
8397,mikeroyal,13,0.00030,3891649,90.27170,4311040
8398,mikeyrcamp,13,0.00030,3891662,90.27200,4311040
8399,mmirecki,13,0.00030,3891675,90.27230,4311040
8400,Mohdcode,13,0.00030,3891688,90.27260,4311040
8401,mostafaghadimi,13,0.00030,3891701,90.27290,4311040
8402,mprzygrodzki,13,0.00030,3891714,90.27321,4311040
8403,mpvaniersel,13,0.00030,3891727,90.27351,4311040
8404,murphye,13,0.00030,3891740,90.27381,4311040
8405,mvillumsen,13,0.00030,3891753,90.27411,4311040
8406,mx-psi,13,0.00030,3891766,90.27441,4311040
8407,neutronth,13,0.00030,3891779,90.27471,4311040
8408,nfirvine,13,0.00030,3891792,90.27501,4311040
8409,nick4fake,13,0.00030,3891805,90.27532,4311040
8410,nickleefly,13,0.00030,3891818,90.27562,4311040
8411,NicolaiSchmid,13,0.00030,3891831,90.27592,4311040
8412,nicolas-geniteau,13,0.00030,3891844,90.27622,4311040
8413,niconical,13,0.00030,3891857,90.27652,4311040
8414,niemeyer,13,0.00030,3891870,90.27682,4311040
8415,Nitecon,13,0.00030,3891883,90.27713,4311040
8416,nnordrum,13,0.00030,3891896,90.27743,4311040
8417,obi1kenobi,13,0.00030,3891909,90.27773,4311040
8418,omerzach,13,0.00030,3891922,90.27803,4311040
8419,omnibs,13,0.00030,3891935,90.27833,4311040
8420,onatm,13,0.00030,3891948,90.27863,4311040
8421,OvervCW,13,0.00030,3891961,90.27894,4311040
8422,patrick-east,13,0.00030,3891974,90.27924,4311040
8423,paul-rogers,13,0.00030,3891987,90.27954,4311040
8424,petr-k,13,0.00030,3892000,90.27984,4311040
8425,phyllisstein,13,0.00030,3892013,90.28014,4311040
8426,pjo256,13,0.00030,3892026,90.28044,4311040
8427,poblahblahblah,13,0.00030,3892039,90.28074,4311040
8428,popozy,13,0.00030,3892052,90.28105,4311040
8429,ppbits,13,0.00030,3892065,90.28135,4311040
8430,prefer,13,0.00030,3892078,90.28165,4311040
8431,q3k,13,0.00030,3892091,90.28195,4311040
8432,qiupeng-huacloud,13,0.00030,3892104,90.28225,4311040
8433,raftAtGit,13,0.00030,3892117,90.28255,4311040
8434,RagingPuppies,13,0.00030,3892130,90.28286,4311040
8435,rastislavszabo,13,0.00030,3892143,90.28316,4311040
8436,ravishivt,13,0.00030,3892156,90.28346,4311040
8437,rchakra3,13,0.00030,3892169,90.28376,4311040
8438,redborian,13,0.00030,3892182,90.28406,4311040
8439,rendhalver,13,0.00030,3892195,90.28436,4311040
8440,rennokki,13,0.00030,3892208,90.28466,4311040
8441,retroflexer,13,0.00030,3892221,90.28497,4311040
8442,rghdrizzle,13,0.00030,3892234,90.28527,4311040
8443,rgolangh,13,0.00030,3892247,90.28557,4311040
8444,rkttu,13,0.00030,3892260,90.28587,4311040
8445,rlewkowicz,13,0.00030,3892273,90.28617,4311040
8446,robertdavidsmith,13,0.00030,3892286,90.28647,4311040
8447,rsgowman,13,0.00030,3892299,90.28678,4311040
8448,rupalibehera,13,0.00030,3892312,90.28708,4311040
8449,rverma-nsl,13,0.00030,3892325,90.28738,4311040
8450,ryanhartje,13,0.00030,3892338,90.28768,4311040
8451,sabbox,13,0.00030,3892351,90.28798,4311040
8452,SameeraGrandhi,13,0.00030,3892364,90.28828,4311040
8453,sarasensible,13,0.00030,3892377,90.28858,4311040
8454,sathiyas,13,0.00030,3892390,90.28889,4311040
8455,ScottBrenner,13,0.00030,3892403,90.28919,4311040
8456,seenickcode,13,0.00030,3892416,90.28949,4311040
8457,seeruk,13,0.00030,3892429,90.28979,4311040
8458,seivan,13,0.00030,3892442,90.29009,4311040
8459,sgoings,13,0.00030,3892455,90.29039,4311040
8460,sgrzemski,13,0.00030,3892468,90.29070,4311040
8461,shadowshot-x,13,0.00030,3892481,90.29100,4311040
8462,simnalamburt,13,0.00030,3892494,90.29130,4311040
8463,simonvane,13,0.00030,3892507,90.29160,4311040
8464,SimpCosm,13,0.00030,3892520,90.29190,4311040
8465,skbly7,13,0.00030,3892533,90.29220,4311040
8466,sleshchenko,13,0.00030,3892546,90.29250,4311040
8467,sontek,13,0.00030,3892559,90.29281,4311040
8468,sorah,13,0.00030,3892572,90.29311,4311040
8469,spacez320,13,0.00030,3892585,90.29341,4311040
8470,speedplane,13,0.00030,3892598,90.29371,4311040
8471,stefanbethke,13,0.00030,3892611,90.29401,4311040
8472,stobias123,13,0.00030,3892624,90.29431,4311040
8473,StupidScience,13,0.00030,3892637,90.29462,4311040
8474,suhrud-kumar,13,0.00030,3892650,90.29492,4311040
8475,sukhong,13,0.00030,3892663,90.29522,4311040
8476,sureshvis,13,0.00030,3892676,90.29552,4311040
8477,sushil97,13,0.00030,3892689,90.29582,4311040
8478,swagatbora90,13,0.00030,3892702,90.29612,4311040
8479,synox,13,0.00030,3892715,90.29642,4311040
8480,TAOXUY,13,0.00030,3892728,90.29673,4311040
8481,tdemaret,13,0.00030,3892741,90.29703,4311040
8482,teochenglim,13,0.00030,3892754,90.29733,4311040
8483,tesshuflower,13,0.00030,3892767,90.29763,4311040
8484,tesspib,13,0.00030,3892780,90.29793,4311040
8485,TheAbhishekS,13,0.00030,3892793,90.29823,4311040
8486,thxCode,13,0.00030,3892806,90.29854,4311040
8487,tianyuansun,13,0.00030,3892819,90.29884,4311040
8488,tibers,13,0.00030,3892832,90.29914,4311040
8489,timbyr,13,0.00030,3892845,90.29944,4311040
8490,toadjaune,13,0.00030,3892858,90.29974,4311040
8491,tschottdorf,13,0.00030,3892871,90.30004,4311040
8492,tvon,13,0.00030,3892884,90.30035,4311040
8493,TwinProduction,13,0.00030,3892897,90.30065,4311040
8494,tyangliu,13,0.00030,3892910,90.30095,4311040
8495,usarid,13,0.00030,3892923,90.30125,4311040
8496,vasartori,13,0.00030,3892936,90.30155,4311040
8497,veophi,13,0.00030,3892949,90.30185,4311040
8498,viccuad,13,0.00030,3892962,90.30215,4311040
8499,vitorfhc,13,0.00030,3892975,90.30246,4311040
8500,vorlonofportland,13,0.00030,3892988,90.30276,4311040
8501,voron,13,0.00030,3893001,90.30306,4311040
8502,vyshane,13,0.00030,3893014,90.30336,4311040
8503,waldauf,13,0.00030,3893027,90.30366,4311040
8504,waseem,13,0.00030,3893040,90.30396,4311040
8505,whitmo,13,0.00030,3893053,90.30427,4311040
8506,willseeyou,13,0.00030,3893066,90.30457,4311040
8507,wsilva,13,0.00030,3893079,90.30487,4311040
8508,wuli-jessica,13,0.00030,3893092,90.30517,4311040
8509,xiangpingjiang,13,0.00030,3893105,90.30547,4311040
8510,yarinm,13,0.00030,3893118,90.30577,4311040
8511,yissacharcw,13,0.00030,3893131,90.30607,4311040
8512,yuval-k,13,0.00030,3893144,90.30638,4311040
8513,yuyuvn,13,0.00030,3893157,90.30668,4311040
8514,zaa,13,0.00030,3893170,90.30698,4311040
8515,zerthimon,13,0.00030,3893183,90.30728,4311040
8516,zhangheliu,13,0.00030,3893196,90.30758,4311040
8517,7ing,12,0.00028,3893208,90.30786,4311040
8518,AbdullahBM,12,0.00028,3893220,90.30814,4311040
8519,abel-von,12,0.00028,3893232,90.30842,4311040
8520,abhay-raj19,12,0.00028,3893244,90.30870,4311040
8521,Adiqq,12,0.00028,3893256,90.30897,4311040
8522,adrianlzt,12,0.00028,3893268,90.30925,4311040
8523,agemooij,12,0.00028,3893280,90.30953,4311040
8524,agomez-infoblox,12,0.00028,3893292,90.30981,4311040
8525,aidagha,12,0.00028,3893304,90.31009,4311040
8526,al3xisb,12,0.00028,3893316,90.31037,4311040
8527,alexbarcelo,12,0.00028,3893328,90.31064,4311040
8528,alexsomesan,12,0.00028,3893340,90.31092,4311040
8529,alidadar7676,12,0.00028,3893352,90.31120,4311040
8530,allanyung,12,0.00028,3893364,90.31148,4311040
8531,ambis,12,0.00028,3893376,90.31176,4311040
8532,ameir,12,0.00028,3893388,90.31204,4311040
8533,amuraru,12,0.00028,3893400,90.31231,4311040
8534,andyliuliming,12,0.00028,3893412,90.31259,4311040
8535,Anumita,12,0.00028,3893424,90.31287,4311040
8536,aramhakobyan,12,0.00028,3893436,90.31315,4311040
8537,archSeer,12,0.00028,3893448,90.31343,4311040
8538,AsherShoshan,12,0.00028,3893460,90.31371,4311040
8539,AstromechZA,12,0.00028,3893472,90.31398,4311040
8540,atomantic,12,0.00028,3893484,90.31426,4311040
8541,atorik,12,0.00028,3893496,90.31454,4311040
8542,baens,12,0.00028,3893508,90.31482,4311040
8543,bigmyx,12,0.00028,3893520,90.31510,4311040
8544,bnason,12,0.00028,3893532,90.31538,4311040
8545,bobsky,12,0.00028,3893544,90.31565,4311040
8546,botzill,12,0.00028,3893556,90.31593,4311040
8547,bpasson,12,0.00028,3893568,90.31621,4311040
8548,brankomijuskovic,12,0.00028,3893580,90.31649,4311040
8549,buo,12,0.00028,3893592,90.31677,4311040
8550,byeongjaeSon,12,0.00028,3893604,90.31705,4311040
8551,caleblloyd,12,0.00028,3893616,90.31732,4311040
8552,carlosrbcunha,12,0.00028,3893628,90.31760,4311040
8553,cbuchacher,12,0.00028,3893640,90.31788,4311040
8554,CermakM,12,0.00028,3893652,90.31816,4311040
8555,cespare,12,0.00028,3893664,90.31844,4311040
8556,ChamMach,12,0.00028,3893676,90.31872,4311040
8557,chrisjohnson,12,0.00028,3893688,90.31899,4311040
8558,clement-buchart,12,0.00028,3893700,90.31927,4311040
8559,code0x9,12,0.00028,3893712,90.31955,4311040
8560,colega,12,0.00028,3893724,90.31983,4311040
8561,cooperbenson-qz,12,0.00028,3893736,90.32011,4311040
8562,coreyperkins,12,0.00028,3893748,90.32039,4311040
8563,coryodaniel,12,0.00028,3893760,90.32067,4311040
8564,costimuraru,12,0.00028,3893772,90.32094,4311040
8565,couloum,12,0.00028,3893784,90.32122,4311040
8566,cristian04,12,0.00028,3893796,90.32150,4311040
8567,ctso,12,0.00028,3893808,90.32178,4311040
8568,curtbushko,12,0.00028,3893820,90.32206,4311040
8569,cyberh0me,12,0.00028,3893832,90.32234,4311040
8570,czomo,12,0.00028,3893844,90.32261,4311040
8571,d4l3k,12,0.00028,3893856,90.32289,4311040
8572,danieldreier,12,0.00028,3893868,90.32317,4311040
8573,dannysauer,12,0.00028,3893880,90.32345,4311040
8574,dcfranca,12,0.00028,3893892,90.32373,4311040
8575,d-cs,12,0.00028,3893904,90.32401,4311040
8576,ddseapy,12,0.00028,3893916,90.32428,4311040
8577,debankur1,12,0.00028,3893928,90.32456,4311040
8578,deinspanjer,12,0.00028,3893940,90.32484,4311040
8579,denniswebb,12,0.00028,3893952,90.32512,4311040
8580,devadvocado,12,0.00028,3893964,90.32540,4311040
8581,devx,12,0.00028,3893976,90.32568,4311040
8582,dhague,12,0.00028,3893988,90.32595,4311040
8583,dhananjaya-senanayake,12,0.00028,3894000,90.32623,4311040
8584,dklesev,12,0.00028,3894012,90.32651,4311040
8585,DmitriGekhtman,12,0.00028,3894024,90.32679,4311040
8586,dmolik,12,0.00028,3894036,90.32707,4311040
8587,docktermj,12,0.00028,3894048,90.32735,4311040
8588,DrmagicE,12,0.00028,3894060,90.32762,4311040
8589,drx777,12,0.00028,3894072,90.32790,4311040
8590,dtan4,12,0.00028,3894084,90.32818,4311040
8591,duanjiong,12,0.00028,3894096,90.32846,4311040
8592,duboisf,12,0.00028,3894108,90.32874,4311040
8593,dunglas,12,0.00028,3894120,90.32902,4311040
8594,eashi,12,0.00028,3894132,90.32929,4311040
8595,edrevo,12,0.00028,3894144,90.32957,4311040
8596,EKami,12,0.00028,3894156,90.32985,4311040
8597,Elexy,12,0.00028,3894168,90.33013,4311040
8598,elgalu,12,0.00028,3894180,90.33041,4311040
8599,elibixby,12,0.00028,3894192,90.33069,4311040
8600,e-max,12,0.00028,3894204,90.33096,4311040
8601,ereOn,12,0.00028,3894216,90.33124,4311040
8602,erks,12,0.00028,3894228,90.33152,4311040
8603,estechnical,12,0.00028,3894240,90.33180,4311040
8604,eytanhanig,12,0.00028,3894252,90.33208,4311040
8605,f10atin9,12,0.00028,3894264,90.33236,4311040
8606,fedenusy,12,0.00028,3894276,90.33263,4311040
8607,fiorix,12,0.00028,3894288,90.33291,4311040
8608,fkrestan,12,0.00028,3894300,90.33319,4311040
8609,fliphess,12,0.00028,3894312,90.33347,4311040
8610,florath,12,0.00028,3894324,90.33375,4311040
8611,florianrusch,12,0.00028,3894336,90.33403,4311040
8612,foobarbecue,12,0.00028,3894348,90.33430,4311040
8613,frost1990,12,0.00028,3894360,90.33458,4311040
8614,FWiesner,12,0.00028,3894372,90.33486,4311040
8615,gabel,12,0.00028,3894384,90.33514,4311040
8616,gabrtv,12,0.00028,3894396,90.33542,4311040
8617,gadaigadai,12,0.00028,3894408,90.33570,4311040
8618,galan,12,0.00028,3894420,90.33597,4311040
8619,Galexrt,12,0.00028,3894432,90.33625,4311040
8620,gbergere,12,0.00028,3894444,90.33653,4311040
8621,ged15,12,0.00028,3894456,90.33681,4311040
8622,geekodour,12,0.00028,3894468,90.33709,4311040
8623,georgekuruvillak,12,0.00028,3894480,90.33737,4311040
8624,ggpaue,12,0.00028,3894492,90.33764,4311040
8625,ginobiliwang,12,0.00028,3894504,90.33792,4311040
8626,gkop,12,0.00028,3894516,90.33820,4311040
8627,gkrizek,12,0.00028,3894528,90.33848,4311040
8628,glomikuz,12,0.00028,3894540,90.33876,4311040
8629,gnavgire,12,0.00028,3894552,90.33904,4311040
8630,gnawux,12,0.00028,3894564,90.33931,4311040
8631,grahamwhaley,12,0.00028,3894576,90.33959,4311040
8632,gswallow,12,0.00028,3894588,90.33987,4311040
8633,guitarrapc,12,0.00028,3894600,90.34015,4311040
8634,guohaifang,12,0.00028,3894612,90.34043,4311040
8635,Hades32,12,0.00028,3894624,90.34071,4311040
8636,HashedDan,12,0.00028,3894636,90.34099,4311040
8637,hekike,12,0.00028,3894648,90.34126,4311040
8638,HenryXie1,12,0.00028,3894660,90.34154,4311040
8639,henvic,12,0.00028,3894672,90.34182,4311040
8640,Hermain,12,0.00028,3894684,90.34210,4311040
8641,hobbytp,12,0.00028,3894696,90.34238,4311040
8642,holgero,12,0.00028,3894708,90.34266,4311040
8643,huanggze,12,0.00028,3894720,90.34293,4311040
8644,huydinhle,12,0.00028,3894732,90.34321,4311040
8645,hyunsun,12,0.00028,3894744,90.34349,4311040
8646,iamleot,12,0.00028,3894756,90.34377,4311040
8647,iantw89,12,0.00028,3894768,90.34405,4311040
8648,ibawt,12,0.00028,3894780,90.34433,4311040
8649,igcherkaev,12,0.00028,3894792,90.34460,4311040
8650,ikramulkayes,12,0.00028,3894804,90.34488,4311040
8651,intellix,12,0.00028,3894816,90.34516,4311040
8652,ipeacocks,12,0.00028,3894828,90.34544,4311040
8653,iredwards,12,0.00028,3894840,90.34572,4311040
8654,IronCore864,12,0.00028,3894852,90.34600,4311040
8655,itsc0lin,12,0.00028,3894864,90.34627,4311040
8656,ivanstanev,12,0.00028,3894876,90.34655,4311040
8657,jainbhavya65,12,0.00028,3894888,90.34683,4311040
8658,JanisOrlovs,12,0.00028,3894900,90.34711,4311040
8659,jasoncwik,12,0.00028,3894912,90.34739,4311040
8660,JaveriaK,12,0.00028,3894924,90.34767,4311040
8661,jcrugzz,12,0.00028,3894936,90.34794,4311040
8662,jgreat,12,0.00028,3894948,90.34822,4311040
8663,jharshman,12,0.00028,3894960,90.34850,4311040
8664,jhoch-palantir,12,0.00028,3894972,90.34878,4311040
8665,jim3ma,12,0.00028,3894984,90.34906,4311040
8666,joaopapereira,12,0.00028,3894996,90.34934,4311040
8667,jonstacks,12,0.00028,3895008,90.34961,4311040
8668,JossWhittle,12,0.00028,3895020,90.34989,4311040
8669,joway,12,0.00028,3895032,90.35017,4311040
8670,jrthrawny,12,0.00028,3895044,90.35045,4311040
8671,jseiser,12,0.00028,3895056,90.35073,4311040
8672,julienvincent,12,0.00028,3895068,90.35101,4311040
8673,juliusv,12,0.00028,3895080,90.35128,4311040
8674,jwesolowski-rms,12,0.00028,3895092,90.35156,4311040
8675,jwz-ecust,12,0.00028,3895104,90.35184,4311040
8676,j-zimnowoda,12,0.00028,3895116,90.35212,4311040
8677,Kanika637,12,0.00028,3895128,90.35240,4311040
8678,karlmutch,12,0.00028,3895140,90.35268,4311040
8679,KarthikNedunchezhiyan,12,0.00028,3895152,90.35295,4311040
8680,kate-goldenring,12,0.00028,3895164,90.35323,4311040
8681,kdembler,12,0.00028,3895176,90.35351,4311040
8682,kealexan,12,0.00028,3895188,90.35379,4311040
8683,kevinjkj,12,0.00028,3895200,90.35407,4311040
8684,kincl,12,0.00028,3895212,90.35435,4311040
8685,KinOSurvival,12,0.00028,3895224,90.35462,4311040
8686,kkohtaka,12,0.00028,3895236,90.35490,4311040
8687,kovetskiy,12,0.00028,3895248,90.35518,4311040
8688,krzysdabro,12,0.00028,3895260,90.35546,4311040
8689,kvaster,12,0.00028,3895272,90.35574,4311040
8690,kw217,12,0.00028,3895284,90.35602,4311040
8691,kyessenov,12,0.00028,3895296,90.35629,4311040
8692,L3n41c,12,0.00028,3895308,90.35657,4311040
8693,lackhoa,12,0.00028,3895320,90.35685,4311040
8694,lamielle,12,0.00028,3895332,90.35713,4311040
8695,Lan-ce-lot,12,0.00028,3895344,90.35741,4311040
8696,lcalcote,12,0.00028,3895356,90.35769,4311040
8697,leecalcote,12,0.00028,3895368,90.35796,4311040
8698,leo8a,12,0.00028,3895380,90.35824,4311040
8699,lhb008,12,0.00028,3895392,90.35852,4311040
8700,lionelvillard,12,0.00028,3895404,90.35880,4311040
8701,liuming-dev,12,0.00028,3895416,90.35908,4311040
8702,llamallamaduck,12,0.00028,3895428,90.35936,4311040
8703,lmxia,12,0.00028,3895440,90.35963,4311040
8704,LogicalShark,12,0.00028,3895452,90.35991,4311040
8705,lsjostro,12,0.00028,3895464,90.36019,4311040
8706,luckylittle,12,0.00028,3895476,90.36047,4311040
8707,MadVikingGod,12,0.00028,3895488,90.36075,4311040
8708,mandrean,12,0.00028,3895500,90.36103,4311040
8709,MarkRx,12,0.00028,3895512,90.36130,4311040
8710,MarkSpencerTan,12,0.00028,3895524,90.36158,4311040
8711,matjohn2,12,0.00028,3895536,90.36186,4311040
8712,mattdodge,12,0.00028,3895548,90.36214,4311040
8713,Mattias-,12,0.00028,3895560,90.36242,4311040
8714,mattmb,12,0.00028,3895572,90.36270,4311040
8715,maxbischoff,12,0.00028,3895584,90.36298,4311040
8716,mburtless,12,0.00028,3895596,90.36325,4311040
8717,mchangxe,12,0.00028,3895608,90.36353,4311040
8718,mdavidsen,12,0.00028,3895620,90.36381,4311040
8719,mfranczy,12,0.00028,3895632,90.36409,4311040
8720,michael-valdron,12,0.00028,3895644,90.36437,4311040
8721,michal-hudy,12,0.00028,3895656,90.36465,4311040
8722,michellemcone,12,0.00028,3895668,90.36492,4311040
8723,mikesimons,12,0.00028,3895680,90.36520,4311040
8724,miton18,12,0.00028,3895692,90.36548,4311040
8725,moduspwnens,12,0.00028,3895704,90.36576,4311040
8726,moleksyuk,12,0.00028,3895716,90.36604,4311040
8727,mookjp,12,0.00028,3895728,90.36632,4311040
8728,Moshe-Immerman,12,0.00028,3895740,90.36659,4311040
8729,mrsiano,12,0.00028,3895752,90.36687,4311040
8730,ms705,12,0.00028,3895764,90.36715,4311040
8731,mtcode,12,0.00028,3895776,90.36743,4311040
8732,mwl,12,0.00028,3895788,90.36771,4311040
8733,mycrEEpy,12,0.00028,3895800,90.36799,4311040
8734,nalbam,12,0.00028,3895812,90.36826,4311040
8735,narqo,12,0.00028,3895824,90.36854,4311040
8736,naumvd95,12,0.00028,3895836,90.36882,4311040
8737,nemo83,12,0.00028,3895848,90.36910,4311040
8738,ngraef,12,0.00028,3895860,90.36938,4311040
8739,nicholasmhughes,12,0.00028,3895872,90.36966,4311040
8740,nicorevin,12,0.00028,3895884,90.36993,4311040
8741,Niksko,12,0.00028,3895896,90.37021,4311040
8742,nsubrahm-aws,12,0.00028,3895908,90.37049,4311040
8743,ntavares,12,0.00028,3895920,90.37077,4311040
8744,oaktowner,12,0.00028,3895932,90.37105,4311040
8745,oboukili,12,0.00028,3895944,90.37133,4311040
8746,oleh-ozimok,12,0.00028,3895956,90.37160,4311040
8747,omBratteng,12,0.00028,3895968,90.37188,4311040
8748,pandeybk,12,0.00028,3895980,90.37216,4311040
8749,paradigm,12,0.00028,3895992,90.37244,4311040
8750,pengsrc,12,0.00028,3896004,90.37272,4311040
8751,Perfect-Web,12,0.00028,3896016,90.37300,4311040
8752,peterbourgon,12,0.00028,3896028,90.37327,4311040
8753,pgaxatte,12,0.00028,3896040,90.37355,4311040
8754,PhilippeDupont,12,0.00028,3896052,90.37383,4311040
8755,phinoceslee,12,0.00028,3896064,90.37411,4311040
8756,pjaak,12,0.00028,3896076,90.37439,4311040
8757,plumdog,12,0.00028,3896088,90.37467,4311040
8758,podnov,12,0.00028,3896100,90.37494,4311040
8759,prabdeb,12,0.00028,3896112,90.37522,4311040
8760,pshail,12,0.00028,3896124,90.37550,4311040
8761,rahulbandariSensei,12,0.00028,3896136,90.37578,4311040
8762,RajatVaryani,12,0.00028,3896148,90.37606,4311040
8763,RayBB,12,0.00028,3896160,90.37634,4311040
8764,reasonerjt,12,0.00028,3896172,90.37661,4311040
8765,rezakrimi,12,0.00028,3896184,90.37689,4311040
8766,rgl,12,0.00028,3896196,90.37717,4311040
8767,rgowrishankar,12,0.00028,3896208,90.37745,4311040
8768,rhefner1,12,0.00028,3896220,90.37773,4311040
8769,ric03uec,12,0.00028,3896232,90.37801,4311040
8770,richardwxn,12,0.00028,3896244,90.37828,4311040
8771,rickducott,12,0.00028,3896256,90.37856,4311040
8772,roedie,12,0.00028,3896268,90.37884,4311040
8773,Rozzii,12,0.00028,3896280,90.37912,4311040
8774,rposts,12,0.00028,3896292,90.37940,4311040
8775,runzhliu,12,0.00028,3896304,90.37968,4311040
8776,rwillmer,12,0.00028,3896316,90.37995,4311040
8777,ryantxu,12,0.00028,3896328,90.38023,4311040
8778,s1113950,12,0.00028,3896340,90.38051,4311040
8779,SaiedKazemi,12,0.00028,3896352,90.38079,4311040
8780,saiteja313,12,0.00028,3896364,90.38107,4311040
8781,sameersbn,12,0.00028,3896376,90.38135,4311040
8782,scheung38,12,0.00028,3896388,90.38162,4311040
8783,scraly,12,0.00028,3896400,90.38190,4311040
8784,sdake,12,0.00028,3896412,90.38218,4311040
8785,seanturner83,12,0.00028,3896424,90.38246,4311040
8786,seeker89,12,0.00028,3896436,90.38274,4311040
8787,sestegra,12,0.00028,3896448,90.38302,4311040
8788,sfeng1996,12,0.00028,3896460,90.38329,4311040
8789,sgmitchell,12,0.00028,3896472,90.38357,4311040
8790,shahaf600,12,0.00028,3896484,90.38385,4311040
8791,shaicoleman,12,0.00028,3896496,90.38413,4311040
8792,ShaileshKumar007,12,0.00028,3896508,90.38441,4311040
8793,shantanubansal,12,0.00028,3896520,90.38469,4311040
8794,silverskyvicto,12,0.00028,3896532,90.38497,4311040
8795,SimonBaeumer,12,0.00028,3896544,90.38524,4311040
8796,simon-wessel,12,0.00028,3896556,90.38552,4311040
8797,siredmar,12,0.00028,3896568,90.38580,4311040
8798,skuda,12,0.00028,3896580,90.38608,4311040
8799,SlickNik,12,0.00028,3896592,90.38636,4311040
8800,smparkes,12,0.00028,3896604,90.38664,4311040
8801,sniperking1234,12,0.00028,3896616,90.38691,4311040
8802,SpencerMalone,12,0.00028,3896628,90.38719,4311040
8803,spk83,12,0.00028,3896640,90.38747,4311040
8804,splitice,12,0.00028,3896652,90.38775,4311040
8805,starcraft66,12,0.00028,3896664,90.38803,4311040
8806,stcheng,12,0.00028,3896676,90.38831,4311040
8807,stefanhans,12,0.00028,3896688,90.38858,4311040
8808,stpierre,12,0.00028,3896700,90.38886,4311040
8809,streadway,12,0.00028,3896712,90.38914,4311040
8810,stresler,12,0.00028,3896724,90.38942,4311040
8811,subnetmarco,12,0.00028,3896736,90.38970,4311040
8812,suvl,12,0.00028,3896748,90.38998,4311040
8813,syndbg,12,0.00028,3896760,90.39025,4311040
8814,tailnode,12,0.00028,3896772,90.39053,4311040
8815,talhairfanbentley,12,0.00028,3896784,90.39081,4311040
8816,tangfeixiong,12,0.00028,3896796,90.39109,4311040
8817,theairkit,12,0.00028,3896808,90.39137,4311040
8818,thejosephstevens,12,0.00028,3896820,90.39165,4311040
8819,thoslin,12,0.00028,3896832,90.39192,4311040
8820,tobiaskohlbau,12,0.00028,3896844,90.39220,4311040
8821,toydarian,12,0.00028,3896856,90.39248,4311040
8822,Transmitt0r,12,0.00028,3896868,90.39276,4311040
8823,treed,12,0.00028,3896880,90.39304,4311040
8824,tristanpemble,12,0.00028,3896892,90.39332,4311040
8825,Tzrlk,12,0.00028,3896904,90.39359,4311040
8826,ublubu,12,0.00028,3896916,90.39387,4311040
8827,unixorn,12,0.00028,3896928,90.39415,4311040
8828,wallaceicy06,12,0.00028,3896940,90.39443,4311040
8829,wasup-yash,12,0.00028,3896952,90.39471,4311040
8830,whitel,12,0.00028,3896964,90.39499,4311040
8831,willtrnr,12,0.00028,3896976,90.39526,4311040
8832,WillWcchan,12,0.00028,3896988,90.39554,4311040
8833,wleese,12,0.00028,3897000,90.39582,4311040
8834,wwsean08,12,0.00028,3897012,90.39610,4311040
8835,xiaojiey,12,0.00028,3897024,90.39638,4311040
8836,xoxbet,12,0.00028,3897036,90.39666,4311040
8837,xtreme-sameer-vohra,12,0.00028,3897048,90.39693,4311040
8838,yanc0,12,0.00028,3897060,90.39721,4311040
8839,yashp1402,12,0.00028,3897072,90.39749,4311040
8840,yeahdongcn,12,0.00028,3897084,90.39777,4311040
8841,yongjie-gong,12,0.00028,3897096,90.39805,4311040
8842,YP28,12,0.00028,3897108,90.39833,4311040
8843,yuansmin,12,0.00028,3897120,90.39860,4311040
8844,yurishkuro,12,0.00028,3897132,90.39888,4311040
8845,zadigus,12,0.00028,3897144,90.39916,4311040
8846,Zapadlo,12,0.00028,3897156,90.39944,4311040
8847,zh168654,12,0.00028,3897168,90.39972,4311040
8848,Zhomart,12,0.00028,3897180,90.40000,4311040
8849,zmt,12,0.00028,3897192,90.40027,4311040
8850,zrks,12,0.00028,3897204,90.40055,4311040
8851,zvlb,12,0.00028,3897216,90.40083,4311040
8852,2color,11,0.00026,3897227,90.40109,4311040
8853,a8m,11,0.00026,3897238,90.40134,4311040
8854,abatilo,11,0.00026,3897249,90.40160,4311040
8855,abergmeier,11,0.00026,3897260,90.40185,4311040
8856,abraithwaite,11,0.00026,3897271,90.40211,4311040
8857,actgardner,11,0.00026,3897282,90.40236,4311040
8858,adamcharnock,11,0.00026,3897293,90.40262,4311040
8859,AdamSharif-MSFT,11,0.00026,3897304,90.40287,4311040
8860,ademariag,11,0.00026,3897315,90.40313,4311040
8861,adibrastegarnia,11,0.00026,3897326,90.40338,4311040
8862,adleong,11,0.00026,3897337,90.40364,4311040
8863,agniveshadhikari,11,0.00026,3897348,90.40389,4311040
8864,ahawtho,11,0.00026,3897359,90.40415,4311040
8865,akhil-rane,11,0.00026,3897370,90.40440,4311040
8866,alanbover,11,0.00026,3897381,90.40466,4311040
8867,AlbertoPeon,11,0.00026,3897392,90.40491,4311040
8868,alexanderbuhler,11,0.00026,3897403,90.40517,4311040
8869,alexcouper,11,0.00026,3897414,90.40542,4311040
8870,alexku7,11,0.00026,3897425,90.40568,4311040
8871,Alien2150,11,0.00026,3897436,90.40593,4311040
8872,alifiroozi80,11,0.00026,3897447,90.40619,4311040
8873,alpeb,11,0.00026,3897458,90.40644,4311040
8874,ALRubinger,11,0.00026,3897469,90.40670,4311040
8875,amargherio,11,0.00026,3897480,90.40696,4311040
8876,ambguo,11,0.00026,3897491,90.40721,4311040
8877,AmitKumarDas,11,0.00026,3897502,90.40747,4311040
8878,AmitVishwash,11,0.00026,3897513,90.40772,4311040
8879,anarcat,11,0.00026,3897524,90.40798,4311040
8880,angapov,11,0.00026,3897535,90.40823,4311040
8881,anupash147,11,0.00026,3897546,90.40849,4311040
8882,apollocse,11,0.00026,3897557,90.40874,4311040
8883,ArcticSnowman,11,0.00026,3897568,90.40900,4311040
8884,ArenaSu,11,0.00026,3897579,90.40925,4311040
8885,arisu1000,11,0.00026,3897590,90.40951,4311040
8886,arjunsingri,11,0.00026,3897601,90.40976,4311040
8887,arthurlogilab,11,0.00026,3897612,90.41002,4311040
8888,augabet,11,0.00026,3897623,90.41027,4311040
8889,autrilla,11,0.00026,3897634,90.41053,4311040
8890,aw185176,11,0.00026,3897645,90.41078,4311040
8891,axelsteingrimsson,11,0.00026,3897656,90.41104,4311040
8892,banjot,11,0.00026,3897667,90.41129,4311040
8893,benbc,11,0.00026,3897678,90.41155,4311040
8894,benjamincburns,11,0.00026,3897689,90.41180,4311040
8895,beriberikix,11,0.00026,3897700,90.41206,4311040
8896,bethaitman,11,0.00026,3897711,90.41231,4311040
8897,better0332,11,0.00026,3897722,90.41257,4311040
8898,bgauduch,11,0.00026,3897733,90.41282,4311040
8899,bismarck,11,0.00026,3897744,90.41308,4311040
8900,blackpiglet,11,0.00026,3897755,90.41333,4311040
8901,brandonweeks,11,0.00026,3897766,90.41359,4311040
8902,BrendanBall,11,0.00026,3897777,90.41384,4311040
8903,brunowoo,11,0.00026,3897788,90.41410,4311040
8904,brycecarman,11,0.00026,3897799,90.41435,4311040
8905,btrx-rkazi,11,0.00026,3897810,90.41461,4311040
8906,budimanjojo,11,0.00026,3897821,90.41487,4311040
8907,campionfellin,11,0.00026,3897832,90.41512,4311040
8908,cboggs,11,0.00026,3897843,90.41538,4311040
8909,cdmurph32,11,0.00026,3897854,90.41563,4311040
8910,ceason,11,0.00026,3897865,90.41589,4311040
8911,celebdor,11,0.00026,3897876,90.41614,4311040
8912,cfstras,11,0.00026,3897887,90.41640,4311040
8913,chadlwilson,11,0.00026,3897898,90.41665,4311040
8914,chanezon,11,0.00026,3897909,90.41691,4311040
8915,CharlieC3,11,0.00026,3897920,90.41716,4311040
8916,chaudyg,11,0.00026,3897931,90.41742,4311040
8917,Checksumz,11,0.00026,3897942,90.41767,4311040
8918,chrispoole643,11,0.00026,3897953,90.41793,4311040
8919,clairealyssa,11,0.00026,3897964,90.41818,4311040
8920,clehene,11,0.00026,3897975,90.41844,4311040
8921,cmaster11,11,0.00026,3897986,90.41869,4311040
8922,cmur2,11,0.00026,3897997,90.41895,4311040
8923,cniket,11,0.00026,3898008,90.41920,4311040
8924,ColdFire87,11,0.00026,3898019,90.41946,4311040
8925,corvus-ch,11,0.00026,3898030,90.41971,4311040
8926,crazy-canux,11,0.00026,3898041,90.41997,4311040
8927,csandanov,11,0.00026,3898052,90.42022,4311040
8928,csworm-rudraksha,11,0.00026,3898063,90.42048,4311040
8929,danielbryantuk,11,0.00026,3898074,90.42073,4311040
8930,danielsand,11,0.00026,3898085,90.42099,4311040
8931,danielwegener,11,0.00026,3898096,90.42124,4311040
8932,dankenigsberg,11,0.00026,3898107,90.42150,4311040
8933,danmx,11,0.00026,3898118,90.42175,4311040
8934,dastrobu,11,0.00026,3898129,90.42201,4311040
8935,DavadDi,11,0.00026,3898140,90.42226,4311040
8936,defyjoy,11,0.00026,3898151,90.42252,4311040
8937,deiga,11,0.00026,3898162,90.42278,4311040
8938,deining,11,0.00026,3898173,90.42303,4311040
8939,dickeyf,11,0.00026,3898184,90.42329,4311040
8940,dipendrachaudhary,11,0.00026,3898195,90.42354,4311040
8941,djamaile,11,0.00026,3898206,90.42380,4311040
8942,dllegru,11,0.00026,3898217,90.42405,4311040
8943,dolphyvn,11,0.00026,3898228,90.42431,4311040
8944,dongziming,11,0.00026,3898239,90.42456,4311040
8945,dorsany,11,0.00026,3898250,90.42482,4311040
8946,dpc,11,0.00026,3898261,90.42507,4311040
8947,dragon3,11,0.00026,3898272,90.42533,4311040
8948,Drupi,11,0.00026,3898283,90.42558,4311040
8949,dts,11,0.00026,3898294,90.42584,4311040
8950,dzr0001,11,0.00026,3898305,90.42609,4311040
8951,eddiesimeon,11,0.00026,3898316,90.42635,4311040
8952,eduever,11,0.00026,3898327,90.42660,4311040
8953,EdVinyard,11,0.00026,3898338,90.42686,4311040
8954,elemental-lf,11,0.00026,3898349,90.42711,4311040
8955,eljefedelrodeodeljefe,11,0.00026,3898360,90.42737,4311040
8956,elordahl,11,0.00026,3898371,90.42762,4311040
8957,emailtovamos,11,0.00026,3898382,90.42788,4311040
8958,erSitzt,11,0.00026,3898393,90.42813,4311040
8959,esteban1983cl,11,0.00026,3898404,90.42839,4311040
8960,evilnick,11,0.00026,3898415,90.42864,4311040
8961,fcantournet,11,0.00026,3898426,90.42890,4311040
8962,fdegir,11,0.00026,3898437,90.42915,4311040
8963,feluxe,11,0.00026,3898448,90.42941,4311040
8964,feniix,11,0.00026,3898459,90.42966,4311040
8965,fgogolli,11,0.00026,3898470,90.42992,4311040
8966,filippog,11,0.00026,3898481,90.43017,4311040
8967,flaviomoringa,11,0.00026,3898492,90.43043,4311040
8968,Foritus,11,0.00026,3898503,90.43068,4311040
8969,gaigepr,11,0.00026,3898514,90.43094,4311040
8970,geoand,11,0.00026,3898525,90.43120,4311040
8971,georgekaz,11,0.00026,3898536,90.43145,4311040
8972,gertvdijk,11,0.00026,3898547,90.43171,4311040
8973,ggtools,11,0.00026,3898558,90.43196,4311040
8974,Ghosgt,11,0.00026,3898569,90.43222,4311040
8975,gireeshpunathil,11,0.00026,3898580,90.43247,4311040
8976,gitfool,11,0.00026,3898591,90.43273,4311040
8977,gonzalobarbitta,11,0.00026,3898602,90.43298,4311040
8978,govindKAG,11,0.00026,3898613,90.43324,4311040
8979,greatbsky,11,0.00026,3898624,90.43349,4311040
8980,guanzo,11,0.00026,3898635,90.43375,4311040
8981,guyromb,11,0.00026,3898646,90.43400,4311040
8982,gWOLF3,11,0.00026,3898657,90.43426,4311040
8983,halkeye,11,0.00026,3898668,90.43451,4311040
8984,haojue,11,0.00026,3898679,90.43477,4311040
8985,hardillb,11,0.00026,3898690,90.43502,4311040
8986,harsha-y,11,0.00026,3898701,90.43528,4311040
8987,hayderimran7,11,0.00026,3898712,90.43553,4311040
8988,hernandanielg,11,0.00026,3898723,90.43579,4311040
8989,hoatle,11,0.00026,3898734,90.43604,4311040
8990,hobbsh,11,0.00026,3898745,90.43630,4311040
8991,Hongbo-Miao,11,0.00026,3898756,90.43655,4311040
8992,hyunchel,11,0.00026,3898767,90.43681,4311040
8993,iamejboy,11,0.00026,3898778,90.43706,4311040
8994,ikester,11,0.00026,3898789,90.43732,4311040
8995,iliazlobin,11,0.00026,3898800,90.43757,4311040
8996,imyashvinder,11,0.00026,3898811,90.43783,4311040
8997,Industrial,11,0.00026,3898822,90.43808,4311040
8998,infinitydon,11,0.00026,3898833,90.43834,4311040
8999,intlabs,11,0.00026,3898844,90.43859,4311040
9000,irlevesque,11,0.00026,3898855,90.43885,4311040
9001,isa-bel,11,0.00026,3898866,90.43911,4311040
9002,Israphel,11,0.00026,3898877,90.43936,4311040
9003,isubuz,11,0.00026,3898888,90.43962,4311040
9004,j14s,11,0.00026,3898899,90.43987,4311040
9005,Jaanki,11,0.00026,3898910,90.44013,4311040
9006,jabbrwcky,11,0.00026,3898921,90.44038,4311040
9007,Jacobh2,11,0.00026,3898932,90.44064,4311040
9008,jaideepr97,11,0.00026,3898943,90.44089,4311040
9009,jaimehrubiks,11,0.00026,3898954,90.44115,4311040
9010,jakoberpf,11,0.00026,3898965,90.44140,4311040
9011,jakubbujny,11,0.00026,3898976,90.44166,4311040
9012,jameshochadel,11,0.00026,3898987,90.44191,4311040
9013,jaredstehler,11,0.00026,3898998,90.44217,4311040
9014,jay-rob,11,0.00026,3899009,90.44242,4311040
9015,jeesmon,11,0.00026,3899020,90.44268,4311040
9016,jeffpearce,11,0.00026,3899031,90.44293,4311040
9017,jeunii,11,0.00026,3899042,90.44319,4311040
9018,jgehrcke,11,0.00026,3899053,90.44344,4311040
9019,jiangyuzhao,11,0.00026,3899064,90.44370,4311040
9020,jianjuns,11,0.00026,3899075,90.44395,4311040
9021,jinguang-dong,11,0.00026,3899086,90.44421,4311040
9022,jmontleon,11,0.00026,3899097,90.44446,4311040
9023,jnpacker,11,0.00026,3899108,90.44472,4311040
9024,johnbieren,11,0.00026,3899119,90.44497,4311040
9025,jonas,11,0.00026,3899130,90.44523,4311040
9026,jongio,11,0.00026,3899141,90.44548,4311040
9027,jonmosco,11,0.00026,3899152,90.44574,4311040
9028,jon-walton,11,0.00026,3899163,90.44599,4311040
9029,jordigilh,11,0.00026,3899174,90.44625,4311040
9030,JorenZ,11,0.00026,3899185,90.44650,4311040
9031,josegob,11,0.00026,3899196,90.44676,4311040
9032,joselamego,11,0.00026,3899207,90.44702,4311040
9033,joshiste,11,0.00026,3899218,90.44727,4311040
9034,joshulyne,11,0.00026,3899229,90.44753,4311040
9035,jpkrohling,11,0.00026,3899240,90.44778,4311040
9036,jqlu,11,0.00026,3899251,90.44804,4311040
9037,JRemitz,11,0.00026,3899262,90.44829,4311040
9038,jsolbrig,11,0.00026,3899273,90.44855,4311040
9039,JubayerJoy,11,0.00026,3899284,90.44880,4311040
9040,Junnplus,11,0.00026,3899295,90.44906,4311040
9041,k,11,0.00026,3899306,90.44931,4311040
9042,kalise,11,0.00026,3899317,90.44957,4311040
9043,kazukousen,11,0.00026,3899328,90.44982,4311040
9044,kdorosh,11,0.00026,3899339,90.45008,4311040
9045,kewynakshlley,11,0.00026,3899350,90.45033,4311040
9046,kgnanaprakasam,11,0.00026,3899361,90.45059,4311040
9047,KMilhan,11,0.00026,3899372,90.45084,4311040
9048,kmindi,11,0.00026,3899383,90.45110,4311040
9049,kramerul,11,0.00026,3899394,90.45135,4311040
9050,laudibert,11,0.00026,3899405,90.45161,4311040
9051,leo-baltus,11,0.00026,3899416,90.45186,4311040
9052,LEW21,11,0.00026,3899427,90.45212,4311040
9053,LittleBoy18,11,0.00026,3899438,90.45237,4311040
9054,liuan1986,11,0.00026,3899449,90.45263,4311040
9055,lkirill,11,0.00026,3899460,90.45288,4311040
9056,lkysow,11,0.00026,3899471,90.45314,4311040
9057,lonng,11,0.00026,3899482,90.45339,4311040
9058,maan19,11,0.00026,3899493,90.45365,4311040
9059,Magicloud,11,0.00026,3899504,90.45390,4311040
9060,magmax,11,0.00026,3899515,90.45416,4311040
9061,mairin,11,0.00026,3899526,90.45441,4311040
9062,makusu2,11,0.00026,3899537,90.45467,4311040
9063,mamachanko,11,0.00026,3899548,90.45493,4311040
9064,manigandham,11,0.00026,3899559,90.45518,4311040
9065,marceliwac,11,0.00026,3899570,90.45544,4311040
9066,marga-kinvolk,11,0.00026,3899581,90.45569,4311040
9067,markapruett,11,0.00026,3899592,90.45595,4311040
9068,mastersingh24,11,0.00026,3899603,90.45620,4311040
9069,matgomes21,11,0.00026,3899614,90.45646,4311040
9070,matkam,11,0.00026,3899625,90.45671,4311040
9071,mbolek,11,0.00026,3899636,90.45697,4311040
9072,mikekim,11,0.00026,3899647,90.45722,4311040
9073,mkbhanda,11,0.00026,3899658,90.45748,4311040
9074,mmumshad,11,0.00026,3899669,90.45773,4311040
9075,MohGeek,11,0.00026,3899680,90.45799,4311040
9076,mpasternacki,11,0.00026,3899691,90.45824,4311040
9077,mpolednik,11,0.00026,3899702,90.45850,4311040
9078,msohn,11,0.00026,3899713,90.45875,4311040
9079,NamikoToriyama,11,0.00026,3899724,90.45901,4311040
9080,Nanfei-Chen,11,0.00026,3899735,90.45926,4311040
9081,nasirhm,11,0.00026,3899746,90.45952,4311040
9082,ndesh26,11,0.00026,3899757,90.45977,4311040
9083,nickolaev,11,0.00026,3899768,90.46003,4311040
9084,nikhilchauhangithub,11,0.00026,3899779,90.46028,4311040
9085,nikhilk,11,0.00026,3899790,90.46054,4311040
9086,nishantsikarwar,11,0.00026,3899801,90.46079,4311040
9087,niuhp,11,0.00026,3899812,90.46105,4311040
9088,njhale,11,0.00026,3899823,90.46130,4311040
9089,nkvoll,11,0.00026,3899834,90.46156,4311040
9090,nrdlngr,11,0.00026,3899845,90.46181,4311040
9091,oicheryl,11,0.00026,3899856,90.46207,4311040
9092,olegmayko,11,0.00026,3899867,90.46232,4311040
9093,oliverisaac,11,0.00026,3899878,90.46258,4311040
9094,omerbensaadon,11,0.00026,3899889,90.46283,4311040
9095,ozhuraki,11,0.00026,3899900,90.46309,4311040
9096,paivagustavo,11,0.00026,3899911,90.46335,4311040
9097,palade,11,0.00026,3899922,90.46360,4311040
9098,PascalKu,11,0.00026,3899933,90.46386,4311040
9099,pat2man,11,0.00026,3899944,90.46411,4311040
9100,paulcastro,11,0.00026,3899955,90.46437,4311040
9101,paultag,11,0.00026,3899966,90.46462,4311040
9102,petervandenabeele,11,0.00026,3899977,90.46488,4311040
9103,pgdagenais,11,0.00026,3899988,90.46513,4311040
9104,phantasm66,11,0.00026,3899999,90.46539,4311040
9105,philliphoff,11,0.00026,3900010,90.46564,4311040
9106,phs,11,0.00026,3900021,90.46590,4311040
9107,pierrchen,11,0.00026,3900032,90.46615,4311040
9108,pigboysid,11,0.00026,3900043,90.46641,4311040
9109,pisymbol,11,0.00026,3900054,90.46666,4311040
9110,pnowaczyk,11,0.00026,3900065,90.46692,4311040
9111,PradeepKumar-15,11,0.00026,3900076,90.46717,4311040
9112,PriyaModali,11,0.00026,3900087,90.46743,4311040
9113,przemek-lal,11,0.00026,3900098,90.46768,4311040
9114,pwnb0y,11,0.00026,3900109,90.46794,4311040
9115,rajdhandus,11,0.00026,3900120,90.46819,4311040
9116,rajeeshckr,11,0.00026,3900131,90.46845,4311040
9117,raoofm,11,0.00026,3900142,90.46870,4311040
9118,raykrueger,11,0.00026,3900153,90.46896,4311040
9119,rccrdpccl,11,0.00026,3900164,90.46921,4311040
9120,remonlam,11,0.00026,3900175,90.46947,4311040
9121,rentseen,11,0.00026,3900186,90.46972,4311040
9122,rforberger,11,0.00026,3900197,90.46998,4311040
9123,ricardo-larosa,11,0.00026,3900208,90.47023,4311040
9124,RicardoNalesAmato,11,0.00026,3900219,90.47049,4311040
9125,ringods,11,0.00026,3900230,90.47074,4311040
9126,rishitashaw,11,0.00026,3900241,90.47100,4311040
9127,riupie,11,0.00026,3900252,90.47126,4311040
9128,rogeralsing,11,0.00026,3900263,90.47151,4311040
9129,rohanand,11,0.00026,3900274,90.47177,4311040
9130,RomanenkoDenys,11,0.00026,3900285,90.47202,4311040
9131,roobre,11,0.00026,3900296,90.47228,4311040
9132,roopakparikh,11,0.00026,3900307,90.47253,4311040
9133,RouxAntoine,11,0.00026,3900318,90.47279,4311040
9134,rsadowsk,11,0.00026,3900329,90.47304,4311040
9135,ruifung,11,0.00026,3900340,90.47330,4311040
9136,samdamana,11,0.00026,3900351,90.47355,4311040
9137,Sandeep-source,11,0.00026,3900362,90.47381,4311040
9138,SaschaHeyer,11,0.00026,3900373,90.47406,4311040
9139,sbrandtb,11,0.00026,3900384,90.47432,4311040
9140,sbuvaneshkumar,11,0.00026,3900395,90.47457,4311040
9141,scr-oath,11,0.00026,3900406,90.47483,4311040
9142,sdouche,11,0.00026,3900417,90.47508,4311040
9143,sergeohl,11,0.00026,3900428,90.47534,4311040
9144,sergeyevstifeev,11,0.00026,3900439,90.47559,4311040
9145,sfitts,11,0.00026,3900450,90.47585,4311040
9146,Shabirmean,11,0.00026,3900461,90.47610,4311040
9147,Shaked,11,0.00026,3900472,90.47636,4311040
9148,shettyh,11,0.00026,3900483,90.47661,4311040
9149,ShimiT,11,0.00026,3900494,90.47687,4311040
9150,sio4,11,0.00026,3900505,90.47712,4311040
9151,skmkzyk,11,0.00026,3900516,90.47738,4311040
9152,slayerjain,11,0.00026,3900527,90.47763,4311040
9153,snstanton,11,0.00026,3900538,90.47789,4311040
9154,soolaugust,11,0.00026,3900549,90.47814,4311040
9155,south37,11,0.00026,3900560,90.47840,4311040
9156,sshishov,11,0.00026,3900571,90.47865,4311040
9157,stanhu,11,0.00026,3900582,90.47891,4311040
9158,stemid,11,0.00026,3900593,90.47917,4311040
9159,stevenschlansker,11,0.00026,3900604,90.47942,4311040
9160,strangeminds,11,0.00026,3900615,90.47968,4311040
9161,sudhi-vm,11,0.00026,3900626,90.47993,4311040
9162,superseb,11,0.00026,3900637,90.48019,4311040
9163,SurajPratap10,11,0.00026,3900648,90.48044,4311040
9164,SwanSpouse,11,0.00026,3900659,90.48070,4311040
9165,SydOps,11,0.00026,3900670,90.48095,4311040
9166,sylus,11,0.00026,3900681,90.48121,4311040
9167,tabern,11,0.00026,3900692,90.48146,4311040
9168,tallt0m,11,0.00026,3900703,90.48172,4311040
9169,tamama,11,0.00026,3900714,90.48197,4311040
9170,tealee1992,11,0.00026,3900725,90.48223,4311040
9171,thangbn,11,0.00026,3900736,90.48248,4311040
9172,thebigjc,11,0.00026,3900747,90.48274,4311040
9173,thepaulmacca,11,0.00026,3900758,90.48299,4311040
9174,thernstig,11,0.00026,3900769,90.48325,4311040
9175,TheStalwart,11,0.00026,3900780,90.48350,4311040
9176,timdorr,11,0.00026,3900791,90.48376,4311040
9177,TJM,11,0.00026,3900802,90.48401,4311040
9178,tk3fftk,11,0.00026,3900813,90.48427,4311040
9179,tPl0ch,11,0.00026,3900824,90.48452,4311040
9180,tscherf,11,0.00026,3900835,90.48478,4311040
9181,tsunamishaun,11,0.00026,3900846,90.48503,4311040
9182,tutaidalal,11,0.00026,3900857,90.48529,4311040
9183,tvieira,11,0.00026,3900868,90.48554,4311040
9184,unterstein,11,0.00026,3900879,90.48580,4311040
9185,vasa47,11,0.00026,3900890,90.48605,4311040
9186,vasu1124,11,0.00026,3900901,90.48631,4311040
9187,Vaxuite,11,0.00026,3900912,90.48656,4311040
9188,virtuald,11,0.00026,3900923,90.48682,4311040
9189,vongohren,11,0.00026,3900934,90.48708,4311040
9190,wang-mask,11,0.00026,3900945,90.48733,4311040
9191,warroyo,11,0.00026,3900956,90.48759,4311040
9192,watercraft,11,0.00026,3900967,90.48784,4311040
9193,Wayt,11,0.00026,3900978,90.48810,4311040
9194,weargoggles,11,0.00026,3900989,90.48835,4311040
9195,weizhoublue,11,0.00026,3901000,90.48861,4311040
9196,WesCossick,11,0.00026,3901011,90.48886,4311040
9197,wilkers-steve,11,0.00026,3901022,90.48912,4311040
9198,wlawton,11,0.00026,3901033,90.48937,4311040
9199,wojciechka,11,0.00026,3901044,90.48963,4311040
9200,wokaoo1234,11,0.00026,3901055,90.48988,4311040
9201,WPH95,11,0.00026,3901066,90.49014,4311040
9202,wryun,11,0.00026,3901077,90.49039,4311040
9203,wyb1,11,0.00026,3901088,90.49065,4311040
9204,xcoulon,11,0.00026,3901099,90.49090,4311040
9205,xiaogaozi,11,0.00026,3901110,90.49116,4311040
9206,xiao-zhou,11,0.00026,3901121,90.49141,4311040
9207,xiejunan,11,0.00026,3901132,90.49167,4311040
9208,xmlking,11,0.00026,3901143,90.49192,4311040
9209,xuchenhao001,11,0.00026,3901154,90.49218,4311040
9210,yaacov,11,0.00026,3901165,90.49243,4311040
9211,yahavb,11,0.00026,3901176,90.49269,4311040
9212,YangKeao,11,0.00026,3901187,90.49294,4311040
9213,Yasumoto,11,0.00026,3901198,90.49320,4311040
9214,ynqa,11,0.00026,3901209,90.49345,4311040
9215,yoanisgil,11,0.00026,3901220,90.49371,4311040
9216,yogendra,11,0.00026,3901231,90.49396,4311040
9217,yuriipolishchuk,11,0.00026,3901242,90.49422,4311040
9218,zaneclaes,11,0.00026,3901253,90.49447,4311040
9219,Zeka13,11,0.00026,3901264,90.49473,4311040
9220,Zempashi,11,0.00026,3901275,90.49498,4311040
9221,zeusro,11,0.00026,3901286,90.49524,4311040
9222,zhangtbj,11,0.00026,3901297,90.49550,4311040
9223,ZhuGongpu,11,0.00026,3901308,90.49575,4311040
9224,zhxqgithub,11,0.00026,3901319,90.49601,4311040
9225,zllovesuki,11,0.00026,3901330,90.49626,4311040
9226,123BLiN,10,0.00023,3901340,90.49649,4311040
9227,245347881,10,0.00023,3901350,90.49672,4311040
9228,4c0n,10,0.00023,3901360,90.49696,4311040
9229,aadi58002,10,0.00023,3901370,90.49719,4311040
9230,aaronhenshaw,10,0.00023,3901380,90.49742,4311040
9231,AAzza,10,0.00023,3901390,90.49765,4311040
9232,abevoelker,10,0.00023,3901400,90.49788,4311040
9233,acaire,10,0.00023,3901410,90.49812,4311040
9234,achew22,10,0.00023,3901420,90.49835,4311040
9235,adambom,10,0.00023,3901430,90.49858,4311040
9236,adamglt,10,0.00023,3901440,90.49881,4311040
9237,Addono,10,0.00023,3901450,90.49904,4311040
9238,adithyaakrishna,10,0.00023,3901460,90.49928,4311040
9239,adoy,10,0.00023,3901470,90.49951,4311040
9240,aee11,10,0.00023,3901480,90.49974,4311040
9241,aegershman,10,0.00023,3901490,90.49997,4311040
9242,aelij,10,0.00023,3901500,90.50020,4311040
9243,agardnerIT,10,0.00023,3901510,90.50044,4311040
9244,aharbis,10,0.00023,3901520,90.50067,4311040
9245,ahilmathew,10,0.00023,3901530,90.50090,4311040
9246,airadier,10,0.00023,3901540,90.50113,4311040
9247,ajbouh,10,0.00023,3901550,90.50136,4311040
9248,alanlekah,10,0.00023,3901560,90.50160,4311040
9249,alefray,10,0.00023,3901570,90.50183,4311040
9250,AlexChesser,10,0.00023,3901580,90.50206,4311040
9251,alexfornuto,10,0.00023,3901590,90.50229,4311040
9252,alexmavr,10,0.00023,3901600,90.50252,4311040
9253,Alexx-G,10,0.00023,3901610,90.50276,4311040
9254,allanchau,10,0.00023,3901620,90.50299,4311040
9255,allenpetersen,10,0.00023,3901630,90.50322,4311040
9256,andahme,10,0.00023,3901640,90.50345,4311040
9257,andloh,10,0.00023,3901650,90.50368,4311040
9258,andrenarchy,10,0.00023,3901660,90.50392,4311040
9259,Anilkumar56,10,0.00023,3901670,90.50415,4311040
9260,anmolsachan,10,0.00023,3901680,90.50438,4311040
9261,antmanler,10,0.00023,3901690,90.50461,4311040
9262,apaatsio,10,0.00023,3901700,90.50484,4311040
9263,aranair,10,0.00023,3901710,90.50508,4311040
9264,armab,10,0.00023,3901720,90.50531,4311040
9265,armandgrillet,10,0.00023,3901730,90.50554,4311040
9266,artemkoslenkov,10,0.00023,3901740,90.50577,4311040
9267,arthurdm,10,0.00023,3901750,90.50600,4311040
9268,artushin,10,0.00023,3901760,90.50624,4311040
9269,arunabhabanerjee,10,0.00023,3901770,90.50647,4311040
9270,arundeep78,10,0.00023,3901780,90.50670,4311040
9271,aulanov,10,0.00023,3901790,90.50693,4311040
9272,autumn0207,10,0.00023,3901800,90.50716,4311040
9273,baryluk,10,0.00023,3901810,90.50739,4311040
9274,beanssoft,10,0.00023,3901820,90.50763,4311040
9275,ben-ihelputech,10,0.00023,3901830,90.50786,4311040
9276,BenjaminHuang,10,0.00023,3901840,90.50809,4311040
9277,benley,10,0.00023,3901850,90.50832,4311040
9278,bjoernrost,10,0.00023,3901860,90.50855,4311040
9279,bjornbouetsmith,10,0.00023,3901870,90.50879,4311040
9280,bnutt,10,0.00023,3901880,90.50902,4311040
9281,booleanbetrayal,10,0.00023,3901890,90.50925,4311040
9282,branttaylor,10,0.00023,3901900,90.50948,4311040
9283,BrentDorsey,10,0.00023,3901910,90.50971,4311040
9284,briansmith,10,0.00023,3901920,90.50995,4311040
9285,brichins,10,0.00023,3901930,90.51018,4311040
9286,brunosaboia,10,0.00023,3901940,90.51041,4311040
9287,bsnchan,10,0.00023,3901950,90.51064,4311040
9288,caedev,10,0.00023,3901960,90.51087,4311040
9289,camilosantana,10,0.00023,3901970,90.51111,4311040
9290,carlbraganza,10,0.00023,3901980,90.51134,4311040
9291,carlosdamazio,10,0.00023,3901990,90.51157,4311040
9292,carnott-snap,10,0.00023,3902000,90.51180,4311040
9293,cchapla,10,0.00023,3902010,90.51203,4311040
9294,ceesios,10,0.00023,3902020,90.51227,4311040
9295,cgruver,10,0.00023,3902030,90.51250,4311040
9296,chaintng,10,0.00023,3902040,90.51273,4311040
9297,charan1998,10,0.00023,3902050,90.51296,4311040
9298,chris922,10,0.00023,3902060,90.51319,4311040
9299,chris-ng-scmp,10,0.00023,3902070,90.51343,4311040
9300,cilerler,10,0.00023,3902080,90.51366,4311040
9301,cjhomour,10,0.00023,3902090,90.51389,4311040
9302,cmdallas,10,0.00023,3902100,90.51412,4311040
9303,CodingCanuck,10,0.00023,3902110,90.51435,4311040
9304,corehello,10,0.00023,3902120,90.51459,4311040
9305,corlettb,10,0.00023,3902130,90.51482,4311040
9306,coryfklein,10,0.00023,3902140,90.51505,4311040
9307,ctrlaltdel,10,0.00023,3902150,90.51528,4311040
9308,CVirus,10,0.00023,3902160,90.51551,4311040
9309,cwayne18,10,0.00023,3902170,90.51575,4311040
9310,DanielJonesEB,10,0.00023,3902180,90.51598,4311040
9311,DanielMcAssey,10,0.00023,3902190,90.51621,4311040
9312,dano0b,10,0.00023,3902200,90.51644,4311040
9313,davidebianchi,10,0.00023,3902210,90.51667,4311040
9314,DavidJacob,10,0.00023,3902220,90.51691,4311040
9315,davidmatson,10,0.00023,3902230,90.51714,4311040
9316,dawidd6,10,0.00023,3902240,90.51737,4311040
9317,ddbmh,10,0.00023,3902250,90.51760,4311040
9318,deathowl,10,0.00023,3902260,90.51783,4311040
9319,deepakcpakhale06,10,0.00023,3902270,90.51807,4311040
9320,Devesh-N,10,0.00023,3902280,90.51830,4311040
9321,diclophis,10,0.00023,3902290,90.51853,4311040
9322,divyangjp,10,0.00023,3902300,90.51876,4311040
9323,dkhachyan,10,0.00023,3902310,90.51899,4311040
9324,d-m,10,0.00023,3902320,90.51923,4311040
9325,dmitris,10,0.00023,3902330,90.51946,4311040
9326,drf,10,0.00023,3902340,90.51969,4311040
9327,droopy4096,10,0.00023,3902350,90.51992,4311040
9328,dsalamancaMS,10,0.00023,3902360,90.52015,4311040
9329,dshamanthreddy,10,0.00023,3902370,90.52038,4311040
9330,dustinspecker,10,0.00023,3902380,90.52062,4311040
9331,eden,10,0.00023,3902390,90.52085,4311040
9332,edernucci,10,0.00023,3902400,90.52108,4311040
9333,edwinpjacques,10,0.00023,3902410,90.52131,4311040
9334,eggie5,10,0.00023,3902420,90.52154,4311040
9335,elchead,10,0.00023,3902430,90.52178,4311040
9336,elsbrock,10,0.00023,3902440,90.52201,4311040
9337,enkelprifti98,10,0.00023,3902450,90.52224,4311040
9338,enkov,10,0.00023,3902460,90.52247,4311040
9339,epicfaace,10,0.00023,3902470,90.52270,4311040
9340,epiphenie,10,0.00023,3902480,90.52294,4311040
9341,eplightning,10,0.00023,3902490,90.52317,4311040
9342,er1c,10,0.00023,3902500,90.52340,4311040
9343,EricEdens,10,0.00023,3902510,90.52363,4311040
9344,ericsyh,10,0.00023,3902520,90.52386,4311040
9345,erikmcc,10,0.00023,3902530,90.52410,4311040
9346,EtienneCoutaud,10,0.00023,3902540,90.52433,4311040
9347,etwillbefine,10,0.00023,3902550,90.52456,4311040
9348,EvgeniGordeev,10,0.00023,3902560,90.52479,4311040
9349,evildandelions,10,0.00023,3902570,90.52502,4311040
9350,evnsio,10,0.00023,3902580,90.52526,4311040
9351,ezzoueidi,10,0.00023,3902590,90.52549,4311040
9352,FarhadF,10,0.00023,3902600,90.52572,4311040
9353,farshad-hobsons,10,0.00023,3902610,90.52595,4311040
9354,flands,10,0.00023,3902620,90.52618,4311040
9355,floriankoch,10,0.00023,3902630,90.52642,4311040
9356,foo0x29a,10,0.00023,3902640,90.52665,4311040
9357,francoisminaud,10,0.00023,3902650,90.52688,4311040
9358,fungiboletus,10,0.00023,3902660,90.52711,4311040
9359,gaplyk,10,0.00023,3902670,90.52734,4311040
9360,gaziqbal,10,0.00023,3902680,90.52758,4311040
9361,geekgonecrazy,10,0.00023,3902690,90.52781,4311040
9362,GerryWilko,10,0.00023,3902700,90.52804,4311040
9363,gotzmann,10,0.00023,3902710,90.52827,4311040
9364,hatemosphere,10,0.00023,3902720,90.52850,4311040
9365,heckdevice,10,0.00023,3902730,90.52874,4311040
9366,hemantha-kumara,10,0.00023,3902740,90.52897,4311040
9367,hexxdump,10,0.00023,3902750,90.52920,4311040
9368,hilcj,10,0.00023,3902760,90.52943,4311040
9369,hlamer,10,0.00023,3902770,90.52966,4311040
9370,hongxu-jia,10,0.00023,3902780,90.52990,4311040
9371,HSBawa,10,0.00023,3902790,90.53013,4311040
9372,Hsiny,10,0.00023,3902800,90.53036,4311040
9373,hunter32292,10,0.00023,3902810,90.53059,4311040
9374,hvolkmer,10,0.00023,3902820,90.53082,4311040
9375,idcmp,10,0.00023,3902830,90.53106,4311040
9376,invenfantasy,10,0.00023,3902840,90.53129,4311040
9377,iptizer,10,0.00023,3902850,90.53152,4311040
9378,jacintobarbeira,10,0.00023,3902860,90.53175,4311040
9379,jaipradeesh,10,0.00023,3902870,90.53198,4311040
9380,jchanam,10,0.00023,3902880,90.53221,4311040
9381,jdanekrh,10,0.00023,3902890,90.53245,4311040
9382,jeenx,10,0.00023,3902900,90.53268,4311040
9383,jeevanragula,10,0.00023,3902910,90.53291,4311040
9384,jeffdyoung,10,0.00023,3902920,90.53314,4311040
9385,jforman,10,0.00023,3902930,90.53337,4311040
9386,jhawkins1,10,0.00023,3902940,90.53361,4311040
9387,JHDST,10,0.00023,3902950,90.53384,4311040
9388,jihed,10,0.00023,3902960,90.53407,4311040
9389,jmazzitelli,10,0.00023,3902970,90.53430,4311040
9390,jmriebold,10,0.00023,3902980,90.53453,4311040
9391,jomeier,10,0.00023,3902990,90.53477,4311040
9392,jonathanheaden,10,0.00023,3903000,90.53500,4311040
9393,joshimoo,10,0.00023,3903010,90.53523,4311040
9394,jpts,10,0.00023,3903020,90.53546,4311040
9395,jroggeman,10,0.00023,3903030,90.53569,4311040
9396,js8080,10,0.00023,3903040,90.53593,4311040
9397,jsharpe,10,0.00023,3903050,90.53616,4311040
9398,judavi,10,0.00023,3903060,90.53639,4311040
9399,jurgen-weber-deltatre,10,0.00023,3903070,90.53662,4311040
9400,justingrayston,10,0.00023,3903080,90.53685,4311040
9401,justinwalz,10,0.00023,3903090,90.53709,4311040
9402,JWimsingues,10,0.00023,3903100,90.53732,4311040
9403,j-windsor,10,0.00023,3903110,90.53755,4311040
9404,jwolski2,10,0.00023,3903120,90.53778,4311040
9405,Kampe,10,0.00023,3903130,90.53801,4311040
9406,karasjoh000,10,0.00023,3903140,90.53825,4311040
9407,karras,10,0.00023,3903150,90.53848,4311040
9408,katiewasnothere,10,0.00023,3903160,90.53871,4311040
9409,kcx2366425574,10,0.00023,3903170,90.53894,4311040
9410,kenegozi,10,0.00023,3903180,90.53917,4311040
9411,Kent-H,10,0.00023,3903190,90.53941,4311040
9412,keslerm,10,0.00023,3903200,90.53964,4311040
9413,kevinzs2048,10,0.00023,3903210,90.53987,4311040
9414,kidiyoor,10,0.00023,3903220,90.54010,4311040
9415,KierranM,10,0.00023,3903230,90.54033,4311040
9416,knqyf263,10,0.00023,3903240,90.54057,4311040
9417,kranthikirang,10,0.00023,3903250,90.54080,4311040
9418,krembu,10,0.00023,3903260,90.54103,4311040
9419,kriswuollett,10,0.00023,3903270,90.54126,4311040
9420,lbragstad,10,0.00023,3903280,90.54149,4311040
9421,leahnp,10,0.00023,3903290,90.54173,4311040
9422,lebauce,10,0.00023,3903300,90.54196,4311040
9423,leoryu,10,0.00023,3903310,90.54219,4311040
9424,lewandom,10,0.00023,3903320,90.54242,4311040
9425,lexfrei,10,0.00023,3903330,90.54265,4311040
9426,lifubang,10,0.00023,3903340,90.54289,4311040
9427,lingz,10,0.00023,3903350,90.54312,4311040
9428,lodotek,10,0.00023,3903360,90.54335,4311040
9429,luckymrwang,10,0.00023,3903370,90.54358,4311040
9430,lxm,10,0.00023,3903380,90.54381,4311040
9431,lxs137,10,0.00023,3903390,90.54405,4311040
9432,lynic,10,0.00023,3903400,90.54428,4311040
9433,mahjonp,10,0.00023,3903410,90.54451,4311040
9434,maiqueb,10,0.00023,3903420,90.54474,4311040
9435,MandarJKulkarni,10,0.00023,3903430,90.54497,4311040
9436,manlinl,10,0.00023,3903440,90.54520,4311040
9437,Manvi07,10,0.00023,3903450,90.54544,4311040
9438,marianafranco,10,0.00023,3903460,90.54567,4311040
9439,mattj-io,10,0.00023,3903470,90.54590,4311040
9440,mattsdni,10,0.00023,3903480,90.54613,4311040
9441,mattsre,10,0.00023,3903490,90.54636,4311040
9442,mdeggies,10,0.00023,3903500,90.54660,4311040
9443,mdgrotheer,10,0.00023,3903510,90.54683,4311040
9444,megian,10,0.00023,3903520,90.54706,4311040
9445,mel1nn,10,0.00023,3903530,90.54729,4311040
9446,melnik13,10,0.00023,3903540,90.54752,4311040
9447,mgarstecki,10,0.00023,3903550,90.54776,4311040
9448,Midas847,10,0.00023,3903560,90.54799,4311040
9449,MikaelSmith,10,0.00023,3903570,90.54822,4311040
9450,miklapko,10,0.00023,3903580,90.54845,4311040
9451,milas,10,0.00023,3903590,90.54868,4311040
9452,miron9,10,0.00023,3903600,90.54892,4311040
9453,mixj93,10,0.00023,3903610,90.54915,4311040
9454,mjg59,10,0.00023,3903620,90.54938,4311040
9455,mjhopkins,10,0.00023,3903630,90.54961,4311040
9456,mogsie,10,0.00023,3903640,90.54984,4311040
9457,morengab,10,0.00023,3903650,90.55008,4311040
9458,mradmila,10,0.00023,3903660,90.55031,4311040
9459,mr-bjerre,10,0.00023,3903670,90.55054,4311040
9460,mrVectorz,10,0.00023,3903680,90.55077,4311040
9461,mrwacky42,10,0.00023,3903690,90.55100,4311040
9462,msheldyakov,10,0.00023,3903700,90.55124,4311040
9463,msiebuhr,10,0.00023,3903710,90.55147,4311040
9464,msvbhat,10,0.00023,3903720,90.55170,4311040
9465,multani,10,0.00023,3903730,90.55193,4311040
9466,munjalpatel,10,0.00023,3903740,90.55216,4311040
9467,mzsanford,10,0.00023,3903750,90.55240,4311040
9468,naioja,10,0.00023,3903760,90.55263,4311040
9469,nannancy,10,0.00023,3903770,90.55286,4311040
9470,natebwangsut,10,0.00023,3903780,90.55309,4311040
9471,nghialv,10,0.00023,3903790,90.55332,4311040
9472,niclic,10,0.00023,3903800,90.55356,4311040
9473,nicolaiskogheim,10,0.00023,3903810,90.55379,4311040
9474,niklaskorz,10,0.00023,3903820,90.55402,4311040
9475,nilic,10,0.00023,3903830,90.55425,4311040
9476,nimakaviani,10,0.00023,3903840,90.55448,4311040
9477,NitishT,10,0.00023,3903850,90.55472,4311040
9478,noctarius,10,0.00023,3903860,90.55495,4311040
9479,northrup,10,0.00023,3903870,90.55518,4311040
9480,notmaxx,10,0.00023,3903880,90.55541,4311040
9481,nsteinmetz,10,0.00023,3903890,90.55564,4311040
9482,nustiueudinastea,10,0.00023,3903900,90.55588,4311040
9483,obriensystems,10,0.00023,3903910,90.55611,4311040
9484,olamy,10,0.00023,3903920,90.55634,4311040
9485,oshothebig,10,0.00023,3903930,90.55657,4311040
9486,packi,10,0.00023,3903940,90.55680,4311040
9487,palsivertsen,10,0.00023,3903950,90.55703,4311040
9488,payes,10,0.00023,3903960,90.55727,4311040
9489,pengqinglan,10,0.00023,3903970,90.55750,4311040
9490,peterhoneder,10,0.00023,3903980,90.55773,4311040
9491,pfisterer,10,0.00023,3903990,90.55796,4311040
9492,philippt,10,0.00023,3904000,90.55819,4311040
9493,phillipahereza,10,0.00023,3904010,90.55843,4311040
9494,philpep,10,0.00023,3904020,90.55866,4311040
9495,philwinder,10,0.00023,3904030,90.55889,4311040
9496,pietervogelaar,10,0.00023,3904040,90.55912,4311040
9497,pkaramol,10,0.00023,3904050,90.55935,4311040
9498,postmasters,10,0.00023,3904060,90.55959,4311040
9499,pranavmarla,10,0.00023,3904070,90.55982,4311040
9500,premist,10,0.00023,3904080,90.56005,4311040
9501,pritamfocal,10,0.00023,3904090,90.56028,4311040
9502,prometheanfire,10,0.00023,3904100,90.56051,4311040
9503,pseudometric,10,0.00023,3904110,90.56075,4311040
9504,psiwczak,10,0.00023,3904120,90.56098,4311040
9505,Quarky9,10,0.00023,3904130,90.56121,4311040
9506,qujinping,10,0.00023,3904140,90.56144,4311040
9507,r0bobo,10,0.00023,3904150,90.56167,4311040
9508,rafik8,10,0.00023,3904160,90.56191,4311040
9509,rakarakhi,10,0.00023,3904170,90.56214,4311040
9510,rbroggi,10,0.00023,3904180,90.56237,4311040
9511,rdcastro,10,0.00023,3904190,90.56260,4311040
9512,reachlin,10,0.00023,3904200,90.56283,4311040
9513,remmeier,10,0.00023,3904210,90.56307,4311040
9514,renperez,10,0.00023,3904220,90.56330,4311040
9515,riffling,10,0.00023,3904230,90.56353,4311040
9516,rishabh96b,10,0.00023,3904240,90.56376,4311040
9517,rivernews,10,0.00023,3904250,90.56399,4311040
9518,rmgpinto,10,0.00023,3904260,90.56423,4311040
9519,rnaveiras,10,0.00023,3904270,90.56446,4311040
9520,Rohan749,10,0.00023,3904280,90.56469,4311040
9521,rokka-n,10,0.00023,3904290,90.56492,4311040
9522,rongou,10,0.00023,3904300,90.56515,4311040
9523,roshandawrani,10,0.00023,3904310,90.56539,4311040
9524,RoSk0,10,0.00023,3904320,90.56562,4311040
9525,rrayst,10,0.00023,3904330,90.56585,4311040
9526,rubberydub,10,0.00023,3904340,90.56608,4311040
9527,ruckc,10,0.00023,3904350,90.56631,4311040
9528,ruippeixotog,10,0.00023,3904360,90.56655,4311040
9529,russgold,10,0.00023,3904370,90.56678,4311040
9530,russtaylor,10,0.00023,3904380,90.56701,4311040
9531,rzr,10,0.00023,3904390,90.56724,4311040
9532,s12chung,10,0.00023,3904400,90.56747,4311040
9533,saamalik,10,0.00023,3904410,90.56771,4311040
9534,sachinar,10,0.00023,3904420,90.56794,4311040
9535,sahil-lakhwani,10,0.00023,3904430,90.56817,4311040
9536,SailingYYC,10,0.00023,3904440,90.56840,4311040
9537,sajal,10,0.00023,3904450,90.56863,4311040
9538,SamFleming,10,0.00023,3904460,90.56887,4311040
9539,samnoon1971,10,0.00023,3904470,90.56910,4311040
9540,sampowers,10,0.00023,3904480,90.56933,4311040
9541,sanarena,10,0.00023,3904490,90.56956,4311040
9542,saravanakumar-periyasamy,10,0.00023,3904500,90.56979,4311040
9543,sbocinec,10,0.00023,3904510,90.57002,4311040
9544,sbskas,10,0.00023,3904520,90.57026,4311040
9545,sciffer,10,0.00023,3904530,90.57049,4311040
9546,seaunderwater,10,0.00023,3904540,90.57072,4311040
9547,sebastian-philipp,10,0.00023,3904550,90.57095,4311040
9548,senthilrch,10,0.00023,3904560,90.57118,4311040
9549,sergeyshaykhullin,10,0.00023,3904570,90.57142,4311040
9550,sgc109,10,0.00023,3904580,90.57165,4311040
9551,shinigambit,10,0.00023,3904590,90.57188,4311040
9552,shraykay,10,0.00023,3904600,90.57211,4311040
9553,siliconbrain,10,0.00023,3904610,90.57234,4311040
9554,sjackman,10,0.00023,3904620,90.57258,4311040
9555,skaegi,10,0.00023,3904630,90.57281,4311040
9556,smawson,10,0.00023,3904640,90.57304,4311040
9557,smiklosovic,10,0.00023,3904650,90.57327,4311040
9558,smoke,10,0.00023,3904660,90.57350,4311040
9559,smoshiur1237,10,0.00023,3904670,90.57374,4311040
9560,snowmanstark,10,0.00023,3904680,90.57397,4311040
9561,snowsky,10,0.00023,3904690,90.57420,4311040
9562,soellman,10,0.00023,3904700,90.57443,4311040
9563,someshkoli,10,0.00023,3904710,90.57466,4311040
9564,souravsk,10,0.00023,3904720,90.57490,4311040
9565,squaremo,10,0.00023,3904730,90.57513,4311040
9566,ssboisen,10,0.00023,3904740,90.57536,4311040
9567,sseago,10,0.00023,3904750,90.57559,4311040
9568,sta-szek,10,0.00023,3904760,90.57582,4311040
9569,steakunderscore,10,0.00023,3904770,90.57606,4311040
9570,stevenpitts,10,0.00023,3904780,90.57629,4311040
9571,steveruckdashel,10,0.00023,3904790,90.57652,4311040
9572,sumit-badaya,10,0.00023,3904800,90.57675,4311040
9573,sun7927,10,0.00023,3904810,90.57698,4311040
9574,suramrit,10,0.00023,3904820,90.57722,4311040
9575,surik,10,0.00023,3904830,90.57745,4311040
9576,suryast,10,0.00023,3904840,90.57768,4311040
9577,SvenDowideit,10,0.00023,3904850,90.57791,4311040
9578,svenefftinge,10,0.00023,3904860,90.57814,4311040
9579,syed-awais-ali,10,0.00023,3904870,90.57838,4311040
9580,t3hmrman,10,0.00023,3904880,90.57861,4311040
9581,tagomoris,10,0.00023,3904890,90.57884,4311040
9582,tanayvaswani,10,0.00023,3904900,90.57907,4311040
9583,taylorsilva,10,0.00023,3904910,90.57930,4311040
9584,tbachman,10,0.00023,3904920,90.57954,4311040
9585,teemow,10,0.00023,3904930,90.57977,4311040
9586,teeram,10,0.00023,3904940,90.58000,4311040
9587,tembleking,10,0.00023,3904950,90.58023,4311040
9588,Tenaria,10,0.00023,3904960,90.58046,4311040
9589,tgrosinger,10,0.00023,3904970,90.58070,4311040
9590,thedch,10,0.00023,3904980,90.58093,4311040
9591,thehackercat,10,0.00023,3904990,90.58116,4311040
9592,thenayr,10,0.00023,3905000,90.58139,4311040
9593,thetwopct,10,0.00023,3905010,90.58162,4311040
9594,thomastvedt,10,0.00023,3905020,90.58185,4311040
9595,thuey,10,0.00023,3905030,90.58209,4311040
9596,tianhe-oi,10,0.00023,3905040,90.58232,4311040
9597,timactive,10,0.00023,3905050,90.58255,4311040
9598,timBrockman,10,0.00023,3905060,90.58278,4311040
9599,timflannagan,10,0.00023,3905070,90.58301,4311040
9600,timtoum,10,0.00023,3905080,90.58325,4311040
9601,TisonKun,10,0.00023,3905090,90.58348,4311040
9602,tjs-intel,10,0.00023,3905100,90.58371,4311040
9603,toddbaert,10,0.00023,3905110,90.58394,4311040
9604,tommywo,10,0.00023,3905120,90.58417,4311040
9605,tong101,10,0.00023,3905130,90.58441,4311040
9606,tongda,10,0.00023,3905140,90.58464,4311040
9607,TrevorEdwards,10,0.00023,3905150,90.58487,4311040
9608,tslater,10,0.00023,3905160,90.58510,4311040
9609,ttarczynski,10,0.00023,3905170,90.58533,4311040
9610,tuunit,10,0.00023,3905180,90.58557,4311040
9611,valer-cara,10,0.00023,3905190,90.58580,4311040
9612,Vampouille,10,0.00023,3905200,90.58603,4311040
9613,varac,10,0.00023,3905210,90.58626,4311040
9614,vbehar,10,0.00023,3905220,90.58649,4311040
9615,vgkowski,10,0.00023,3905230,90.58673,4311040
9616,viggeh,10,0.00023,3905240,90.58696,4311040
9617,vihangm,10,0.00023,3905250,90.58719,4311040
9618,visheyra,10,0.00023,3905260,90.58742,4311040
9619,vishiy,10,0.00023,3905270,90.58765,4311040
9620,vorti2,10,0.00023,3905280,90.58789,4311040
9621,vukg,10,0.00023,3905290,90.58812,4311040
9622,vulpecula,10,0.00023,3905300,90.58835,4311040
9623,wangtjia,10,0.00023,3905310,90.58858,4311040
9624,wangyira,10,0.00023,3905320,90.58881,4311040
9625,weizhanxu,10,0.00023,3905330,90.58905,4311040
9626,wenjianhn,10,0.00023,3905340,90.58928,4311040
9627,whillas,10,0.00023,3905350,90.58951,4311040
9628,whiteinge,10,0.00023,3905360,90.58974,4311040
9629,whiterm,10,0.00023,3905370,90.58997,4311040
9630,wiardvanrij,10,0.00023,3905380,90.59021,4311040
9631,withinboredom,10,0.00023,3905390,90.59044,4311040
9632,wyc,10,0.00023,3905400,90.59067,4311040
9633,wzrdtales,10,0.00023,3905410,90.59090,4311040
9634,xavierbaude,10,0.00023,3905420,90.59113,4311040
9635,xelalexv,10,0.00023,3905430,90.59137,4311040
9636,xgt001,10,0.00023,3905440,90.59160,4311040
9637,yanivroz,10,0.00023,3905450,90.59183,4311040
9638,yehudamakarov,10,0.00023,3905460,90.59206,4311040
9639,yossicohn,10,0.00023,3905470,90.59229,4311040
9640,yujunzhang,10,0.00023,3905480,90.59253,4311040
9641,zachgersh,10,0.00023,3905490,90.59276,4311040
9642,zakame,10,0.00023,3905500,90.59299,4311040
9643,zanhsieh,10,0.00023,3905510,90.59322,4311040
9644,zarenner,10,0.00023,3905520,90.59345,4311040
9645,zburgermeiszter,10,0.00023,3905530,90.59369,4311040
9646,Zebradil,10,0.00023,3905540,90.59392,4311040
9647,Zhang21,10,0.00023,3905550,90.59415,4311040
9648,zonghaishang,10,0.00023,3905560,90.59438,4311040
9649,1riggs,9,0.00021,3905569,90.59459,4311040
9650,3dinfluence,9,0.00021,3905578,90.59480,4311040
9651,3h4x,9,0.00021,3905587,90.59501,4311040
9652,aaaaahaaaaa,9,0.00021,3905596,90.59522,4311040
9653,aahemm,9,0.00021,3905605,90.59542,4311040
9654,aaron-trout,9,0.00021,3905614,90.59563,4311040
9655,acim,9,0.00021,3905623,90.59584,4311040
9656,acondrat,9,0.00021,3905632,90.59605,4311040
9657,adamkgray,9,0.00021,3905641,90.59626,4311040
9658,addisonbair,9,0.00021,3905650,90.59647,4311040
9659,aditighag,9,0.00021,3905659,90.59668,4311040
9660,adrianliechti,9,0.00021,3905668,90.59689,4311040
9661,aelbarkani,9,0.00021,3905677,90.59709,4311040
9662,AirbornePorcine,9,0.00021,3905686,90.59730,4311040
9663,ajcann,9,0.00021,3905695,90.59751,4311040
9664,aknrdureegaesr,9,0.00021,3905704,90.59772,4311040
9665,alantang888,9,0.00021,3905713,90.59793,4311040
9666,albertocsm,9,0.00021,3905722,90.59814,4311040
9667,AL-Cui,9,0.00021,3905731,90.59835,4311040
9668,aleb,9,0.00021,3905740,90.59856,4311040
9669,aLekSer,9,0.00021,3905749,90.59877,4311040
9670,alexbarbato,9,0.00021,3905758,90.59897,4311040
9671,AlexDiamanti,9,0.00021,3905767,90.59918,4311040
9672,alexmt,9,0.00021,3905776,90.59939,4311040
9673,aliabbasjaffri,9,0.00021,3905785,90.59960,4311040
9674,alice-sawatzky,9,0.00021,3905794,90.59981,4311040
9675,alkaliphile,9,0.00021,3905803,90.60002,4311040
9676,alop,9,0.00021,3905812,90.60023,4311040
9677,amalucelli,9,0.00021,3905821,90.60044,4311040
9678,ambition-consulting,9,0.00021,3905830,90.60064,4311040
9679,andye2004,9,0.00021,3905839,90.60085,4311040
9680,anishasthana,9,0.00021,3905848,90.60106,4311040
9681,ankitabhopatkar13,9,0.00021,3905857,90.60127,4311040
9682,anniedy,9,0.00021,3905866,90.60148,4311040
9683,antonakv,9,0.00021,3905875,90.60169,4311040
9684,antonlisovenko,9,0.00021,3905884,90.60190,4311040
9685,anyasabo,9,0.00021,3905893,90.60211,4311040
9686,apeabody,9,0.00021,3905902,90.60231,4311040
9687,AppalaKarthik,9,0.00021,3905911,90.60252,4311040
9688,arehmandev,9,0.00021,3905920,90.60273,4311040
9689,arjunan-k,9,0.00021,3905929,90.60294,4311040
9690,arvin-a,9,0.00021,3905938,90.60315,4311040
9691,ascheman,9,0.00021,3905947,90.60336,4311040
9692,avinassh,9,0.00021,3905956,90.60357,4311040
9693,avish42,9,0.00021,3905965,90.60378,4311040
9694,avkonst,9,0.00021,3905974,90.60398,4311040
9695,axrav,9,0.00021,3905983,90.60419,4311040
9696,b0nete,9,0.00021,3905992,90.60440,4311040
9697,b675987273,9,0.00021,3906001,90.60461,4311040
9698,bakito,9,0.00021,3906010,90.60482,4311040
9699,bangau1,9,0.00021,3906019,90.60503,4311040
9700,banks,9,0.00021,3906028,90.60524,4311040
9701,baodongli,9,0.00021,3906037,90.60545,4311040
9702,basanaguk,9,0.00021,3906046,90.60565,4311040
9703,batistein,9,0.00021,3906055,90.60586,4311040
9704,bcollard,9,0.00021,3906064,90.60607,4311040
9705,bentito,9,0.00021,3906073,90.60628,4311040
9706,bernielomax,9,0.00021,3906082,90.60649,4311040
9707,billimek,9,0.00021,3906091,90.60670,4311040
9708,binoue,9,0.00021,3906100,90.60691,4311040
9709,BioGeek,9,0.00021,3906109,90.60712,4311040
9710,bjarkevad,9,0.00021,3906118,90.60732,4311040
9711,bjornryden,9,0.00021,3906127,90.60753,4311040
9712,blackstar257,9,0.00021,3906136,90.60774,4311040
9713,bmoylan,9,0.00021,3906145,90.60795,4311040
9714,bmuschko,9,0.00021,3906154,90.60816,4311040
9715,borkod,9,0.00021,3906163,90.60837,4311040
9716,BouweCeunen,9,0.00021,3906172,90.60858,4311040
9717,braedon,9,0.00021,3906181,90.60879,4311040
9718,bragi92,9,0.00021,3906190,90.60899,4311040
9719,brpaz,9,0.00021,3906199,90.60920,4311040
9720,bryanl,9,0.00021,3906208,90.60941,4311040
9721,bshephar,9,0.00021,3906217,90.60962,4311040
9722,bydga,9,0.00021,3906226,90.60983,4311040
9723,c3d,9,0.00021,3906235,90.61004,4311040
9724,caesar0301,9,0.00021,3906244,90.61025,4311040
9725,camh-,9,0.00021,3906253,90.61046,4311040
9726,carmark,9,0.00021,3906262,90.61066,4311040
9727,CarpathianUA,9,0.00021,3906271,90.61087,4311040
9728,carroarmato0,9,0.00021,3906280,90.61108,4311040
9729,cewood,9,0.00021,3906289,90.61129,4311040
9730,chandanpasunoori,9,0.00021,3906298,90.61150,4311040
9731,chaolou,9,0.00021,3906307,90.61171,4311040
9732,chenleji,9,0.00021,3906316,90.61192,4311040
9733,chhetripradeep,9,0.00021,3906325,90.61213,4311040
9734,chicobento,9,0.00021,3906334,90.61233,4311040
9735,ChienHuey,9,0.00021,3906343,90.61254,4311040
9736,chmodrs,9,0.00021,3906352,90.61275,4311040
9737,chncaption,9,0.00021,3906361,90.61296,4311040
9738,chrisjs,9,0.00021,3906370,90.61317,4311040
9739,chrismcv,9,0.00021,3906379,90.61338,4311040
9740,ChrJantz,9,0.00021,3906388,90.61359,4311040
9741,chsigg,9,0.00021,3906397,90.61380,4311040
9742,cjc7373,9,0.00021,3906406,90.61400,4311040
9743,ckcd,9,0.00021,3906415,90.61421,4311040
9744,cliedeman,9,0.00021,3906424,90.61442,4311040
9745,cmachler,9,0.00021,3906433,90.61463,4311040
9746,coldTea214,9,0.00021,3906442,90.61484,4311040
9747,crenshaw-dev,9,0.00021,3906451,90.61505,4311040
9748,crizCraig,9,0.00021,3906460,90.61526,4311040
9749,ctlam,9,0.00021,3906469,90.61547,4311040
9750,dadux,9,0.00021,3906478,90.61568,4311040
9751,dalbani,9,0.00021,3906487,90.61588,4311040
9752,damianpumar,9,0.00021,3906496,90.61609,4311040
9753,dan-j,9,0.00021,3906505,90.61630,4311040
9754,davidham,9,0.00021,3906514,90.61651,4311040
9755,DavidHuie,9,0.00021,3906523,90.61672,4311040
9756,dblackdblack,9,0.00021,3906532,90.61693,4311040
9757,dduportal,9,0.00021,3906541,90.61714,4311040
9758,dee-kryvenko,9,0.00021,3906550,90.61735,4311040
9759,Devatoria,9,0.00021,3906559,90.61755,4311040
9760,dhrp,9,0.00021,3906568,90.61776,4311040
9761,diafour,9,0.00021,3906577,90.61797,4311040
9762,dimitarKiryakov,9,0.00021,3906586,90.61818,4311040
9763,diogomonica,9,0.00021,3906595,90.61839,4311040
9764,distributethe6ix,9,0.00021,3906604,90.61860,4311040
9765,dkozlov,9,0.00021,3906613,90.61881,4311040
9766,dlamotte,9,0.00021,3906622,90.61902,4311040
9767,dmcqueen,9,0.00021,3906631,90.61922,4311040
9768,dminca,9,0.00021,3906640,90.61943,4311040
9769,dminGod,9,0.00021,3906649,90.61964,4311040
9770,dmitsh,9,0.00021,3906658,90.61985,4311040
9771,docwhat,9,0.00021,3906667,90.62006,4311040
9772,domgoodwin,9,0.00021,3906676,90.62027,4311040
9773,drivebyer,9,0.00021,3906685,90.62048,4311040
9774,dshcherb,9,0.00021,3906694,90.62069,4311040
9775,duane-ibm,9,0.00021,3906703,90.62089,4311040
9776,duboc,9,0.00021,3906712,90.62110,4311040
9777,dwelch2344,9,0.00021,3906721,90.62131,4311040
9778,easimon,9,0.00021,3906730,90.62152,4311040
9779,ebuildy,9,0.00021,3906739,90.62173,4311040
9780,EDGsheryl,9,0.00021,3906748,90.62194,4311040
9781,edude03,9,0.00021,3906757,90.62215,4311040
9782,EdwardZhang88,9,0.00021,3906766,90.62236,4311040
9783,elipapa,9,0.00021,3906775,90.62256,4311040
9784,elithrar,9,0.00021,3906784,90.62277,4311040
9785,emilevauge,9,0.00021,3906793,90.62298,4311040
9786,e-minguez,9,0.00021,3906802,90.62319,4311040
9787,enneitex,9,0.00021,3906811,90.62340,4311040
9788,ErickStaal,9,0.00021,3906820,90.62361,4311040
9789,ericsuhong,9,0.00021,3906829,90.62382,4311040
9790,eridai,9,0.00021,3906838,90.62403,4311040
9791,erihanse,9,0.00021,3906847,90.62423,4311040
9792,Eronarn,9,0.00021,3906856,90.62444,4311040
9793,EsDmitrii,9,0.00021,3906865,90.62465,4311040
9794,eskaufel,9,0.00021,3906874,90.62486,4311040
9795,fardin01,9,0.00021,3906883,90.62507,4311040
9796,fastest963,9,0.00021,3906892,90.62528,4311040
9797,fbiville,9,0.00021,3906901,90.62549,4311040
9798,ff8eyes,9,0.00021,3906910,90.62570,4311040
9799,Flydiverny,9,0.00021,3906919,90.62590,4311040
9800,franpog859,9,0.00021,3906928,90.62611,4311040
9801,freedev,9,0.00021,3906937,90.62632,4311040
9802,friedrichwilken,9,0.00021,3906946,90.62653,4311040
9803,Frostman,9,0.00021,3906955,90.62674,4311040
9804,frozenice,9,0.00021,3906964,90.62695,4311040
9805,Frusty,9,0.00021,3906973,90.62716,4311040
9806,galderz,9,0.00021,3906982,90.62737,4311040
9807,gbzhu,9,0.00021,3906991,90.62757,4311040
9808,Gchbg,9,0.00021,3907000,90.62778,4311040
9809,gdvalle,9,0.00021,3907009,90.62799,4311040
9810,geekSiddharth,9,0.00021,3907018,90.62820,4311040
9811,gghezzo,9,0.00021,3907027,90.62841,4311040
9812,giannello,9,0.00021,3907036,90.62862,4311040
9813,Gimi,9,0.00021,3907045,90.62883,4311040
9814,GongWilliam,9,0.00021,3907054,90.62904,4311040
9815,gongysh2004,9,0.00021,3907063,90.62924,4311040
9816,goruha,9,0.00021,3907072,90.62945,4311040
9817,Gowiem,9,0.00021,3907081,90.62966,4311040
9818,grifx,9,0.00021,3907090,90.62987,4311040
9819,groob,9,0.00021,3907099,90.63008,4311040
9820,gsf,9,0.00021,3907108,90.63029,4311040
9821,gucki,9,0.00021,3907117,90.63050,4311040
9822,guillaumerose,9,0.00021,3907126,90.63071,4311040
9823,guoweikuang,9,0.00021,3907135,90.63092,4311040
9824,haf-afa,9,0.00021,3907144,90.63112,4311040
9825,hajowieland,9,0.00021,3907153,90.63133,4311040
9826,HamzaK8s,9,0.00021,3907162,90.63154,4311040
9827,hanselsen,9,0.00021,3907171,90.63175,4311040
9828,HarikrishnanBalagopal,9,0.00021,3907180,90.63196,4311040
9829,hbceylan,9,0.00021,3907189,90.63217,4311040
9830,Henrod,9,0.00021,3907198,90.63238,4311040
9831,hhoover,9,0.00021,3907207,90.63259,4311040
9832,hiyosi,9,0.00021,3907216,90.63279,4311040
9833,hjfreyer,9,0.00021,3907225,90.63300,4311040
9834,hnwolf,9,0.00021,3907234,90.63321,4311040
9835,iamthemuffinman,9,0.00021,3907243,90.63342,4311040
9836,IBMRob,9,0.00021,3907252,90.63363,4311040
9837,idevz,9,0.00021,3907261,90.63384,4311040
9838,ifilonenko,9,0.00021,3907270,90.63405,4311040
9839,ii2day,9,0.00021,3907279,90.63426,4311040
9840,ilovezfs,9,0.00021,3907288,90.63446,4311040
9841,ilyakaznacheev,9,0.00021,3907297,90.63467,4311040
9842,indigoid,9,0.00021,3907306,90.63488,4311040
9843,ipedrazas,9,0.00021,3907315,90.63509,4311040
9844,ishitatsuyuki,9,0.00021,3907324,90.63530,4311040
9845,ismailbaskin,9,0.00021,3907333,90.63551,4311040
9846,ivuk,9,0.00021,3907342,90.63572,4311040
9847,jackivanov,9,0.00021,3907351,90.63593,4311040
9848,JackZxj,9,0.00021,3907360,90.63613,4311040
9849,jakebolam,9,0.00021,3907369,90.63634,4311040
9850,jamtur01,9,0.00021,3907378,90.63655,4311040
9851,JasonRD,9,0.00021,3907387,90.63676,4311040
9852,jawad846,9,0.00021,3907396,90.63697,4311040
9853,jaythamke,9,0.00021,3907405,90.63718,4311040
9854,jceb,9,0.00021,3907414,90.63739,4311040
9855,jchesterpivotal,9,0.00021,3907423,90.63760,4311040
9856,JCMais,9,0.00021,3907432,90.63780,4311040
9857,jcmcken,9,0.00021,3907441,90.63801,4311040
9858,jcodybaker,9,0.00021,3907450,90.63822,4311040
9859,JeffPaine,9,0.00021,3907459,90.63843,4311040
9860,JeffWuBJ,9,0.00021,3907468,90.63864,4311040
9861,jeid64,9,0.00021,3907477,90.63885,4311040
9862,jek-a,9,0.00021,3907486,90.63906,4311040
9863,JensRantil,9,0.00021,3907495,90.63927,4311040
9864,jeromeinsf,9,0.00021,3907504,90.63947,4311040
9865,jessebye,9,0.00021,3907513,90.63968,4311040
9866,jessegonzalez,9,0.00021,3907522,90.63989,4311040
9867,jhahn21,9,0.00021,3907531,90.64010,4311040
9868,jimengliu,9,0.00021,3907540,90.64031,4311040
9869,jjulien,9,0.00021,3907549,90.64052,4311040
9870,jldeen,9,0.00021,3907558,90.64073,4311040
9871,jmccarty3,9,0.00021,3907567,90.64094,4311040
9872,jmymy,9,0.00021,3907576,90.64114,4311040
9873,johanhubens,9,0.00021,3907585,90.64135,4311040
9874,jongwu,9,0.00021,3907594,90.64156,4311040
9875,jonkatora,9,0.00021,3907603,90.64177,4311040
9876,jonohart,9,0.00021,3907612,90.64198,4311040
9877,Jorropo,9,0.00021,3907621,90.64219,4311040
9878,josepalafox,9,0.00021,3907630,90.64240,4311040
9879,joshuastern,9,0.00021,3907639,90.64261,4311040
9880,jovizhangwei,9,0.00021,3907648,90.64281,4311040
9881,jpdstan,9,0.00021,3907657,90.64302,4311040
9882,juanmaia,9,0.00021,3907666,90.64323,4311040
9883,juhtie01,9,0.00021,3907675,90.64344,4311040
9884,junaid18183,9,0.00021,3907684,90.64365,4311040
9885,justinbarrick,9,0.00021,3907693,90.64386,4311040
9886,justinkillen,9,0.00021,3907702,90.64407,4311040
9887,jwalton,9,0.00021,3907711,90.64428,4311040
9888,Kaezon,9,0.00021,3907720,90.64448,4311040
9889,kamigerami,9,0.00021,3907729,90.64469,4311040
9890,kandros,9,0.00021,3907738,90.64490,4311040
9891,karinnainiguez,9,0.00021,3907747,90.64511,4311040
9892,kcking,9,0.00021,3907756,90.64532,4311040
9893,keegancsmith,9,0.00021,3907765,90.64553,4311040
9894,keithjohnhowe,9,0.00021,3907774,90.64574,4311040
9895,kenjones-cisco,9,0.00021,3907783,90.64595,4311040
9896,kevin-zhaoshuai,9,0.00021,3907792,90.64615,4311040
9897,kiela,9,0.00021,3907801,90.64636,4311040
9898,kieronlanning,9,0.00021,3907810,90.64657,4311040
9899,kitch,9,0.00021,3907819,90.64678,4311040
9900,kivoli,9,0.00021,3907828,90.64699,4311040
9901,kkaneda,9,0.00021,3907837,90.64720,4311040
9902,kmrov,9,0.00021,3907846,90.64741,4311040
9903,krangerich,9,0.00021,3907855,90.64762,4311040
9904,ku524,9,0.00021,3907864,90.64783,4311040
9905,kubesure,9,0.00021,3907873,90.64803,4311040
9906,KylanZhang,9,0.00021,3907882,90.64824,4311040
9907,kyprifog,9,0.00021,3907891,90.64845,4311040
9908,lalithvaka,9,0.00021,3907900,90.64866,4311040
9909,Lastpixl,9,0.00021,3907909,90.64887,4311040
9910,leoluk,9,0.00021,3907918,90.64908,4311040
9911,leominov,9,0.00021,3907927,90.64929,4311040
9912,leyao-daily,9,0.00021,3907936,90.64950,4311040
9913,linxcat,9,0.00021,3907945,90.64970,4311040
9914,LipingMao,9,0.00021,3907954,90.64991,4311040
9915,liskl,9,0.00021,3907963,90.65012,4311040
9916,ljnelson,9,0.00021,3907972,90.65033,4311040
9917,lloydchang,9,0.00021,3907981,90.65054,4311040
9918,lmickh,9,0.00021,3907990,90.65075,4311040
9919,loadwiki,9,0.00021,3907999,90.65096,4311040
9920,lodejard,9,0.00021,3908008,90.65117,4311040
9921,lohmag,9,0.00021,3908017,90.65137,4311040
9922,lominorama,9,0.00021,3908026,90.65158,4311040
9923,longngn,9,0.00021,3908035,90.65179,4311040
9924,loomsen,9,0.00021,3908044,90.65200,4311040
9925,lpaulmp,9,0.00021,3908053,90.65221,4311040
9926,lrouquette,9,0.00021,3908062,90.65242,4311040
9927,luanguimaraesla,9,0.00021,3908071,90.65263,4311040
9928,lucky-sideburn,9,0.00021,3908080,90.65284,4311040
9929,luizbafilho,9,0.00021,3908089,90.65304,4311040
9930,LukeShu,9,0.00021,3908098,90.65325,4311040
9931,lyarwood,9,0.00021,3908107,90.65346,4311040
9932,mafraba,9,0.00021,3908116,90.65367,4311040
9933,magnologan,9,0.00021,3908125,90.65388,4311040
9934,Manda-supraja26,9,0.00021,3908134,90.65409,4311040
9935,manusa,9,0.00021,3908143,90.65430,4311040
9936,mariobris,9,0.00021,3908152,90.65451,4311040
9937,mark8s,9,0.00021,3908161,90.65471,4311040
9938,martinssipenko,9,0.00021,3908170,90.65492,4311040
9939,mat285,9,0.00021,3908179,90.65513,4311040
9940,MatthewRalston,9,0.00021,3908188,90.65534,4311040
9941,mattklein123,9,0.00021,3908197,90.65555,4311040
9942,max-wittig,9,0.00021,3908206,90.65576,4311040
9943,mbelang,9,0.00021,3908215,90.65597,4311040
9944,mbhinder,9,0.00021,3908224,90.65618,4311040
9945,mbode,9,0.00021,3908233,90.65638,4311040
9946,mcsos,9,0.00021,3908242,90.65659,4311040
9947,Mert18,9,0.00021,3908251,90.65680,4311040
9948,metaswirl,9,0.00021,3908260,90.65701,4311040
9949,mfornasa,9,0.00021,3908269,90.65722,4311040
9950,mfykmn,9,0.00021,3908278,90.65743,4311040
9951,mialkin,9,0.00021,3908287,90.65764,4311040
9952,MichalMankowski,9,0.00021,3908296,90.65785,4311040
9953,mikemckiernan,9,0.00021,3908305,90.65805,4311040
9954,MikkelHegn,9,0.00021,3908314,90.65826,4311040
9955,mikkosest,9,0.00021,3908323,90.65847,4311040
9956,milindchawre,9,0.00021,3908332,90.65868,4311040
9957,ming-ddtechcg,9,0.00021,3908341,90.65889,4311040
9958,minhdanh,9,0.00021,3908350,90.65910,4311040
9959,mironov,9,0.00021,3908359,90.65931,4311040
9960,mjgutermuth,9,0.00021,3908368,90.65952,4311040
9961,mkmik,9,0.00021,3908377,90.65972,4311040
9962,mootpt,9,0.00021,3908386,90.65993,4311040
9963,mossuchida,9,0.00021,3908395,90.66014,4311040
9964,moule3053,9,0.00021,3908404,90.66035,4311040
9965,mpmaia,9,0.00021,3908413,90.66056,4311040
9966,mrak,9,0.00021,3908422,90.66077,4311040
9967,mrizzi,9,0.00021,3908431,90.66098,4311040
9968,msiebeneicher,9,0.00021,3908440,90.66119,4311040
9969,mt-inside,9,0.00021,3908449,90.66139,4311040
9970,mtnbikenc,9,0.00021,3908458,90.66160,4311040
9971,mxplusb,9,0.00021,3908467,90.66181,4311040
9972,mzuccala,9,0.00021,3908476,90.66202,4311040
9973,nabsul,9,0.00021,3908485,90.66223,4311040
9974,namra98,9,0.00021,3908494,90.66244,4311040
9975,namratachaudhary,9,0.00021,3908503,90.66265,4311040
9976,naphthalene,9,0.00021,3908512,90.66286,4311040
9977,navi86,9,0.00021,3908521,90.66307,4311040
9978,nbouron,9,0.00021,3908530,90.66327,4311040
9979,ngocketit,9,0.00021,3908539,90.66348,4311040
9980,nicdoye,9,0.00021,3908548,90.66369,4311040
9981,nickethier,9,0.00021,3908557,90.66390,4311040
9982,niladrih,9,0.00021,3908566,90.66411,4311040
9983,nimeshksingh,9,0.00021,3908575,90.66432,4311040
9984,njfix6,9,0.00021,3908584,90.66453,4311040
9985,nkysg,9,0.00021,3908593,90.66474,4311040
9986,nmasse-itix,9,0.00021,3908602,90.66494,4311040
9987,novas0x2a,9,0.00021,3908611,90.66515,4311040
9988,npramod,9,0.00021,3908620,90.66536,4311040
9989,octete,9,0.00021,3908629,90.66557,4311040
9990,ofcourseican,9,0.00021,3908638,90.66578,4311040
9991,oivindoh,9,0.00021,3908647,90.66599,4311040
9992,ojarjur,9,0.00021,3908656,90.66620,4311040
9993,omarkhammassi,9,0.00021,3908665,90.66641,4311040
9994,omerfsen,9,0.00021,3908674,90.66661,4311040
9995,onpaws,9,0.00021,3908683,90.66682,4311040
9996,optimisticanshul,9,0.00021,3908692,90.66703,4311040
9997,orenc1,9,0.00021,3908701,90.66724,4311040
9998,oshi36,9,0.00021,3908710,90.66745,4311040
9999,oszi,9,0.00021,3908719,90.66766,4311040
10000,paidhi,9,0.00021,3908728,90.66787,4311040
10001,parasyte,9,0.00021,3908737,90.66808,4311040
10002,paulbakker,9,0.00021,3908746,90.66828,4311040
10003,pditommaso,9,0.00021,3908755,90.66849,4311040
10004,pecameron,9,0.00021,3908764,90.66870,4311040
10005,pendoragon,9,0.00021,3908773,90.66891,4311040
10006,pengdake,9,0.00021,3908782,90.66912,4311040
10007,petermd,9,0.00021,3908791,90.66933,4311040
10008,petermikitsh,9,0.00021,3908800,90.66954,4311040
10009,pgray,9,0.00021,3908809,90.66975,4311040
10010,phedoreanu,9,0.00021,3908818,90.66995,4311040
10011,phoracek,9,0.00021,3908827,90.67016,4311040
10012,phracek,9,0.00021,3908836,90.67037,4311040
10013,plamer,9,0.00021,3908845,90.67058,4311040
10014,pliu,9,0.00021,3908854,90.67079,4311040
10015,plobsing,9,0.00021,3908863,90.67100,4311040
10016,pms1969,9,0.00021,3908872,90.67121,4311040
10017,Prateeknandle,9,0.00021,3908881,90.67142,4311040
10018,Project0,9,0.00021,3908890,90.67162,4311040
10019,prrajput1199,9,0.00021,3908899,90.67183,4311040
10020,psalaberria002,9,0.00021,3908908,90.67204,4311040
10021,ptone,9,0.00021,3908917,90.67225,4311040
10022,PureWhiteWu,9,0.00021,3908926,90.67246,4311040
10023,pururaj1908,9,0.00021,3908935,90.67267,4311040
10024,pvdvreede,9,0.00021,3908944,90.67288,4311040
10025,pythops,9,0.00021,3908953,90.67309,4311040
10026,qlikcoe,9,0.00021,3908962,90.67329,4311040
10027,qubusp,9,0.00021,3908971,90.67350,4311040
10028,r8k,9,0.00021,3908980,90.67371,4311040
10029,radtriste,9,0.00021,3908989,90.67392,4311040
10030,raeesiqbal,9,0.00021,3908998,90.67413,4311040
10031,rafax,9,0.00021,3909007,90.67434,4311040
10032,rajaSahil,9,0.00021,3909016,90.67455,4311040
10033,ranjib,9,0.00021,3909025,90.67476,4311040
10034,raphink,9,0.00021,3909034,90.67496,4311040
10035,RaymondArias,9,0.00021,3909043,90.67517,4311040
10036,rcoh,9,0.00021,3909052,90.67538,4311040
10037,remche,9,0.00021,3909061,90.67559,4311040
10038,rflorenc,9,0.00021,3909070,90.67580,4311040
10039,RichardBronosky,9,0.00021,3909079,90.67601,4311040
10040,RichardHightower,9,0.00021,3909088,90.67622,4311040
10041,riklopfer,9,0.00021,3909097,90.67643,4311040
10042,rmetzger,9,0.00021,3909106,90.67663,4311040
10043,robbiezhang,9,0.00021,3909115,90.67684,4311040
10044,rogerwelin,9,0.00021,3909124,90.67705,4311040
10045,rojosinalma,9,0.00021,3909133,90.67726,4311040
10046,rokrokss,9,0.00021,3909142,90.67747,4311040
10047,RonMallory,9,0.00021,3909151,90.67768,4311040
10048,RothAndrew,9,0.00021,3909160,90.67789,4311040
10049,rrmckinley,9,0.00021,3909169,90.67810,4311040
10050,RXminuS,9,0.00021,3909178,90.67831,4311040
10051,rzarzynski,9,0.00021,3909187,90.67851,4311040
10052,sandipchitale,9,0.00021,3909196,90.67872,4311040
10053,SaphMB,9,0.00021,3909205,90.67893,4311040
10054,saumas,9,0.00021,3909214,90.67914,4311040
10055,sczizzo,9,0.00021,3909223,90.67935,4311040
10056,sdanbury,9,0.00021,3909232,90.67956,4311040
10057,sdlarsen,9,0.00021,3909241,90.67977,4311040
10058,sel,9,0.00021,3909250,90.67998,4311040
10059,senorflor,9,0.00021,3909259,90.68018,4311040
10060,sermilrod,9,0.00021,3909268,90.68039,4311040
10061,serverwentdown,9,0.00021,3909277,90.68060,4311040
10062,sferich888,9,0.00021,3909286,90.68081,4311040
10063,sgallagher,9,0.00021,3909295,90.68102,4311040
10064,shankar-forgerock,9,0.00021,3909304,90.68123,4311040
10065,shivaylamba,9,0.00021,3909313,90.68144,4311040
10066,shroudedcode,9,0.00021,3909322,90.68165,4311040
10067,shubham14bajpai,9,0.00021,3909331,90.68185,4311040
10068,Sijoma,9,0.00021,3909340,90.68206,4311040
10069,simonjcarr,9,0.00021,3909349,90.68227,4311040
10070,sjc960115,9,0.00021,3909358,90.68248,4311040
10071,slashben,9,0.00021,3909367,90.68269,4311040
10072,smsilva,9,0.00021,3909376,90.68290,4311040
10073,southwolf,9,0.00021,3909385,90.68311,4311040
10074,spacepluk,9,0.00021,3909394,90.68332,4311040
10075,spyridonas,9,0.00021,3909403,90.68352,4311040
10076,SrinivasChilveri,9,0.00021,3909412,90.68373,4311040
10077,statik,9,0.00021,3909421,90.68394,4311040
10078,stefanmb,9,0.00021,3909430,90.68415,4311040
10079,stephenwithav,9,0.00021,3909439,90.68436,4311040
10080,steren,9,0.00021,3909448,90.68457,4311040
10081,steveteuber,9,0.00021,3909457,90.68478,4311040
10082,sublimino,9,0.00021,3909466,90.68499,4311040
10083,SueKocher,9,0.00021,3909475,90.68519,4311040
10084,sumo-drosiek,9,0.00021,3909484,90.68540,4311040
10085,SurferJeffAtGoogle,9,0.00021,3909493,90.68561,4311040
10086,tamsky,9,0.00021,3909502,90.68582,4311040
10087,tchernomax,9,0.00021,3909511,90.68603,4311040
10088,Tchinmai7,9,0.00021,3909520,90.68624,4311040
10089,tekenstam,9,0.00021,3909529,90.68645,4311040
10090,tetchel,9,0.00021,3909538,90.68666,4311040
10091,tfherbert,9,0.00021,3909547,90.68686,4311040
10092,tgunsch,9,0.00021,3909556,90.68707,4311040
10093,ThaSami,9,0.00021,3909565,90.68728,4311040
10094,TheMeier,9,0.00021,3909574,90.68749,4311040
10095,thomaso-mirodin,9,0.00021,3909583,90.68770,4311040
10096,ThorstenHans,9,0.00021,3909592,90.68791,4311040
10097,Thubo,9,0.00021,3909601,90.68812,4311040
10098,tibetsam,9,0.00021,3909610,90.68833,4311040
10099,tiwillia,9,0.00021,3909619,90.68853,4311040
10100,TomasKohout,9,0.00021,3909628,90.68874,4311040
10101,TomatoAres,9,0.00021,3909637,90.68895,4311040
10102,tomislater,9,0.00021,3909646,90.68916,4311040
10103,toothbrush,9,0.00021,3909655,90.68937,4311040
10104,tpantelis,9,0.00021,3909664,90.68958,4311040
10105,traghave,9,0.00021,3909673,90.68979,4311040
10106,trallnag,9,0.00021,3909682,90.69000,4311040
10107,travisgroth,9,0.00021,3909691,90.69020,4311040
10108,tringuyen-yw,9,0.00021,3909700,90.69041,4311040
10109,tsanders-rh,9,0.00021,3909709,90.69062,4311040
10110,tsubasaxZZZ,9,0.00021,3909718,90.69083,4311040
10111,ttomsu,9,0.00021,3909727,90.69104,4311040
10112,turowicz,9,0.00021,3909736,90.69125,4311040
10113,upk8s,9,0.00021,3909745,90.69146,4311040
10114,Utwo,9,0.00021,3909754,90.69167,4311040
10115,vaibhavkhurana2018,9,0.00021,3909763,90.69187,4311040
10116,vallard,9,0.00021,3909772,90.69208,4311040
10117,vatsalparekh,9,0.00021,3909781,90.69229,4311040
10118,VictorDenisov,9,0.00021,3909790,90.69250,4311040
10119,vigneshraaj,9,0.00021,3909799,90.69271,4311040
10120,VikramTiwari,9,0.00021,3909808,90.69292,4311040
10121,vincepii,9,0.00021,3909817,90.69313,4311040
10122,Vishwanath-GitHub,9,0.00021,3909826,90.69334,4311040
10123,vitobotta,9,0.00021,3909835,90.69354,4311040
10124,vivkong,9,0.00021,3909844,90.69375,4311040
10125,vmtyler,9,0.00021,3909853,90.69396,4311040
10126,vrubiolo,9,0.00021,3909862,90.69417,4311040
10127,wangfakang,9,0.00021,3909871,90.69438,4311040
10128,wd,9,0.00021,3909880,90.69459,4311040
10129,weeco,9,0.00021,3909889,90.69480,4311040
10130,wheelerlaw,9,0.00021,3909898,90.69501,4311040
10131,WLun001,9,0.00021,3909907,90.69522,4311040
10132,wmorgan,9,0.00021,3909916,90.69542,4311040
10133,wolmi,9,0.00021,3909925,90.69563,4311040
10134,wonleing,9,0.00021,3909934,90.69584,4311040
10135,WoohyungHan,9,0.00021,3909943,90.69605,4311040
10136,wshaffer,9,0.00021,3909952,90.69626,4311040
10137,wyaeld,9,0.00021,3909961,90.69647,4311040
10138,wzhx78,9,0.00021,3909970,90.69668,4311040
10139,xarses,9,0.00021,3909979,90.69689,4311040
10140,xenolog,9,0.00021,3909988,90.69709,4311040
10141,xh3b4sd,9,0.00021,3909997,90.69730,4311040
10142,xiaofan-linux,9,0.00021,3910006,90.69751,4311040
10143,xordspar0,9,0.00021,3910015,90.69772,4311040
10144,XSAM,9,0.00021,3910024,90.69793,4311040
10145,yaowenqiang,9,0.00021,3910033,90.69814,4311040
10146,yashdev9274,9,0.00021,3910042,90.69835,4311040
10147,yashubh,9,0.00021,3910051,90.69856,4311040
10148,yebrahim,9,0.00021,3910060,90.69876,4311040
10149,yevgenypats,9,0.00021,3910069,90.69897,4311040
10150,yingding,9,0.00021,3910078,90.69918,4311040
10151,yong-jie-gong,9,0.00021,3910087,90.69939,4311040
10152,yskopets,9,0.00021,3910096,90.69960,4311040
10153,ysolt,9,0.00021,3910105,90.69981,4311040
10154,ywk253100,9,0.00021,3910114,90.70002,4311040
10155,zetaron,9,0.00021,3910123,90.70023,4311040
10156,zezaeoh,9,0.00021,3910132,90.70043,4311040
10157,zombiezen,9,0.00021,3910141,90.70064,4311040
10158,zvigrinberg,9,0.00021,3910150,90.70085,4311040
10159,zw0610,9,0.00021,3910159,90.70106,4311040
10160,111andre111,8,0.00019,3910167,90.70125,4311040
10161,11jwolfe2,8,0.00019,3910175,90.70143,4311040
10162,a1exus,8,0.00019,3910183,90.70162,4311040
10163,aackerman,8,0.00019,3910191,90.70180,4311040
10164,aalexand,8,0.00019,3910199,90.70199,4311040
10165,abebars,8,0.00019,3910207,90.70217,4311040
10166,Abhishek-kumar09,8,0.00019,3910215,90.70236,4311040
10167,abuango,8,0.00019,3910223,90.70255,4311040
10168,ackerman80,8,0.00019,3910231,90.70273,4311040
10169,adamdecaf,8,0.00019,3910239,90.70292,4311040
10170,adamreese,8,0.00019,3910247,90.70310,4311040
10171,adrianotto,8,0.00019,3910255,90.70329,4311040
10172,advancedwebdeveloper,8,0.00019,3910263,90.70347,4311040
10173,aecolley,8,0.00019,3910271,90.70366,4311040
10174,ahl,8,0.00019,3910279,90.70384,4311040
10175,ahrkrak,8,0.00019,3910287,90.70403,4311040
10176,ak20102763,8,0.00019,3910295,90.70422,4311040
10177,akartsky,8,0.00019,3910303,90.70440,4311040
10178,alamaison,8,0.00019,3910311,90.70459,4311040
10179,alanmeadows,8,0.00019,3910319,90.70477,4311040
10180,albatross0,8,0.00019,3910327,90.70496,4311040
10181,alexisvincent,8,0.00019,3910335,90.70514,4311040
10182,AlexKhotian,8,0.00019,3910343,90.70533,4311040
10183,AlexRRR,8,0.00019,3910351,90.70551,4311040
10184,alexvicegrab,8,0.00019,3910359,90.70570,4311040
10185,alezzandro,8,0.00019,3910367,90.70589,4311040
10186,ali-raza-tariq,8,0.00019,3910375,90.70607,4311040
10187,alobbs,8,0.00019,3910383,90.70626,4311040
10188,Alphasite,8,0.00019,3910391,90.70644,4311040
10189,amacneil,8,0.00019,3910399,90.70663,4311040
10190,ammills01,8,0.00019,3910407,90.70681,4311040
10191,amorenoz,8,0.00019,3910415,90.70700,4311040
10192,anannaya,8,0.00019,3910423,90.70718,4311040
10193,andrei-dascalu,8,0.00019,3910431,90.70737,4311040
10194,andres-lowrie,8,0.00019,3910439,90.70756,4311040
10195,andrewpollack,8,0.00019,3910447,90.70774,4311040
10196,andrewsomething,8,0.00019,3910455,90.70793,4311040
10197,Andrey9kin,8,0.00019,3910463,90.70811,4311040
10198,andreyvelich,8,0.00019,3910471,90.70830,4311040
10199,andyfeller,8,0.00019,3910479,90.70848,4311040
10200,anik120,8,0.00019,3910487,90.70867,4311040
10201,annismckenzie,8,0.00019,3910495,90.70885,4311040
10202,antonu17,8,0.00019,3910503,90.70904,4311040
10203,anukul,8,0.00019,3910511,90.70923,4311040
10204,Anutrix,8,0.00019,3910519,90.70941,4311040
10205,apratina,8,0.00019,3910527,90.70960,4311040
10206,arbourd,8,0.00019,3910535,90.70978,4311040
10207,archcloudlabs,8,0.00019,3910543,90.70997,4311040
10208,Arindam200,8,0.00019,3910551,90.71015,4311040
10209,arkanmgerges,8,0.00019,3910559,90.71034,4311040
10210,artem-nefedov,8,0.00019,3910567,90.71052,4311040
10211,arthurk,8,0.00019,3910575,90.71071,4311040
10212,ashwanikhemani,8,0.00019,3910583,90.71090,4311040
10213,asispatra,8,0.00019,3910591,90.71108,4311040
10214,aspsk,8,0.00019,3910599,90.71127,4311040
10215,atbaker,8,0.00019,3910607,90.71145,4311040
10216,AviKndr,8,0.00019,3910615,90.71164,4311040
10217,avik-so,8,0.00019,3910623,90.71182,4311040
10218,Ayden-Franklin,8,0.00019,3910631,90.71201,4311040
10219,ayshiff,8,0.00019,3910639,90.71219,4311040
10220,barp,8,0.00019,3910647,90.71238,4311040
10221,bartimar,8,0.00019,3910655,90.71257,4311040
10222,bassambst,8,0.00019,3910663,90.71275,4311040
10223,bertoost,8,0.00019,3910671,90.71294,4311040
10224,bertreyking,8,0.00019,3910679,90.71312,4311040
10225,bibinphilip,8,0.00019,3910687,90.71331,4311040
10226,bisakhmondal,8,0.00019,3910695,90.71349,4311040
10227,blacksd,8,0.00019,3910703,90.71368,4311040
10228,blanquicet,8,0.00019,3910711,90.71386,4311040
10229,blencoff,8,0.00019,3910719,90.71405,4311040
10230,blind3dd,8,0.00019,3910727,90.71424,4311040
10231,blynch,8,0.00019,3910735,90.71442,4311040
10232,bnallapeta,8,0.00019,3910743,90.71461,4311040
10233,boosty,8,0.00019,3910751,90.71479,4311040
10234,brokenmass,8,0.00019,3910759,90.71498,4311040
10235,brooksmtownsend,8,0.00019,3910767,90.71516,4311040
10236,brunomcustodio,8,0.00019,3910775,90.71535,4311040
10237,brushmate,8,0.00019,3910783,90.71553,4311040
10238,bshelton229,8,0.00019,3910791,90.71572,4311040
10239,btannous,8,0.00019,3910799,90.71591,4311040
10240,bycEEE,8,0.00019,3910807,90.71609,4311040
10241,calebstewart,8,0.00019,3910815,90.71628,4311040
10242,calvinmetcalf,8,0.00019,3910823,90.71646,4311040
10243,CandiceGuo,8,0.00019,3910831,90.71665,4311040
10244,cberner,8,0.00019,3910839,90.71683,4311040
10245,cdaringe,8,0.00019,3910847,90.71702,4311040
10246,cevian,8,0.00019,3910855,90.71721,4311040
10247,cgthayer,8,0.00019,3910863,90.71739,4311040
10248,ChaoyiHuang,8,0.00019,3910871,90.71758,4311040
10249,chez-shanpu,8,0.00019,3910879,90.71776,4311040
10250,chinu-anand,8,0.00019,3910887,90.71795,4311040
10251,chrissng,8,0.00019,3910895,90.71813,4311040
10252,christian-schlichtherle,8,0.00019,3910903,90.71832,4311040
10253,chuntaochen,8,0.00019,3910911,90.71850,4311040
10254,ciberkleid,8,0.00019,3910919,90.71869,4311040
10255,claudiomerli,8,0.00019,3910927,90.71888,4311040
10256,clhuang,8,0.00019,3910935,90.71906,4311040
10257,clook,8,0.00019,3910943,90.71925,4311040
10258,cmcarey,8,0.00019,3910951,90.71943,4311040
10259,c-mcdonnell,8,0.00019,3910959,90.71962,4311040
10260,codeyq,8,0.00019,3910967,90.71980,4311040
10261,cognifloyd,8,0.00019,3910975,90.71999,4311040
10262,cowwoc,8,0.00019,3910983,90.72017,4311040
10263,craigfurman,8,0.00019,3910991,90.72036,4311040
10264,Crevil,8,0.00019,3910999,90.72055,4311040
10265,crgarcia12,8,0.00019,3911007,90.72073,4311040
10266,crielly,8,0.00019,3911015,90.72092,4311040
10267,crigor,8,0.00019,3911023,90.72110,4311040
10268,csfrancis,8,0.00019,3911031,90.72129,4311040
10269,cshiv,8,0.00019,3911039,90.72147,4311040
10270,cwedgwood,8,0.00019,3911047,90.72166,4311040
10271,DanyHenriquez,8,0.00019,3911055,90.72184,4311040
10272,davenso,8,0.00019,3911063,90.72203,4311040
10273,DavidKorczynski,8,0.00019,3911071,90.72222,4311040
10274,davidwtf,8,0.00019,3911079,90.72240,4311040
10275,dbachrach,8,0.00019,3911087,90.72259,4311040
10276,deadmoose,8,0.00019,3911095,90.72277,4311040
10277,deepak1556,8,0.00019,3911103,90.72296,4311040
10278,delgod,8,0.00019,3911111,90.72314,4311040
10279,demonCoder95,8,0.00019,3911119,90.72333,4311040
10280,derek-burdick,8,0.00019,3911127,90.72351,4311040
10281,devlinmr,8,0.00019,3911135,90.72370,4311040
10282,devlounge,8,0.00019,3911143,90.72389,4311040
10283,dewe,8,0.00019,3911151,90.72407,4311040
10284,dhruvmaindola227,8,0.00019,3911159,90.72426,4311040
10285,djannot,8,0.00019,3911167,90.72444,4311040
10286,dnwe,8,0.00019,3911175,90.72463,4311040
10287,dokipen,8,0.00019,3911183,90.72481,4311040
10288,DonMartin76,8,0.00019,3911191,90.72500,4311040
10289,dosullivan,8,0.00019,3911199,90.72518,4311040
10290,dramasamy,8,0.00019,3911207,90.72537,4311040
10291,driusha,8,0.00019,3911215,90.72556,4311040
10292,dshatohin,8,0.00019,3911223,90.72574,4311040
10293,dylanlingelbach,8,0.00019,3911231,90.72593,4311040
10294,dynek,8,0.00019,3911239,90.72611,4311040
10295,dzdx,8,0.00019,3911247,90.72630,4311040
10296,EamonKeane,8,0.00019,3911255,90.72648,4311040
10297,eamontaaffe,8,0.00019,3911263,90.72667,4311040
10298,eatnumber1,8,0.00019,3911271,90.72685,4311040
10299,edganiukov,8,0.00019,3911279,90.72704,4311040
10300,edjee,8,0.00019,3911287,90.72723,4311040
10301,edsondearaujo,8,0.00019,3911295,90.72741,4311040
10302,ekarlso,8,0.00019,3911303,90.72760,4311040
10303,ekeih,8,0.00019,3911311,90.72778,4311040
10304,elliot,8,0.00019,3911319,90.72797,4311040
10305,emetchar,8,0.00019,3911327,90.72815,4311040
10306,emonty,8,0.00019,3911335,90.72834,4311040
10307,emperinter,8,0.00019,3911343,90.72852,4311040
10308,EngHabu,8,0.00019,3911351,90.72871,4311040
10309,enyiakwu,8,0.00019,3911359,90.72890,4311040
10310,erdun,8,0.00019,3911367,90.72908,4311040
10311,esevan,8,0.00019,3911375,90.72927,4311040
10312,etix,8,0.00019,3911383,90.72945,4311040
10313,eviln1,8,0.00019,3911391,90.72964,4311040
10314,f0o,8,0.00019,3911399,90.72982,4311040
10315,faisal-memon,8,0.00019,3911407,90.73001,4311040
10316,Fedomn,8,0.00019,3911415,90.73020,4311040
10317,fireflycons,8,0.00019,3911423,90.73038,4311040
10318,florianb,8,0.00019,3911431,90.73057,4311040
10319,foroozf001,8,0.00019,3911439,90.73075,4311040
10320,francoispqt,8,0.00019,3911447,90.73094,4311040
10321,frankgu968,8,0.00019,3911455,90.73112,4311040
10322,FrediWeber,8,0.00019,3911463,90.73131,4311040
10323,futureperfect,8,0.00019,3911471,90.73149,4311040
10324,FutureSharks,8,0.00019,3911479,90.73168,4311040
10325,fyuan1316,8,0.00019,3911487,90.73187,4311040
10326,GabrielAlacchi,8,0.00019,3911495,90.73205,4311040
10327,GabrielNicolasAvellaneda,8,0.00019,3911503,90.73224,4311040
10328,gabrielweyer,8,0.00019,3911511,90.73242,4311040
10329,GabyCT,8,0.00019,3911519,90.73261,4311040
10330,gaetancollaud,8,0.00019,3911527,90.73279,4311040
10331,ganeshr2,8,0.00019,3911535,90.73298,4311040
10332,gangefors,8,0.00019,3911543,90.73316,4311040
10333,gao-feng,8,0.00019,3911551,90.73335,4311040
10334,geeknoid,8,0.00019,3911559,90.73354,4311040
10335,geNAZt,8,0.00019,3911567,90.73372,4311040
10336,gflarity,8,0.00019,3911575,90.73391,4311040
10337,ghaydtner,8,0.00019,3911583,90.73409,4311040
10338,GnawNom,8,0.00019,3911591,90.73428,4311040
10339,gnomeontherun,8,0.00019,3911599,90.73446,4311040
10340,goenning,8,0.00019,3911607,90.73465,4311040
10341,gooodmorningopenstack,8,0.00019,3911615,90.73483,4311040
10342,goyalnikhil02,8,0.00019,3911623,90.73502,4311040
10343,grossws,8,0.00019,3911631,90.73521,4311040
10344,guce,8,0.00019,3911639,90.73539,4311040
10345,guilhermeblanco,8,0.00019,3911647,90.73558,4311040
10346,GuillaumeDorschner,8,0.00019,3911655,90.73576,4311040
10347,gust1n,8,0.00019,3911663,90.73595,4311040
10348,gyj0825,8,0.00019,3911671,90.73613,4311040
10349,hadianr,8,0.00019,3911679,90.73632,4311040
10350,hanxiaop,8,0.00019,3911687,90.73650,4311040
10351,Happy2C0de,8,0.00019,3911695,90.73669,4311040
10352,hatt,8,0.00019,3911703,90.73688,4311040
10353,hhemied,8,0.00019,3911711,90.73706,4311040
10354,hoeg,8,0.00019,3911719,90.73725,4311040
10355,hoffin,8,0.00019,3911727,90.73743,4311040
10356,hosseinsalahi,8,0.00019,3911735,90.73762,4311040
10357,hostirosti,8,0.00019,3911743,90.73780,4311040
10358,huanghuangzym,8,0.00019,3911751,90.73799,4311040
10359,huanwei,8,0.00019,3911759,90.73817,4311040
10360,hulu1522,8,0.00019,3911767,90.73836,4311040
10361,hzgu-ibm,8,0.00019,3911775,90.73855,4311040
10362,iamShantanu101,8,0.00019,3911783,90.73873,4311040
10363,icelynjennings,8,0.00019,3911791,90.73892,4311040
10364,icepuma,8,0.00019,3911799,90.73910,4311040
10365,igorcanadi,8,0.00019,3911807,90.73929,4311040
10366,illusion202,8,0.00019,3911815,90.73947,4311040
10367,incfly,8,0.00019,3911823,90.73966,4311040
10368,indrayam,8,0.00019,3911831,90.73984,4311040
10369,ingwonsong,8,0.00019,3911839,90.74003,4311040
10370,Ishani-Gupta,8,0.00019,3911847,90.74022,4311040
10371,ivanmp91,8,0.00019,3911855,90.74040,4311040
10372,ivanov-aleksander,8,0.00019,3911863,90.74059,4311040
10373,JacieChao,8,0.00019,3911871,90.74077,4311040
10374,jadekler,8,0.00019,3911879,90.74096,4311040
10375,jahantech,8,0.00019,3911887,90.74114,4311040
10376,jakirpatel,8,0.00019,3911895,90.74133,4311040
10377,Jamim,8,0.00019,3911903,90.74151,4311040
10378,jangrewe,8,0.00019,3911911,90.74170,4311040
10379,janslow,8,0.00019,3911919,90.74189,4311040
10380,Jasper-Ben,8,0.00019,3911927,90.74207,4311040
10381,jbianquetti-nami,8,0.00019,3911935,90.74226,4311040
10382,jbmcfarlin31,8,0.00019,3911943,90.74244,4311040
10383,jbotelho2-bb,8,0.00019,3911951,90.74263,4311040
10384,jdartigalongue,8,0.00019,3911959,90.74281,4311040
10385,jdavis7257,8,0.00019,3911967,90.74300,4311040
10386,jdoliner,8,0.00019,3911975,90.74318,4311040
10387,jduhamel,8,0.00019,3911983,90.74337,4311040
10388,jebbench,8,0.00019,3911991,90.74356,4311040
10389,jeis2497052,8,0.00019,3911999,90.74374,4311040
10390,jenciso,8,0.00019,3912007,90.74393,4311040
10391,jerry153fish,8,0.00019,3912015,90.74411,4311040
10392,jerryrelmore,8,0.00019,3912023,90.74430,4311040
10393,jetsanix,8,0.00019,3912031,90.74448,4311040
10394,jgiles,8,0.00019,3912039,90.74467,4311040
10395,jianxingzhe,8,0.00019,3912047,90.74486,4311040
10396,jijiechen,8,0.00019,3912055,90.74504,4311040
10397,jlothian,8,0.00019,3912063,90.74523,4311040
10398,jlpettersson,8,0.00019,3912071,90.74541,4311040
10399,jmd9019,8,0.00019,3912079,90.74560,4311040
10400,jmgilman,8,0.00019,3912087,90.74578,4311040
10401,joepvand,8,0.00019,3912095,90.74597,4311040
10402,johan-smits,8,0.00019,3912103,90.74615,4311040
10403,johnlabarge,8,0.00019,3912111,90.74634,4311040
10404,johnraz,8,0.00019,3912119,90.74653,4311040
10405,jomach,8,0.00019,3912127,90.74671,4311040
10406,jonahjon,8,0.00019,3912135,90.74690,4311040
10407,joneal,8,0.00019,3912143,90.74708,4311040
10408,JonZeolla,8,0.00019,3912151,90.74727,4311040
10409,jordanyaker,8,0.00019,3912159,90.74745,4311040
10410,joschi36,8,0.00019,3912167,90.74764,4311040
10411,josharian,8,0.00019,3912175,90.74782,4311040
10412,joshiomkarj,8,0.00019,3912183,90.74801,4311040
10413,jparrill,8,0.00019,3912191,90.74820,4311040
10414,jshum2479,8,0.00019,3912199,90.74838,4311040
10415,jsilvela,8,0.00019,3912207,90.74857,4311040
10416,jstoja,8,0.00019,3912215,90.74875,4311040
10417,jstriebel,8,0.00019,3912223,90.74894,4311040
10418,juicemia,8,0.00019,3912231,90.74912,4311040
10419,julienlim,8,0.00019,3912239,90.74931,4311040
10420,juliusmilan,8,0.00019,3912247,90.74949,4311040
10421,jurmous,8,0.00019,3912255,90.74968,4311040
10422,jyotibhanot,8,0.00019,3912263,90.74987,4311040
10423,jzwlqx,8,0.00019,3912271,90.75005,4311040
10424,kaiyee0,8,0.00019,3912279,90.75024,4311040
10425,kajanth,8,0.00019,3912287,90.75042,4311040
10426,kasperbe,8,0.00019,3912295,90.75061,4311040
10427,KeisukeYamashita,8,0.00019,3912303,90.75079,4311040
10428,kevinsingapore,8,0.00019,3912311,90.75098,4311040
10429,killuazhu,8,0.00019,3912319,90.75116,4311040
10430,KingEmet,8,0.00019,3912327,90.75135,4311040
10431,kirecek,8,0.00019,3912335,90.75154,4311040
10432,kirederik,8,0.00019,3912343,90.75172,4311040
10433,kirinrastogi,8,0.00019,3912351,90.75191,4311040
10434,kleesc,8,0.00019,3912359,90.75209,4311040
10435,knackaron,8,0.00019,3912367,90.75228,4311040
10436,KowalczykBartek,8,0.00019,3912375,90.75246,4311040
10437,kunallanjewar,8,0.00019,3912383,90.75265,4311040
10438,kunickiaj,8,0.00019,3912391,90.75283,4311040
10439,kushwiz,8,0.00019,3912399,90.75302,4311040
10440,laik,8,0.00019,3912407,90.75321,4311040
10441,lambertjosh,8,0.00019,3912415,90.75339,4311040
10442,laushinka,8,0.00019,3912423,90.75358,4311040
10443,Lazyshot,8,0.00019,3912431,90.75376,4311040
10444,leandrocr,8,0.00019,3912439,90.75395,4311040
10445,Lemmons,8,0.00019,3912447,90.75413,4311040
10446,linxuyalun,8,0.00019,3912455,90.75432,4311040
10447,lisa,8,0.00019,3912463,90.75450,4311040
10448,litian54,8,0.00019,3912471,90.75469,4311040
10449,llacoste,8,0.00019,3912479,90.75488,4311040
10450,L-MA,8,0.00019,3912487,90.75506,4311040
10451,lmcarreiro,8,0.00019,3912495,90.75525,4311040
10452,longility,8,0.00019,3912503,90.75543,4311040
10453,lorrin,8,0.00019,3912511,90.75562,4311040
10454,louislepper,8,0.00019,3912519,90.75580,4311040
10455,louismunro,8,0.00019,3912527,90.75599,4311040
10456,lrx0014,8,0.00019,3912535,90.75617,4311040
10457,lucastheisen,8,0.00019,3912543,90.75636,4311040
10458,Lucifergene,8,0.00019,3912551,90.75655,4311040
10459,luiscantero,8,0.00019,3912559,90.75673,4311040
10460,maci0,8,0.00019,3912567,90.75692,4311040
10461,maciej-karas-form3,8,0.00019,3912575,90.75710,4311040
10462,MarlonGamez,8,0.00019,3912583,90.75729,4311040
10463,marshallbrekka,8,0.00019,3912591,90.75747,4311040
10464,marviniter,8,0.00019,3912599,90.75766,4311040
10465,maryyliu,8,0.00019,3912607,90.75784,4311040
10466,masih,8,0.00019,3912615,90.75803,4311040
10467,mateimicu,8,0.00019,3912623,90.75822,4311040
10468,MatejB,8,0.00019,3912631,90.75840,4311040
10469,matejhasul,8,0.00019,3912639,90.75859,4311040
10470,MathieuMailhos,8,0.00019,3912647,90.75877,4311040
10471,matt-duch,8,0.00019,3912655,90.75896,4311040
10472,matthewadams,8,0.00019,3912663,90.75914,4311040
10473,mattmattox,8,0.00019,3912671,90.75933,4311040
10474,MaxThom,8,0.00019,3912679,90.75952,4311040
10475,mayankkapoor,8,0.00019,3912687,90.75970,4311040
10476,mazengxie,8,0.00019,3912695,90.75989,4311040
10477,mbonaci,8,0.00019,3912703,90.76007,4311040
10478,mcavoyk,8,0.00019,3912711,90.76026,4311040
10479,mchmielarski,8,0.00019,3912719,90.76044,4311040
10480,mengzyou,8,0.00019,3912727,90.76063,4311040
10481,mffiedler,8,0.00019,3912735,90.76081,4311040
10482,mgcrea,8,0.00019,3912743,90.76100,4311040
10483,mhoran,8,0.00019,3912751,90.76119,4311040
10484,miabbott,8,0.00019,3912759,90.76137,4311040
10485,michaelcourcy,8,0.00019,3912767,90.76156,4311040
10486,michelesr,8,0.00019,3912775,90.76174,4311040
10487,miguelsorianod,8,0.00019,3912783,90.76193,4311040
10488,mikhailadvani,8,0.00019,3912791,90.76211,4311040
10489,Miles-Garnsey,8,0.00019,3912799,90.76230,4311040
10490,mjgallag,8,0.00019,3912807,90.76248,4311040
10491,mkrupczak3,8,0.00019,3912815,90.76267,4311040
10492,MMartyn,8,0.00019,3912823,90.76286,4311040
10493,mmerickel,8,0.00019,3912831,90.76304,4311040
10494,mmilata,8,0.00019,3912839,90.76323,4311040
10495,moebius87,8,0.00019,3912847,90.76341,4311040
10496,mohan-nagandlla,8,0.00019,3912855,90.76360,4311040
10497,moolitayer,8,0.00019,3912863,90.76378,4311040
10498,mopsfelder,8,0.00019,3912871,90.76397,4311040
10499,mortensteenrasmussen,8,0.00019,3912879,90.76415,4311040
10500,mostafahussein,8,0.00019,3912887,90.76434,4311040
10501,MovieStoreGuy,8,0.00019,3912895,90.76453,4311040
10502,mseiwald,8,0.00019,3912903,90.76471,4311040
10503,msscaroso,8,0.00019,3912911,90.76490,4311040
10504,muka,8,0.00019,3912919,90.76508,4311040
10505,mwhooker,8,0.00019,3912927,90.76527,4311040
10506,mwieczorek,8,0.00019,3912935,90.76545,4311040
10507,naeemkhan12,8,0.00019,3912943,90.76564,4311040
10508,nairb774,8,0.00019,3912951,90.76582,4311040
10509,nammn,8,0.00019,3912959,90.76601,4311040
10510,ne0h,8,0.00019,3912967,90.76620,4311040
10511,nehapithadiya,8,0.00019,3912975,90.76638,4311040
10512,neilharris123,8,0.00019,3912983,90.76657,4311040
10513,nerdeveloper,8,0.00019,3912991,90.76675,4311040
10514,netflash,8,0.00019,3912999,90.76694,4311040
10515,neujie,8,0.00019,3913007,90.76712,4311040
10516,nfons,8,0.00019,3913015,90.76731,4311040
10517,nhamlh,8,0.00019,3913023,90.76749,4311040
10518,nicholasklem,8,0.00019,3913031,90.76768,4311040
10519,noam-codefresh,8,0.00019,3913039,90.76787,4311040
10520,nottrobin,8,0.00019,3913047,90.76805,4311040
10521,nphmuller,8,0.00019,3913055,90.76824,4311040
10522,nrshrivatsan,8,0.00019,3913063,90.76842,4311040
10523,nstott,8,0.00019,3913071,90.76861,4311040
10524,nuriel77,8,0.00019,3913079,90.76879,4311040
10525,nutellinoit,8,0.00019,3913087,90.76898,4311040
10526,nyodas,8,0.00019,3913095,90.76916,4311040
10527,objectiveous,8,0.00019,3913103,90.76935,4311040
10528,odg0318,8,0.00019,3913111,90.76954,4311040
10529,Oduig,8,0.00019,3913119,90.76972,4311040
10530,ohookins,8,0.00019,3913127,90.76991,4311040
10531,orimanabu,8,0.00019,3913135,90.77009,4311040
10532,oriyarde,8,0.00019,3913143,90.77028,4311040
10533,orrchen,8,0.00019,3913151,90.77046,4311040
10534,oscarlofwenhamn,8,0.00019,3913159,90.77065,4311040
10535,osery,8,0.00019,3913167,90.77083,4311040
10536,Ottovsky,8,0.00019,3913175,90.77102,4311040
10537,pabelanger,8,0.00019,3913183,90.77121,4311040
10538,pajel,8,0.00019,3913191,90.77139,4311040
10539,ParagDoke,8,0.00019,3913199,90.77158,4311040
10540,paranoidaditya,8,0.00019,3913207,90.77176,4311040
10541,PaulCapestany,8,0.00019,3913215,90.77195,4311040
10542,pburgisser,8,0.00019,3913223,90.77213,4311040
10543,Philmod,8,0.00019,3913231,90.77232,4311040
10544,physcat,8,0.00019,3913239,90.77251,4311040
10545,pilosus,8,0.00019,3913247,90.77269,4311040
10546,PiotrSikora,8,0.00019,3913255,90.77288,4311040
10547,piyushkumar13,8,0.00019,3913263,90.77306,4311040
10548,Placidina,8,0.00019,3913271,90.77325,4311040
10549,pmahoney-raise,8,0.00019,3913279,90.77343,4311040
10550,poblin-orange,8,0.00019,3913287,90.77362,4311040
10551,polasekr,8,0.00019,3913295,90.77380,4311040
10552,ppatierno,8,0.00019,3913303,90.77399,4311040
10553,PrayagS,8,0.00019,3913311,90.77418,4311040
10554,presidenten,8,0.00019,3913319,90.77436,4311040
10555,Preskton,8,0.00019,3913327,90.77455,4311040
10556,ptagr,8,0.00019,3913335,90.77473,4311040
10557,purpleidea,8,0.00019,3913343,90.77492,4311040
10558,qrilka,8,0.00019,3913351,90.77510,4311040
10559,Raffa50,8,0.00019,3913359,90.77529,4311040
10560,rafis,8,0.00019,3913367,90.77547,4311040
10561,rahulrai-in,8,0.00019,3913375,90.77566,4311040
10562,rahulwa,8,0.00019,3913383,90.77585,4311040
10563,rainleander,8,0.00019,3913391,90.77603,4311040
10564,rbizzell40,8,0.00019,3913399,90.77622,4311040
10565,rbwsam,8,0.00019,3913407,90.77640,4311040
10566,rdgacarvalho,8,0.00019,3913415,90.77659,4311040
10567,redixin,8,0.00019,3913423,90.77677,4311040
10568,reiz,8,0.00019,3913431,90.77696,4311040
10569,relu,8,0.00019,3913439,90.77714,4311040
10570,remore,8,0.00019,3913447,90.77733,4311040
10571,rlankfo,8,0.00019,3913455,90.77752,4311040
10572,robertgzr,8,0.00019,3913463,90.77770,4311040
10573,robozb,8,0.00019,3913471,90.77789,4311040
10574,rocketspacer,8,0.00019,3913479,90.77807,4311040
10575,RockyFu267,8,0.00019,3913487,90.77826,4311040
10576,rogeriomm,8,0.00019,3913495,90.77844,4311040
10577,romoh,8,0.00019,3913503,90.77863,4311040
10578,ronnylt,8,0.00019,3913511,90.77881,4311040
10579,rshriram,8,0.00019,3913519,90.77900,4311040
10580,rud,8,0.00019,3913527,90.77919,4311040
10581,rueyaa332266,8,0.00019,3913535,90.77937,4311040
10582,rumshenoy,8,0.00019,3913543,90.77956,4311040
10583,Russell-IO,8,0.00019,3913551,90.77974,4311040
10584,ryysud,8,0.00019,3913559,90.77993,4311040
10585,s4mur4i,8,0.00019,3913567,90.78011,4311040
10586,sachincool,8,0.00019,3913575,90.78030,4311040
10587,sachinmsft,8,0.00019,3913583,90.78048,4311040
10588,samanthakem,8,0.00019,3913591,90.78067,4311040
10589,sambhavgupta0705,8,0.00019,3913599,90.78086,4311040
10590,SamiHiltunen,8,0.00019,3913607,90.78104,4311040
10591,sancyx,8,0.00019,3913615,90.78123,4311040
10592,sandromodarelli,8,0.00019,3913623,90.78141,4311040
10593,SantosRay,8,0.00019,3913631,90.78160,4311040
10594,savitha-ping,8,0.00019,3913639,90.78178,4311040
10595,sayanibhattacharjee,8,0.00019,3913647,90.78197,4311040
10596,sbadia,8,0.00019,3913655,90.78215,4311040
10597,scuxiayiqian,8,0.00019,3913663,90.78234,4311040
10598,sdboyer,8,0.00019,3913671,90.78253,4311040
10599,sebbrandt87,8,0.00019,3913679,90.78271,4311040
10600,seils,8,0.00019,3913687,90.78290,4311040
10601,seperman,8,0.00019,3913695,90.78308,4311040
10602,shahidhk,8,0.00019,3913703,90.78327,4311040
10603,shaikatz,8,0.00019,3913711,90.78345,4311040
10604,shiftkey,8,0.00019,3913719,90.78364,4311040
10605,Shini31,8,0.00019,3913727,90.78382,4311040
10606,shubhamchaudhary,8,0.00019,3913735,90.78401,4311040
10607,SimonHoenscheid,8,0.00019,3913743,90.78420,4311040
10608,simon-k8s,8,0.00019,3913751,90.78438,4311040
10609,simonwydooghe,8,0.00019,3913759,90.78457,4311040
10610,sjernigan,8,0.00019,3913767,90.78475,4311040
10611,smitthakkar96,8,0.00019,3913775,90.78494,4311040
10612,sneumann,8,0.00019,3913783,90.78512,4311040
10613,SongGithub,8,0.00019,3913791,90.78531,4311040
10614,sostheim,8,0.00019,3913799,90.78549,4311040
10615,sourabh1031,8,0.00019,3913807,90.78568,4311040
10616,souravsekhar,8,0.00019,3913815,90.78587,4311040
10617,spencergilbert,8,0.00019,3913823,90.78605,4311040
10618,sperrenotcantin,8,0.00019,3913831,90.78624,4311040
10619,spiarh,8,0.00019,3913839,90.78642,4311040
10620,sschober,8,0.00019,3913847,90.78661,4311040
10621,stanleynguyen,8,0.00019,3913855,90.78679,4311040
10622,StarpTech,8,0.00019,3913863,90.78698,4311040
10623,steelecliftonberry,8,0.00019,3913871,90.78717,4311040
10624,Stelminator,8,0.00019,3913879,90.78735,4311040
10625,SteveBisnett,8,0.00019,3913887,90.78754,4311040
10626,stevensu1977,8,0.00019,3913895,90.78772,4311040
10627,StevenYCChou,8,0.00019,3913903,90.78791,4311040
10628,stieler-it,8,0.00019,3913911,90.78809,4311040
10629,superdump,8,0.00019,3913919,90.78828,4311040
10630,SwEngin,8,0.00019,3913927,90.78846,4311040
10631,tarokkk,8,0.00019,3913935,90.78865,4311040
10632,TBeijen,8,0.00019,3913943,90.78884,4311040
10633,tchellomello,8,0.00019,3913951,90.78902,4311040
10634,tedli,8,0.00019,3913959,90.78921,4311040
10635,tetianakravchenko,8,0.00019,3913967,90.78939,4311040
10636,thackem,8,0.00019,3913975,90.78958,4311040
10637,TheEdgeOfRage,8,0.00019,3913983,90.78976,4311040
10638,theishshah,8,0.00019,3913991,90.78995,4311040
10639,theodor2311,8,0.00019,3913999,90.79013,4311040
10640,thomasmey,8,0.00019,3914007,90.79032,4311040
10641,tibin-mfl,8,0.00019,3914015,90.79051,4311040
10642,tjons,8,0.00019,3914023,90.79069,4311040
10643,tlvenn,8,0.00019,3914031,90.79088,4311040
10644,tobru,8,0.00019,3914039,90.79106,4311040
10645,toidi,8,0.00019,3914047,90.79125,4311040
10646,tomassedovic,8,0.00019,3914055,90.79143,4311040
10647,tomcsi,8,0.00019,3914063,90.79162,4311040
10648,tompizmor,8,0.00019,3914071,90.79180,4311040
10649,torresdal,8,0.00019,3914079,90.79199,4311040
10650,totemcaf,8,0.00019,3914087,90.79218,4311040
10651,trashhalo,8,0.00019,3914095,90.79236,4311040
10652,trisberg,8,0.00019,3914103,90.79255,4311040
10653,trozet,8,0.00019,3914111,90.79273,4311040
10654,tudor,8,0.00019,3914119,90.79292,4311040
10655,tylfin,8,0.00019,3914127,90.79310,4311040
10656,u0000000021,8,0.00019,3914135,90.79329,4311040
10657,ueokande,8,0.00019,3914143,90.79347,4311040
10658,urvil38,8,0.00019,3914151,90.79366,4311040
10659,Uzuku,8,0.00019,3914159,90.79385,4311040
10660,valorl,8,0.00019,3914167,90.79403,4311040
10661,vasiliy-ul,8,0.00019,3914175,90.79422,4311040
10662,vdice,8,0.00019,3914183,90.79440,4311040
10663,VenkatRamaraju,8,0.00019,3914191,90.79459,4311040
10664,veqryn,8,0.00019,3914199,90.79477,4311040
10665,vertti,8,0.00019,3914207,90.79496,4311040
10666,vibecoder,8,0.00019,3914215,90.79514,4311040
10667,viggys,8,0.00019,3914223,90.79533,4311040
10668,VioletRainbows,8,0.00019,3914231,90.79552,4311040
10669,vipinjn24,8,0.00019,3914239,90.79570,4311040
10670,vishal-biyani,8,0.00019,3914247,90.79589,4311040
10671,vmahedia,8,0.00019,3914255,90.79607,4311040
10672,vmbrasseur,8,0.00019,3914263,90.79626,4311040
10673,vsoutherner,8,0.00019,3914271,90.79644,4311040
10674,vvishal1,8,0.00019,3914279,90.79663,4311040
10675,w4-sjcho,8,0.00019,3914287,90.79681,4311040
10676,WandyLau,8,0.00019,3914295,90.79700,4311040
10677,wencaiwulue,8,0.00019,3914303,90.79719,4311040
10678,wgj,8,0.00019,3914311,90.79737,4311040
10679,wgordon17,8,0.00019,3914319,90.79756,4311040
10680,while1malloc0,8,0.00019,3914327,90.79774,4311040
10681,winromulus,8,0.00019,3914335,90.79793,4311040
10682,wlynch,8,0.00019,3914343,90.79811,4311040
10683,wr0ngway,8,0.00019,3914351,90.79830,4311040
10684,xhzhf,8,0.00019,3914359,90.79848,4311040
10685,xlucas,8,0.00019,3914367,90.79867,4311040
10686,xxx7xxxx,8,0.00019,3914375,90.79886,4311040
10687,yangsoon,8,0.00019,3914383,90.79904,4311040
10688,yashchaddha,8,0.00019,3914391,90.79923,4311040
10689,yasindce1998,8,0.00019,3914399,90.79941,4311040
10690,yhwang,8,0.00019,3914407,90.79960,4311040
10691,Yogendra0Sharma,8,0.00019,3914415,90.79978,4311040
10692,yoshwata,8,0.00019,3914423,90.79997,4311040
10693,yp28,8,0.00019,3914431,90.80015,4311040
10694,yu2003w,8,0.00019,3914439,90.80034,4311040
10695,ZakMiller,8,0.00019,3914447,90.80053,4311040
10696,zeromsi,8,0.00019,3914455,90.80071,4311040
10697,zhiweiyin318,8,0.00019,3914463,90.80090,4311040
10698,zimbatm,8,0.00019,3914471,90.80108,4311040
10699,zjkmxy,8,0.00019,3914479,90.80127,4311040
10700,zloo,8,0.00019,3914487,90.80145,4311040
10701,zombor,8,0.00019,3914495,90.80164,4311040
10702,zoran15,8,0.00019,3914503,90.80183,4311040
10703,06kellyjac,7,0.00016,3914510,90.80199,4311040
10704,11xor6,7,0.00016,3914517,90.80215,4311040
10705,22dm,7,0.00016,3914524,90.80231,4311040
10706,24601,7,0.00016,3914531,90.80247,4311040
10707,aaomidi,7,0.00016,3914538,90.80264,4311040
10708,aaronSig,7,0.00016,3914545,90.80280,4311040
10709,AbirHamzi,7,0.00016,3914552,90.80296,4311040
10710,achilles42,7,0.00016,3914559,90.80312,4311040
10711,adelca,7,0.00016,3914566,90.80329,4311040
10712,adityabyreddy74,7,0.00016,3914573,90.80345,4311040
10713,AdityaVardhanSingh,7,0.00016,3914580,90.80361,4311040
10714,adri,7,0.00016,3914587,90.80377,4311040
10715,advissor,7,0.00016,3914594,90.80394,4311040
10716,ael-g,7,0.00016,3914601,90.80410,4311040
10717,agaoglu,7,0.00016,3914608,90.80426,4311040
10718,agronholm,7,0.00016,3914615,90.80442,4311040
10719,ahaeber,7,0.00016,3914622,90.80459,4311040
10720,ahoehma,7,0.00016,3914629,90.80475,4311040
10721,aiman-alsari,7,0.00016,3914636,90.80491,4311040
10722,ainoya,7,0.00016,3914643,90.80507,4311040
10723,aixeshunter,7,0.00016,3914650,90.80523,4311040
10724,ajfriesen,7,0.00016,3914657,90.80540,4311040
10725,ajpauwels,7,0.00016,3914664,90.80556,4311040
10726,aka-bo,7,0.00016,3914671,90.80572,4311040
10727,akoserwal,7,0.00016,3914678,90.80588,4311040
10728,albanm,7,0.00016,3914685,90.80605,4311040
10729,albertomurillo,7,0.00016,3914692,90.80621,4311040
10730,alessandroargentieri,7,0.00016,3914699,90.80637,4311040
10731,AlexandreRoba,7,0.00016,3914706,90.80653,4311040
10732,AlginMaduro,7,0.00016,3914713,90.80670,4311040
10733,alien19880726,7,0.00016,3914720,90.80686,4311040
10734,alonl,7,0.00016,3914727,90.80702,4311040
10735,amoskyler,7,0.00016,3914734,90.80718,4311040
10736,amybachir,7,0.00016,3914741,90.80735,4311040
10737,ancatri,7,0.00016,3914748,90.80751,4311040
10738,andrebrait,7,0.00016,3914755,90.80767,4311040
10739,andrescaroc,7,0.00016,3914762,90.80783,4311040
10740,andresvia,7,0.00016,3914769,90.80800,4311040
10741,andrewjamesmorgan,7,0.00016,3914776,90.80816,4311040
10742,andyyoung01,7,0.00016,3914783,90.80832,4311040
10743,aneeshep,7,0.00016,3914790,90.80848,4311040
10744,anhldbk,7,0.00016,3914797,90.80864,4311040
10745,anirudhjayakumar,7,0.00016,3914804,90.80881,4311040
10746,anshumanbh,7,0.00016,3914811,90.80897,4311040
10747,antony360,7,0.00016,3914818,90.80913,4311040
10748,apmarshall,7,0.00016,3914825,90.80929,4311040
10749,apolovov,7,0.00016,3914832,90.80946,4311040
10750,archyufa,7,0.00016,3914839,90.80962,4311040
10751,arielshaqed,7,0.00016,3914846,90.80978,4311040
10752,arriqaaq,7,0.00016,3914853,90.80994,4311040
10753,arukaen,7,0.00016,3914860,90.81011,4311040
10754,arunvelsriram,7,0.00016,3914867,90.81027,4311040
10755,aschepis,7,0.00016,3914874,90.81043,4311040
10756,asellappen,7,0.00016,3914881,90.81059,4311040
10757,asheldon,7,0.00016,3914888,90.81076,4311040
10758,ashishxooa,7,0.00016,3914895,90.81092,4311040
10759,AshutoshNirkhe,7,0.00016,3914902,90.81108,4311040
10760,askreet,7,0.00016,3914909,90.81124,4311040
10761,askulkarni2,7,0.00016,3914916,90.81141,4311040
10762,ayj,7,0.00016,3914923,90.81157,4311040
10763,Azrrael,7,0.00016,3914930,90.81173,4311040
10764,bathina2,7,0.00016,3914937,90.81189,4311040
10765,bcanozter,7,0.00016,3914944,90.81205,4311040
10766,benc-uk,7,0.00016,3914951,90.81222,4311040
10767,bendavis78,7,0.00016,3914958,90.81238,4311040
10768,BenHesketh21,7,0.00016,3914965,90.81254,4311040
10769,berlincount,7,0.00016,3914972,90.81270,4311040
10770,bhaggerty,7,0.00016,3914979,90.81287,4311040
10771,bilalmalik777,7,0.00016,3914986,90.81303,4311040
10772,bingohuang,7,0.00016,3914993,90.81319,4311040
10773,blackheaven,7,0.00016,3915000,90.81335,4311040
10774,blueyed,7,0.00016,3915007,90.81352,4311040
10775,bndw,7,0.00016,3915014,90.81368,4311040
10776,boazy,7,0.00016,3915021,90.81384,4311040
10777,bogard1203,7,0.00016,3915028,90.81400,4311040
10778,Boskey,7,0.00016,3915035,90.81417,4311040
10779,bpradipt,7,0.00016,3915042,90.81433,4311040
10780,bradmwalker,7,0.00016,3915049,90.81449,4311040
10781,bsherman,7,0.00016,3915056,90.81465,4311040
10782,bshi,7,0.00016,3915063,90.81481,4311040
10783,BuddhiWathsala,7,0.00016,3915070,90.81498,4311040
10784,BudhirajaMadhav,7,0.00016,3915077,90.81514,4311040
10785,burntcarrot,7,0.00016,3915084,90.81530,4311040
10786,buzzsurfr,7,0.00016,3915091,90.81546,4311040
10787,byrneo,7,0.00016,3915098,90.81563,4311040
10788,caffeinism,7,0.00016,3915105,90.81579,4311040
10789,caglar10ur,7,0.00016,3915112,90.81595,4311040
10790,cainelli,7,0.00016,3915119,90.81611,4311040
10791,caiobrentano,7,0.00016,3915126,90.81628,4311040
10792,callermann,7,0.00016,3915133,90.81644,4311040
10793,callicles,7,0.00016,3915140,90.81660,4311040
10794,CameronHall,7,0.00016,3915147,90.81676,4311040
10795,casey-robertson,7,0.00016,3915154,90.81693,4311040
10796,cdivitotawela,7,0.00016,3915161,90.81709,4311040
10797,cflee,7,0.00016,3915168,90.81725,4311040
10798,cgag,7,0.00016,3915175,90.81741,4311040
10799,ChaosInTheCRD,7,0.00016,3915182,90.81758,4311040
10800,charleslieferando,7,0.00016,3915189,90.81774,4311040
10801,charlottemach,7,0.00016,3915196,90.81790,4311040
10802,chees,7,0.00016,3915203,90.81806,4311040
10803,cheynewallace,7,0.00016,3915210,90.81822,4311040
10804,chgl,7,0.00016,3915217,90.81839,4311040
10805,chiraggupta06,7,0.00016,3915224,90.81855,4311040
10806,chonton,7,0.00016,3915231,90.81871,4311040
10807,christian-posta,7,0.00016,3915238,90.81887,4311040
10808,chuanchang,7,0.00016,3915245,90.81904,4311040
10809,cilindrox,7,0.00016,3915252,90.81920,4311040
10810,cjhpaul,7,0.00016,3915259,90.81936,4311040
10811,CMartinUdden,7,0.00016,3915266,90.81952,4311040
10812,colindev,7,0.00016,3915273,90.81969,4311040
10813,coopstah13,7,0.00016,3915280,90.81985,4311040
10814,cortextual,7,0.00016,3915287,90.82001,4311040
10815,cpoole,7,0.00016,3915294,90.82017,4311040
10816,crunchie84,7,0.00016,3915301,90.82034,4311040
10817,cyberious,7,0.00016,3915308,90.82050,4311040
10818,cychiang,7,0.00016,3915315,90.82066,4311040
10819,Cynocracy,7,0.00016,3915322,90.82082,4311040
10820,danielkrainas,7,0.00016,3915329,90.82099,4311040
10821,dan-slinky-ckpd,7,0.00016,3915336,90.82115,4311040
10822,darobs,7,0.00016,3915343,90.82131,4311040
10823,darryk10,7,0.00016,3915350,90.82147,4311040
10824,darthcorsair,7,0.00016,3915357,90.82163,4311040
10825,davidebelloni,7,0.00016,3915364,90.82180,4311040
10826,davidor,7,0.00016,3915371,90.82196,4311040
10827,davis-haba,7,0.00016,3915378,90.82212,4311040
10828,d-baranowski,7,0.00016,3915385,90.82228,4311040
10829,dbarranco,7,0.00016,3915392,90.82245,4311040
10830,dbsanfte,7,0.00016,3915399,90.82261,4311040
10831,Dbz,7,0.00016,3915406,90.82277,4311040
10832,deepakpunjabi,7,0.00016,3915413,90.82293,4311040
10833,deepaksood619,7,0.00016,3915420,90.82310,4311040
10834,denhamparry,7,0.00016,3915427,90.82326,4311040
10835,deployable,7,0.00016,3915434,90.82342,4311040
10836,derrickburns,7,0.00016,3915441,90.82358,4311040
10837,deveshk0,7,0.00016,3915448,90.82375,4311040
10838,devinburnette,7,0.00016,3915455,90.82391,4311040
10839,dewet22,7,0.00016,3915462,90.82407,4311040
10840,deyceg,7,0.00016,3915469,90.82423,4311040
10841,dfr,7,0.00016,3915476,90.82440,4311040
10842,dgem,7,0.00016,3915483,90.82456,4311040
10843,dgoujard,7,0.00016,3915490,90.82472,4311040
10844,dhadukk,7,0.00016,3915497,90.82488,4311040
10845,dhoeric,7,0.00016,3915504,90.82504,4311040
10846,dhrupadb,7,0.00016,3915511,90.82521,4311040
10847,dichen16,7,0.00016,3915518,90.82537,4311040
10848,dileep-p,7,0.00016,3915525,90.82553,4311040
10849,dinesh,7,0.00016,3915532,90.82569,4311040
10850,dioguerra,7,0.00016,3915539,90.82586,4311040
10851,dishantsethi,7,0.00016,3915546,90.82602,4311040
10852,djha736,7,0.00016,3915553,90.82618,4311040
10853,djvirgen,7,0.00016,3915560,90.82634,4311040
10854,dkorn,7,0.00016,3915567,90.82651,4311040
10855,dmytronasyrov,7,0.00016,3915574,90.82667,4311040
10856,dobegor,7,0.00016,3915581,90.82683,4311040
10857,doehyunbaek,7,0.00016,3915588,90.82699,4311040
10858,dogukanturan,7,0.00016,3915595,90.82716,4311040
10859,dongwenjuan,7,0.00016,3915602,90.82732,4311040
10860,dottodot,7,0.00016,3915609,90.82748,4311040
10861,dozer47528,7,0.00016,3915616,90.82764,4311040
10862,dpkirchner,7,0.00016,3915623,90.82780,4311040
10863,dprince,7,0.00016,3915630,90.82797,4311040
10864,drakedevel,7,0.00016,3915637,90.82813,4311040
10865,DrissiReda,7,0.00016,3915644,90.82829,4311040
10866,drunkirishcoder,7,0.00016,3915651,90.82845,4311040
10867,drusellers,7,0.00016,3915658,90.82862,4311040
10868,dseeley,7,0.00016,3915665,90.82878,4311040
10869,dtpryce,7,0.00016,3915672,90.82894,4311040
10870,duckie,7,0.00016,3915679,90.82910,4311040
10871,ducwindow,7,0.00016,3915686,90.82927,4311040
10872,dymurray,7,0.00016,3915693,90.82943,4311040
10873,ecnahc515,7,0.00016,3915700,90.82959,4311040
10874,edgarlanting,7,0.00016,3915707,90.82975,4311040
10875,edmorley,7,0.00016,3915714,90.82992,4311040
10876,edwardbadboy,7,0.00016,3915721,90.83008,4311040
10877,efranford,7,0.00016,3915728,90.83024,4311040
10878,eguven,7,0.00016,3915735,90.83040,4311040
10879,eigood,7,0.00016,3915742,90.83057,4311040
10880,eik3,7,0.00016,3915749,90.83073,4311040
10881,elcomtik,7,0.00016,3915756,90.83089,4311040
10882,emailksravi,7,0.00016,3915763,90.83105,4311040
10883,emerlinsky,7,0.00016,3915770,90.83121,4311040
10884,epsniff,7,0.00016,3915777,90.83138,4311040
10885,eqrx,7,0.00016,3915784,90.83154,4311040
10886,ericjee,7,0.00016,3915791,90.83170,4311040
10887,ericpromislow,7,0.00016,3915798,90.83186,4311040
10888,erik777,7,0.00016,3915805,90.83203,4311040
10889,eseliger,7,0.00016,3915812,90.83219,4311040
10890,essh,7,0.00016,3915819,90.83235,4311040
10891,ewolff,7,0.00016,3915826,90.83251,4311040
10892,ewrenn8,7,0.00016,3915833,90.83268,4311040
10893,exocode,7,0.00016,3915840,90.83284,4311040
10894,ezeeyahoo,7,0.00016,3915847,90.83300,4311040
10895,fabianbaier,7,0.00016,3915854,90.83316,4311040
10896,fabioformosa,7,0.00016,3915861,90.83333,4311040
10897,farvour,7,0.00016,3915868,90.83349,4311040
10898,feeltimeQ,7,0.00016,3915875,90.83365,4311040
10899,fg91,7,0.00016,3915882,90.83381,4311040
10900,FGRibreau,7,0.00016,3915889,90.83398,4311040
10901,fhopfensperger,7,0.00016,3915896,90.83414,4311040
10902,figaw,7,0.00016,3915903,90.83430,4311040
10903,flavono123,7,0.00016,3915910,90.83446,4311040
10904,fmoctezuma,7,0.00016,3915917,90.83462,4311040
10905,foobaar,7,0.00016,3915924,90.83479,4311040
10906,frank-dspeed,7,0.00016,3915931,90.83495,4311040
10907,franznemeth,7,0.00016,3915938,90.83511,4311040
10908,fredrik-smedberg,7,0.00016,3915945,90.83527,4311040
10909,gacopl,7,0.00016,3915952,90.83544,4311040
10910,gaelgatelement,7,0.00016,3915959,90.83560,4311040
10911,gaetansnl,7,0.00016,3915966,90.83576,4311040
10912,GantzGit,7,0.00016,3915973,90.83592,4311040
10913,gaopeiliang,7,0.00016,3915980,90.83609,4311040
10914,gauthierbl,7,0.00016,3915987,90.83625,4311040
10915,gfrid,7,0.00016,3915994,90.83641,4311040
10916,ghost974,7,0.00016,3916001,90.83657,4311040
10917,ghuntley,7,0.00016,3916008,90.83674,4311040
10918,gillg,7,0.00016,3916015,90.83690,4311040
10919,gnustavo,7,0.00016,3916022,90.83706,4311040
10920,gobengo,7,0.00016,3916029,90.83722,4311040
10921,gozer,7,0.00016,3916036,90.83738,4311040
10922,gpaul,7,0.00016,3916043,90.83755,4311040
10923,growse,7,0.00016,3916050,90.83771,4311040
10924,gruppferi,7,0.00016,3916057,90.83787,4311040
10925,guilhermesteinmuller,7,0.00016,3916064,90.83803,4311040
10926,gustavovalverde,7,0.00016,3916071,90.83820,4311040
10927,h4wkmoon,7,0.00016,3916078,90.83836,4311040
10928,haarchri,7,0.00016,3916085,90.83852,4311040
10929,halil-bugol,7,0.00016,3916092,90.83868,4311040
10930,harper1011,7,0.00016,3916099,90.83885,4311040
10931,harryttd,7,0.00016,3916106,90.83901,4311040
10932,hasan4791,7,0.00016,3916113,90.83917,4311040
10933,hcguersoy,7,0.00016,3916120,90.83933,4311040
10934,hdiass,7,0.00016,3916127,90.83950,4311040
10935,hendrikhalkow,7,0.00016,3916134,90.83966,4311040
10936,HitkoDev,7,0.00016,3916141,90.83982,4311040
10937,hoeghh,7,0.00016,3916148,90.83998,4311040
10938,holyjak,7,0.00016,3916155,90.84015,4311040
10939,horaceheaven,7,0.00016,3916162,90.84031,4311040
10940,hossambarakat,7,0.00016,3916169,90.84047,4311040
10941,hqhq,7,0.00016,3916176,90.84063,4311040
10942,hrabhijith,7,0.00016,3916183,90.84079,4311040
10943,htuch,7,0.00016,3916190,90.84096,4311040
10944,hualongfeng,7,0.00016,3916197,90.84112,4311040
10945,HubertStefanski,7,0.00016,3916204,90.84128,4311040
10946,hyc3z,7,0.00016,3916211,90.84144,4311040
10947,iam-veeramalla,7,0.00016,3916218,90.84161,4311040
10948,ianfisk,7,0.00016,3916225,90.84177,4311040
10949,iArchitSharma,7,0.00016,3916232,90.84193,4311040
10950,icco,7,0.00016,3916239,90.84209,4311040
10951,igalic,7,0.00016,3916246,90.84226,4311040
10952,ikatson,7,0.00016,3916253,90.84242,4311040
10953,ikoevska,7,0.00016,3916260,90.84258,4311040
10954,ikropotov,7,0.00016,3916267,90.84274,4311040
10955,illume,7,0.00016,3916274,90.84291,4311040
10956,imranismail,7,0.00016,3916281,90.84307,4311040
10957,inc0,7,0.00016,3916288,90.84323,4311040
10958,isimluk,7,0.00016,3916295,90.84339,4311040
10959,isindir,7,0.00016,3916302,90.84356,4311040
10960,itamar-resonai,7,0.00016,3916309,90.84372,4311040
10961,itamarst,7,0.00016,3916316,90.84388,4311040
10962,itsnagaraj,7,0.00016,3916323,90.84404,4311040
10963,itsuugo,7,0.00016,3916330,90.84420,4311040
10964,iwilltry42,7,0.00016,3916337,90.84437,4311040
10965,jaggerwang,7,0.00016,3916344,90.84453,4311040
10966,Jake-Smullin,7,0.00016,3916351,90.84469,4311040
10967,JamesDeFabia,7,0.00016,3916358,90.84485,4311040
10968,jamiefang,7,0.00016,3916365,90.84502,4311040
10969,jatins,7,0.00016,3916372,90.84518,4311040
10970,javanthropus,7,0.00016,3916379,90.84534,4311040
10971,javiermarasco,7,0.00016,3916386,90.84550,4311040
10972,jbdoumenjou,7,0.00016,3916393,90.84567,4311040
10973,jcrsilva,7,0.00016,3916400,90.84583,4311040
10974,jebeaudet,7,0.00016,3916407,90.84599,4311040
10975,jeffersongirao,7,0.00016,3916414,90.84615,4311040
10976,jeffrey4l,7,0.00016,3916421,90.84632,4311040
10977,jeffrichiefs,7,0.00016,3916428,90.84648,4311040
10978,jeremyjjbrown,7,0.00016,3916435,90.84664,4311040
10979,jfgauron,7,0.00016,3916442,90.84680,4311040
10980,JHK,7,0.00016,3916449,90.84697,4311040
10981,jiaweizhou,7,0.00016,3916456,90.84713,4311040
10982,JimmyCYJ,7,0.00016,3916463,90.84729,4311040
10983,joaovitor,7,0.00016,3916470,90.84745,4311040
10984,joar,7,0.00016,3916477,90.84761,4311040
10985,jobstoit,7,0.00016,3916484,90.84778,4311040
10986,JoeAshworth,7,0.00016,3916491,90.84794,4311040
10987,johnsonshi,7,0.00016,3916498,90.84810,4311040
10988,jojje,7,0.00016,3916505,90.84826,4311040
10989,jokeyrhyme,7,0.00016,3916512,90.84843,4311040
10990,Jonher937,7,0.00016,3916519,90.84859,4311040
10991,jonsabo,7,0.00016,3916526,90.84875,4311040
10992,jordinl83,7,0.00016,3916533,90.84891,4311040
10993,josecastillolema,7,0.00016,3916540,90.84908,4311040
10994,josephlewis42,7,0.00016,3916547,90.84924,4311040
10995,joshti,7,0.00016,3916554,90.84940,4311040
10996,joshuasimon-taulia,7,0.00016,3916561,90.84956,4311040
10997,jpanda-cn,7,0.00016,3916568,90.84973,4311040
10998,jpeterson88,7,0.00016,3916575,90.84989,4311040
10999,jrcichra,7,0.00016,3916582,90.85005,4311040
11000,jrosinsk,7,0.00016,3916589,90.85021,4311040
11001,jtherin,7,0.00016,3916596,90.85037,4311040
11002,julienp,7,0.00016,3916603,90.85054,4311040
11003,juneharton,7,0.00016,3916610,90.85070,4311040
11004,junkiebev,7,0.00016,3916617,90.85086,4311040
11005,JustinKuli,7,0.00016,3916624,90.85102,4311040
11006,kalverra,7,0.00016,3916631,90.85119,4311040
11007,karolz-ms,7,0.00016,3916638,90.85135,4311040
11008,karunchennuri,7,0.00016,3916645,90.85151,4311040
11009,katsuharu,7,0.00016,3916652,90.85167,4311040
11010,kedare,7,0.00016,3916659,90.85184,4311040
11011,keeganwitt,7,0.00016,3916666,90.85200,4311040
11012,kemitche,7,0.00016,3916673,90.85216,4311040
11013,kevinburke,7,0.00016,3916680,90.85232,4311040
11014,kforsthoevel,7,0.00016,3916687,90.85249,4311040
11015,khelll,7,0.00016,3916694,90.85265,4311040
11016,kim-tsao,7,0.00016,3916701,90.85281,4311040
11017,kitarp29,7,0.00016,3916708,90.85297,4311040
11018,knarz,7,0.00016,3916715,90.85314,4311040
11019,koflerm,7,0.00016,3916722,90.85330,4311040
11020,KongZ,7,0.00016,3916729,90.85346,4311040
11021,ksummersill2,7,0.00016,3916736,90.85362,4311040
11022,kvolkovich-sc,7,0.00016,3916743,90.85378,4311040
11023,langecode,7,0.00016,3916750,90.85395,4311040
11024,larmog,7,0.00016,3916757,90.85411,4311040
11025,larosek,7,0.00016,3916764,90.85427,4311040
11026,laugimethods,7,0.00016,3916771,90.85443,4311040
11027,lbudai74,7,0.00016,3916778,90.85460,4311040
11028,lcrisci,7,0.00016,3916785,90.85476,4311040
11029,lelandsindttouchnet,7,0.00016,3916792,90.85492,4311040
11030,lilinji,7,0.00016,3916799,90.85508,4311040
11031,linericyang,7,0.00016,3916806,90.85525,4311040
11032,liranmauda,7,0.00016,3916813,90.85541,4311040
11033,lonelyCZ,7,0.00016,3916820,90.85557,4311040
11034,losha228,7,0.00016,3916827,90.85573,4311040
11035,lparam,7,0.00016,3916834,90.85590,4311040
11036,lpmi-13,7,0.00016,3916841,90.85606,4311040
11037,lucklove,7,0.00016,3916848,90.85622,4311040
11038,luctowers,7,0.00016,3916855,90.85638,4311040
11039,lujiajing1126,7,0.00016,3916862,90.85655,4311040
11040,Luttik,7,0.00016,3916869,90.85671,4311040
11041,maciekmm,7,0.00016,3916876,90.85687,4311040
11042,mafzst,7,0.00016,3916883,90.85703,4311040
11043,MahmoodKamali,7,0.00016,3916890,90.85719,4311040
11044,manjeetsinghcodz,7,0.00016,3916897,90.85736,4311040
11045,maorfr,7,0.00016,3916904,90.85752,4311040
11046,marceldegraaf,7,0.00016,3916911,90.85768,4311040
11047,MarcErdmann,7,0.00016,3916918,90.85784,4311040
11048,MarckK,7,0.00016,3916925,90.85801,4311040
11049,marcostvz,7,0.00016,3916932,90.85817,4311040
11050,markacola,7,0.00016,3916939,90.85833,4311040
11051,markzhang0928,7,0.00016,3916946,90.85849,4311040
11052,martinlevesque,7,0.00016,3916953,90.85866,4311040
11053,matancarmeli7,7,0.00016,3916960,90.85882,4311040
11054,matschaffer,7,0.00016,3916967,90.85898,4311040
11055,matt-deboer,7,0.00016,3916974,90.85914,4311040
11056,matt-simons,7,0.00016,3916981,90.85931,4311040
11057,matt-tyler,7,0.00016,3916988,90.85947,4311040
11058,MayXuQQ,7,0.00016,3916995,90.85963,4311040
11059,mballoni,7,0.00016,3917002,90.85979,4311040
11060,mbaykara,7,0.00016,3917009,90.85995,4311040
11061,mbrannock,7,0.00016,3917016,90.86012,4311040
11062,mcarbonneaux,7,0.00016,3917023,90.86028,4311040
11063,mdaguete,7,0.00016,3917030,90.86044,4311040
11064,mdanzinger,7,0.00016,3917037,90.86060,4311040
11065,mdonkers,7,0.00016,3917044,90.86077,4311040
11066,merqurio,7,0.00016,3917051,90.86093,4311040
11067,MerveeYilmaz,7,0.00016,3917058,90.86109,4311040
11068,mhkarimi1383,7,0.00016,3917065,90.86125,4311040
11069,mhrabovcin,7,0.00016,3917072,90.86142,4311040
11070,mhubig,7,0.00016,3917079,90.86158,4311040
11071,mhzed,7,0.00016,3917086,90.86174,4311040
11072,micahlmartin,7,0.00016,3917093,90.86190,4311040
11073,michielvangendt,7,0.00016,3917100,90.86207,4311040
11074,miguelvr,7,0.00016,3917107,90.86223,4311040
11075,mingjie-li,7,0.00016,3917114,90.86239,4311040
11076,mingyang91,7,0.00016,3917121,90.86255,4311040
11077,mithuns,7,0.00016,3917128,90.86272,4311040
11078,mivanovvs,7,0.00016,3917135,90.86288,4311040
11079,mkobetic,7,0.00016,3917142,90.86304,4311040
11080,mkozjak,7,0.00016,3917149,90.86320,4311040
11081,mnpenner,7,0.00016,3917156,90.86336,4311040
11082,moadqassem,7,0.00016,3917163,90.86353,4311040
11083,mohamadnikan2013,7,0.00016,3917170,90.86369,4311040
11084,mohamedaminearous,7,0.00016,3917177,90.86385,4311040
11085,mohsen0,7,0.00016,3917184,90.86401,4311040
11086,moritzheiber,7,0.00016,3917191,90.86418,4311040
11087,mosheavni,7,0.00016,3917198,90.86434,4311040
11088,mostafa8026,7,0.00016,3917205,90.86450,4311040
11089,mpluhar,7,0.00016,3917212,90.86466,4311040
11090,mrsegen,7,0.00016,3917219,90.86483,4311040
11091,mrwulf,7,0.00016,3917226,90.86499,4311040
11092,msau42-tmp,7,0.00016,3917233,90.86515,4311040
11093,MukulKolpe,7,0.00016,3917240,90.86531,4311040
11094,mukundjalan,7,0.00016,3917247,90.86548,4311040
11095,murarisumit,7,0.00016,3917254,90.86564,4311040
11096,mynameiswhm,7,0.00016,3917261,90.86580,4311040
11097,myshkin5,7,0.00016,3917268,90.86596,4311040
11098,nakabonne,7,0.00016,3917275,90.86613,4311040
11099,Nanopy,7,0.00016,3917282,90.86629,4311040
11100,navendu-pottekkat,7,0.00016,3917289,90.86645,4311040
11101,Nayana-ibm,7,0.00016,3917296,90.86661,4311040
11102,nbusseneau,7,0.00016,3917303,90.86677,4311040
11103,neomantra,7,0.00016,3917310,90.86694,4311040
11104,nerdalert,7,0.00016,3917317,90.86710,4311040
11105,networkhermit,7,0.00016,3917324,90.86726,4311040
11106,newly12,7,0.00016,3917331,90.86742,4311040
11107,nijave,7,0.00016,3917338,90.86759,4311040
11108,NikeNano,7,0.00016,3917345,90.86775,4311040
11109,nikfot,7,0.00016,3917352,90.86791,4311040
11110,nilesh-akhade,7,0.00016,3917359,90.86807,4311040
11111,ningmingxiao,7,0.00016,3917366,90.86824,4311040
11112,nmakhotkin,7,0.00016,3917373,90.86840,4311040
11113,noelbundick,7,0.00016,3917380,90.86856,4311040
11114,noelmcloughlin,7,0.00016,3917387,90.86872,4311040
11115,nordri,7,0.00016,3917394,90.86889,4311040
11116,noseka1,7,0.00016,3917401,90.86905,4311040
11117,nouseforaname,7,0.00016,3917408,90.86921,4311040
11118,nownabe,7,0.00016,3917415,90.86937,4311040
11119,nuistzyw,7,0.00016,3917422,90.86953,4311040
11120,numerology,7,0.00016,3917429,90.86970,4311040
11121,oblazek,7,0.00016,3917436,90.86986,4311040
11122,okossuth,7,0.00016,3917443,90.87002,4311040
11123,olafnorge,7,0.00016,3917450,90.87018,4311040
11124,omegas27,7,0.00016,3917457,90.87035,4311040
11125,oneilcin,7,0.00016,3917464,90.87051,4311040
11126,osswangxining,7,0.00016,3917471,90.87067,4311040
11127,pastukhov,7,0.00016,3917478,90.87083,4311040
11128,Patstrom,7,0.00016,3917485,90.87100,4311040
11129,paweloczadly,7,0.00016,3917492,90.87116,4311040
11130,pbochynski,7,0.00016,3917499,90.87132,4311040
11131,pdh,7,0.00016,3917506,90.87148,4311040
11132,Pehesi97,7,0.00016,3917513,90.87165,4311040
11133,philwhln,7,0.00016,3917520,90.87181,4311040
11134,phlogistonjohn,7,0.00016,3917527,90.87197,4311040
11135,phuongatemc,7,0.00016,3917534,90.87213,4311040
11136,pmyjavec,7,0.00016,3917541,90.87230,4311040
11137,poweld,7,0.00016,3917548,90.87246,4311040
11138,ppalucki,7,0.00016,3917555,90.87262,4311040
11139,pradeepmurugesan,7,0.00016,3917562,90.87278,4311040
11140,PratikDey,7,0.00016,3917569,90.87294,4311040
11141,PratikforCoding,7,0.00016,3917576,90.87311,4311040
11142,praveenperera,7,0.00016,3917583,90.87327,4311040
11143,prein,7,0.00016,3917590,90.87343,4311040
11144,ProProgrammer,7,0.00016,3917597,90.87359,4311040
11145,proydakov,7,0.00016,3917604,90.87376,4311040
11146,qq12157138,7,0.00016,3917611,90.87392,4311040
11147,rahulanand16nov,7,0.00016,3917618,90.87408,4311040
11148,ralfonso,7,0.00016,3917625,90.87424,4311040
11149,RammusXu,7,0.00016,3917632,90.87441,4311040
11150,Ranler,7,0.00016,3917639,90.87457,4311040
11151,rapatchi,7,0.00016,3917646,90.87473,4311040
11152,rashmichandrashekar,7,0.00016,3917653,90.87489,4311040
11153,rawc0der,7,0.00016,3917660,90.87506,4311040
11154,RdL87,7,0.00016,3917667,90.87522,4311040
11155,Renol7,7,0.00016,3917674,90.87538,4311040
11156,rfay,7,0.00016,3917681,90.87554,4311040
11157,rfvermut,7,0.00016,3917688,90.87571,4311040
11158,rickard-von-essen,7,0.00016,3917695,90.87587,4311040
11159,ricoberger,7,0.00016,3917702,90.87603,4311040
11160,rkevin-arch,7,0.00016,3917709,90.87619,4311040
11161,rkpagadala,7,0.00016,3917716,90.87635,4311040
11162,robax,7,0.00016,3917723,90.87652,4311040
11163,robbiet480,7,0.00016,3917730,90.87668,4311040
11164,RobCannon,7,0.00016,3917737,90.87684,4311040
11165,robin-wayve,7,0.00016,3917744,90.87700,4311040
11166,rohank07,7,0.00016,3917751,90.87717,4311040
11167,Rolinh,7,0.00016,3917758,90.87733,4311040
11168,romanlutz,7,0.00016,3917765,90.87749,4311040
11169,romfreiman,7,0.00016,3917772,90.87765,4311040
11170,Romiko,7,0.00016,3917779,90.87782,4311040
11171,Rowern,7,0.00016,3917786,90.87798,4311040
11172,roy-tonal,7,0.00016,3917793,90.87814,4311040
11173,rsokolkov,7,0.00016,3917800,90.87830,4311040
11174,rubans,7,0.00016,3917807,90.87847,4311040
11175,ryan-a-baker,7,0.00016,3917814,90.87863,4311040
11176,ryanbrainard,7,0.00016,3917821,90.87879,4311040
11177,ryan-ibm,7,0.00016,3917828,90.87895,4311040
11178,ryanwalters,7,0.00016,3917835,90.87912,4311040
11179,sakurai-youhei,7,0.00016,3917842,90.87928,4311040
11180,salahalsaleh,7,0.00016,3917849,90.87944,4311040
11181,samjeyam,7,0.00016,3917856,90.87960,4311040
11182,samschlegel,7,0.00016,3917863,90.87976,4311040
11183,sangwook,7,0.00016,3917870,90.87993,4311040
11184,sanjid133,7,0.00016,3917877,90.88009,4311040
11185,Sansar146,7,0.00016,3917884,90.88025,4311040
11186,sarnickaa,7,0.00016,3917891,90.88041,4311040
11187,savitaashture,7,0.00016,3917898,90.88058,4311040
11188,scbizu,7,0.00016,3917905,90.88074,4311040
11189,schantaraud,7,0.00016,3917912,90.88090,4311040
11190,schittler,7,0.00016,3917919,90.88106,4311040
11191,scopej,7,0.00016,3917926,90.88123,4311040
11192,scottrobertson,7,0.00016,3917933,90.88139,4311040
11193,scprek,7,0.00016,3917940,90.88155,4311040
11194,scrwr,7,0.00016,3917947,90.88171,4311040
11195,sdeoras,7,0.00016,3917954,90.88188,4311040
11196,seanorama,7,0.00016,3917961,90.88204,4311040
11197,sedovalx,7,0.00016,3917968,90.88220,4311040
11198,seemiller,7,0.00016,3917975,90.88236,4311040
11199,seiyapl,7,0.00016,3917982,90.88252,4311040
11200,seizadi,7,0.00016,3917989,90.88269,4311040
11201,sergeyberezansky,7,0.00016,3917996,90.88285,4311040
11202,SeriousM,7,0.00016,3918003,90.88301,4311040
11203,Seth-Karlo,7,0.00016,3918010,90.88317,4311040
11204,sgissi,7,0.00016,3918017,90.88334,4311040
11205,shankgan,7,0.00016,3918024,90.88350,4311040
11206,sharepointoscar,7,0.00016,3918031,90.88366,4311040
11207,shashiranjan84,7,0.00016,3918038,90.88382,4311040
11208,shaunc,7,0.00016,3918045,90.88399,4311040
11209,shaunmansell,7,0.00016,3918052,90.88415,4311040
11210,shaunparker,7,0.00016,3918059,90.88431,4311040
11211,sheetalsingala,7,0.00016,3918066,90.88447,4311040
11212,shihtiy-tw,7,0.00016,3918073,90.88464,4311040
11213,Shimi,7,0.00016,3918080,90.88480,4311040
11214,Shinzu,7,0.00016,3918087,90.88496,4311040
11215,shirdrn,7,0.00016,3918094,90.88512,4311040
11216,shubham-cmyk,7,0.00016,3918101,90.88529,4311040
11217,shuraa,7,0.00016,3918108,90.88545,4311040
11218,Sicaine,7,0.00016,3918115,90.88561,4311040
11219,Sineaggi,7,0.00016,3918122,90.88577,4311040
11220,sivasamyk,7,0.00016,3918129,90.88593,4311040
11221,smurfralf,7,0.00016,3918136,90.88610,4311040
11222,sonnysideup,7,0.00016,3918143,90.88626,4311040
11223,sophaskins,7,0.00016,3918150,90.88642,4311040
11224,sourcesoft,7,0.00016,3918157,90.88658,4311040
11225,spicysomtam,7,0.00016,3918164,90.88675,4311040
11226,sporkmonger,7,0.00016,3918171,90.88691,4311040
11227,ssdowd,7,0.00016,3918178,90.88707,4311040
11228,st33v,7,0.00016,3918185,90.88723,4311040
11229,steelbrain,7,0.00016,3918192,90.88740,4311040
11230,stevenlii,7,0.00016,3918199,90.88756,4311040
11231,subodh-dharma,7,0.00016,3918206,90.88772,4311040
11232,sungjunyoung,7,0.00016,3918213,90.88788,4311040
11233,SVilgelm,7,0.00016,3918220,90.88805,4311040
11234,swizzlr,7,0.00016,3918227,90.88821,4311040
11235,syedriko,7,0.00016,3918234,90.88837,4311040
11236,syswuheng,7,0.00016,3918241,90.88853,4311040
11237,tadashi0713,7,0.00016,3918248,90.88870,4311040
11238,tall-dan,7,0.00016,3918255,90.88886,4311040
11239,TarekAS,7,0.00016,3918262,90.88902,4311040
11240,tedtramonte,7,0.00016,3918269,90.88918,4311040
11241,TeutoNet,7,0.00016,3918276,90.88934,4311040
11242,tglaeser,7,0.00016,3918283,90.88951,4311040
11243,thbkrkr,7,0.00016,3918290,90.88967,4311040
11244,thecubed,7,0.00016,3918297,90.88983,4311040
11245,thedodd,7,0.00016,3918304,90.88999,4311040
11246,themez,7,0.00016,3918311,90.89016,4311040
11247,thequailman,7,0.00016,3918318,90.89032,4311040
11248,thiagodasilva,7,0.00016,3918325,90.89048,4311040
11249,ThomasWo,7,0.00016,3918332,90.89064,4311040
11250,thwarted,7,0.00016,3918339,90.89081,4311040
11251,thylong,7,0.00016,3918346,90.89097,4311040
11252,thz,7,0.00016,3918353,90.89113,4311040
11253,tirumaraiselvan,7,0.00016,3918360,90.89129,4311040
11254,tkrishtop,7,0.00016,3918367,90.89146,4311040
11255,tnolet,7,0.00016,3918374,90.89162,4311040
11256,toabctl,7,0.00016,3918381,90.89178,4311040
11257,Tombar,7,0.00016,3918388,90.89194,4311040
11258,tomjohnburton,7,0.00016,3918395,90.89210,4311040
11259,tomklino,7,0.00016,3918402,90.89227,4311040
11260,tommyjcarpenter,7,0.00016,3918409,90.89243,4311040
11261,tomqwu,7,0.00016,3918416,90.89259,4311040
11262,TothFerenc,7,0.00016,3918423,90.89275,4311040
11263,toxynoid,7,0.00016,3918430,90.89292,4311040
11264,travisby,7,0.00016,3918437,90.89308,4311040
11265,trevex,7,0.00016,3918444,90.89324,4311040
11266,treyhyde,7,0.00016,3918451,90.89340,4311040
11267,trodge,7,0.00016,3918458,90.89357,4311040
11268,ttripp,7,0.00016,3918465,90.89373,4311040
11269,Type1J,7,0.00016,3918472,90.89389,4311040
11270,ukai,7,0.00016,3918479,90.89405,4311040
11271,umi0410,7,0.00016,3918486,90.89422,4311040
11272,uschtwill,7,0.00016,3918493,90.89438,4311040
11273,valdemarpavesi,7,0.00016,3918500,90.89454,4311040
11274,vikramkhatri,7,0.00016,3918507,90.89470,4311040
11275,vincent178,7,0.00016,3918514,90.89487,4311040
11276,virendrasuryavanshi,7,0.00016,3918521,90.89503,4311040
11277,vkryachko,7,0.00016,3918528,90.89519,4311040
11278,vmorris,7,0.00016,3918535,90.89535,4311040
11279,vniche,7,0.00016,3918542,90.89551,4311040
11280,vood,7,0.00016,3918549,90.89568,4311040
11281,vsekhar,7,0.00016,3918556,90.89584,4311040
11282,vtereso,7,0.00016,3918563,90.89600,4311040
11283,w00204372,7,0.00016,3918570,90.89616,4311040
11284,wallyqs,7,0.00016,3918577,90.89633,4311040
11285,wangkeqiang123,7,0.00016,3918584,90.89649,4311040
11286,WangXiangUSTC,7,0.00016,3918591,90.89665,4311040
11287,Wangzihao18,7,0.00016,3918598,90.89681,4311040
11288,wejendorp,7,0.00016,3918605,90.89698,4311040
11289,wenerme,7,0.00016,3918612,90.89714,4311040
11290,whoan,7,0.00016,3918619,90.89730,4311040
11291,wichert,7,0.00016,3918626,90.89746,4311040
11292,willemodendaal,7,0.00016,3918633,90.89763,4311040
11293,winjer,7,0.00016,3918640,90.89779,4311040
11294,wiseelf,7,0.00016,3918647,90.89795,4311040
11295,wlodekb,7,0.00016,3918654,90.89811,4311040
11296,wwwnay,7,0.00016,3918661,90.89828,4311040
11297,xarg,7,0.00016,3918668,90.89844,4311040
11298,XciD,7,0.00016,3918675,90.89860,4311040
11299,xiaolanz,7,0.00016,3918682,90.89876,4311040
11300,xinsnake,7,0.00016,3918689,90.89892,4311040
11301,xishengcai,7,0.00016,3918696,90.89909,4311040
11302,xvello,7,0.00016,3918703,90.89925,4311040
11303,xyhuang,7,0.00016,3918710,90.89941,4311040
11304,yaminisridaran,7,0.00016,3918717,90.89957,4311040
11305,yanrez,7,0.00016,3918724,90.89974,4311040
11306,yeasy,7,0.00016,3918731,90.89990,4311040
11307,yJunS,7,0.00016,3918738,90.90006,4311040
11308,YouHang,7,0.00016,3918745,90.90022,4311040
11309,yspreen,7,0.00016,3918752,90.90039,4311040
11310,yudiandreanp,7,0.00016,3918759,90.90055,4311040
11311,yukirii,7,0.00016,3918766,90.90071,4311040
11312,zackproser,7,0.00016,3918773,90.90087,4311040
11313,ZakariaNaaija,7,0.00016,3918780,90.90104,4311040
11314,zenly,7,0.00016,3918787,90.90120,4311040
11315,zentale,7,0.00016,3918794,90.90136,4311040
11316,zevisert,7,0.00016,3918801,90.90152,4311040
11317,zhangzerui20,7,0.00016,3918808,90.90168,4311040
11318,zherman0,7,0.00016,3918815,90.90185,4311040
11319,zhujik,7,0.00016,3918822,90.90201,4311040
11320,zlangbert,7,0.00016,3918829,90.90217,4311040
11321,zmldh,7,0.00016,3918836,90.90233,4311040
11322,zsais,7,0.00016,3918843,90.90250,4311040
11323,zwhitchcox,7,0.00016,3918850,90.90266,4311040
11324,zxDiscovery,7,0.00016,3918857,90.90282,4311040
11325,0xE282B0,6,0.00014,3918863,90.90296,4311040
11326,1hanymhajna,6,0.00014,3918869,90.90310,4311040
11327,27Bslash6,6,0.00014,3918875,90.90324,4311040
11328,2PacIsAlive,6,0.00014,3918881,90.90338,4311040
11329,2vcps,6,0.00014,3918887,90.90352,4311040
11330,842Mono,6,0.00014,3918893,90.90366,4311040
11331,abedra,6,0.00014,3918899,90.90380,4311040
11332,abhiptl,6,0.00014,3918905,90.90394,4311040
11333,abkaplan07,6,0.00014,3918911,90.90407,4311040
11334,abowloflrf,6,0.00014,3918917,90.90421,4311040
11335,aclisp,6,0.00014,3918923,90.90435,4311040
11336,adamjshook,6,0.00014,3918929,90.90449,4311040
11337,adam-power,6,0.00014,3918935,90.90463,4311040
11338,adecarolis,6,0.00014,3918941,90.90477,4311040
11339,adinhodovic,6,0.00014,3918947,90.90491,4311040
11340,AdolfoJulcamoro,6,0.00014,3918953,90.90505,4311040
11341,AdrianGPrado,6,0.00014,3918959,90.90519,4311040
11342,adrukh,6,0.00014,3918965,90.90533,4311040
11343,afmsavage,6,0.00014,3918971,90.90547,4311040
11344,Agreon,6,0.00014,3918977,90.90561,4311040
11345,Aidamina,6,0.00014,3918983,90.90574,4311040
11346,AjayTripathy,6,0.00014,3918989,90.90588,4311040
11347,Akash4927,6,0.00014,3918995,90.90602,4311040
11348,akshedu,6,0.00014,3919001,90.90616,4311040
11349,akwanmaroso,6,0.00014,3919007,90.90630,4311040
11350,AlanGreene,6,0.00014,3919013,90.90644,4311040
11351,alaudazs,6,0.00014,3919019,90.90658,4311040
11352,albertollamaso,6,0.00014,3919025,90.90672,4311040
11353,aldrinleal,6,0.00014,3919031,90.90686,4311040
11354,alejdg,6,0.00014,3919037,90.90700,4311040
11355,alexandrud,6,0.00014,3919043,90.90714,4311040
11356,alexey-pankratyev,6,0.00014,3919049,90.90728,4311040
11357,AlexisZam,6,0.00014,3919055,90.90741,4311040
11358,AlexMorreale,6,0.00014,3919061,90.90755,4311040
11359,alphara,6,0.00014,3919067,90.90769,4311040
11360,amardomingo,6,0.00014,3919073,90.90783,4311040
11361,AMoghrabi,6,0.00014,3919079,90.90797,4311040
11362,amomsi,6,0.00014,3919085,90.90811,4311040
11363,anasinnyk,6,0.00014,3919091,90.90825,4311040
11364,andraxylia,6,0.00014,3919097,90.90839,4311040
11365,Andre-Freitas,6,0.00014,3919103,90.90853,4311040
11366,andreimc,6,0.00014,3919109,90.90867,4311040
11367,AndreMouche,6,0.00014,3919115,90.90881,4311040
11368,AndrewBoklashko,6,0.00014,3919121,90.90895,4311040
11369,andrew-j-price,6,0.00014,3919127,90.90908,4311040
11370,AndriiOmelianenko,6,0.00014,3919133,90.90922,4311040
11371,andy-v-h,6,0.00014,3919139,90.90936,4311040
11372,ankrause,6,0.00014,3919145,90.90950,4311040
11373,anokun7,6,0.00014,3919151,90.90964,4311040
11374,anshrma,6,0.00014,3919157,90.90978,4311040
11375,ansiwen,6,0.00014,3919163,90.90992,4311040
11376,antonio-te,6,0.00014,3919169,90.91006,4311040
11377,antonosmond,6,0.00014,3919175,90.91020,4311040
11378,anubhabMajumdar,6,0.00014,3919181,90.91034,4311040
11379,aphistic,6,0.00014,3919187,90.91048,4311040
11380,apinnecke,6,0.00014,3919193,90.91062,4311040
11381,apsureda,6,0.00014,3919199,90.91075,4311040
11382,ArdaXi,6,0.00014,3919205,90.91089,4311040
11383,areed,6,0.00014,3919211,90.91103,4311040
11384,arjunagl,6,0.00014,3919217,90.91117,4311040
11385,Arjunkrisha,6,0.00014,3919223,90.91131,4311040
11386,arkadijs,6,0.00014,3919229,90.91145,4311040
11387,arnaldopereira-luizalabs,6,0.00014,3919235,90.91159,4311040
11388,arnikasky,6,0.00014,3919241,90.91173,4311040
11389,arohner,6,0.00014,3919247,90.91187,4311040
11390,Art3mK,6,0.00014,3919253,90.91201,4311040
11391,ArthurSens,6,0.00014,3919259,90.91215,4311040
11392,ArunaLakmal,6,0.00014,3919265,90.91229,4311040
11393,ashahab,6,0.00014,3919271,90.91242,4311040
11394,ashanaakh,6,0.00014,3919277,90.91256,4311040
11395,ashwinhs,6,0.00014,3919283,90.91270,4311040
11396,asim,6,0.00014,3919289,90.91284,4311040
11397,astrikos,6,0.00014,3919295,90.91298,4311040
11398,atomerz,6,0.00014,3919301,90.91312,4311040
11399,Atul9,6,0.00014,3919307,90.91326,4311040
11400,audunstrand,6,0.00014,3919313,90.91340,4311040
11401,avi-08,6,0.00014,3919319,90.91354,4311040
11402,aviau,6,0.00014,3919325,90.91368,4311040
11403,axel7083,6,0.00014,3919331,90.91382,4311040
11404,axozoid,6,0.00014,3919337,90.91396,4311040
11405,AymenFJA,6,0.00014,3919343,90.91409,4311040
11406,Azhovan,6,0.00014,3919349,90.91423,4311040
11407,azuretek,6,0.00014,3919355,90.91437,4311040
11408,azzid,6,0.00014,3919361,90.91451,4311040
11409,badboy,6,0.00014,3919367,90.91465,4311040
11410,ball-hayden,6,0.00014,3919373,90.91479,4311040
11411,bandya2003,6,0.00014,3919379,90.91493,4311040
11412,batrick,6,0.00014,3919385,90.91507,4311040
11413,bbhoss,6,0.00014,3919391,90.91521,4311040
11414,bbkgh,6,0.00014,3919397,90.91535,4311040
11415,bbl,6,0.00014,3919403,90.91549,4311040
11416,bbyrne5,6,0.00014,3919409,90.91563,4311040
11417,bcmills,6,0.00014,3919415,90.91577,4311040
11418,bdehri,6,0.00014,3919421,90.91590,4311040
11419,bechtoldt,6,0.00014,3919427,90.91604,4311040
11420,beeradb,6,0.00014,3919433,90.91618,4311040
11421,belak,6,0.00014,3919439,90.91632,4311040
11422,BenCoughlan15,6,0.00014,3919445,90.91646,4311040
11423,benderillo,6,0.00014,3919451,90.91660,4311040
11424,benishak,6,0.00014,3919457,90.91674,4311040
11425,benjamintanweihao,6,0.00014,3919463,90.91688,4311040
11426,benja-wu,6,0.00014,3919469,90.91702,4311040
11427,beyhan,6,0.00014,3919475,90.91716,4311040
11428,bharatnc,6,0.00014,3919481,90.91730,4311040
11429,bhs,6,0.00014,3919487,90.91744,4311040
11430,billcrook,6,0.00014,3919493,90.91757,4311040
11431,binoculars,6,0.00014,3919499,90.91771,4311040
11432,blaubaer,6,0.00014,3919505,90.91785,4311040
11433,bleggett,6,0.00014,3919511,90.91799,4311040
11434,BlueHatbRit,6,0.00014,3919517,90.91813,4311040
11435,bobdonat,6,0.00014,3919523,90.91827,4311040
11436,bohdantverdyi,6,0.00014,3919529,90.91841,4311040
11437,boingram,6,0.00014,3919535,90.91855,4311040
11438,Boran,6,0.00014,3919541,90.91869,4311040
11439,borisroman,6,0.00014,3919547,90.91883,4311040
11440,borod108,6,0.00014,3919553,90.91897,4311040
11441,bpereto,6,0.00014,3919559,90.91911,4311040
11442,brainstorm,6,0.00014,3919565,90.91924,4311040
11443,breakliu,6,0.00014,3919571,90.91938,4311040
11444,brenix,6,0.00014,3919577,90.91952,4311040
11445,brentpetit-hpe,6,0.00014,3919583,90.91966,4311040
11446,brethubbard,6,0.00014,3919589,90.91980,4311040
11447,brettjenkins,6,0.00014,3919595,90.91994,4311040
11448,brk3,6,0.00014,3919601,90.92008,4311040
11449,brokenpip3,6,0.00014,3919607,90.92022,4311040
11450,brsolomon,6,0.00014,3919613,90.92036,4311040
11451,brunocascio,6,0.00014,3919619,90.92050,4311040
11452,brylex418,6,0.00014,3919625,90.92064,4311040
11453,bwarminski,6,0.00014,3919631,90.92078,4311040
11454,bzurkowski,6,0.00014,3919637,90.92091,4311040
11455,c3mb0,6,0.00014,3919643,90.92105,4311040
11456,CaffeeLake,6,0.00014,3919649,90.92119,4311040
11457,caio1982,6,0.00014,3919655,90.92133,4311040
11458,calexandre,6,0.00014,3919661,90.92147,4311040
11459,caquino,6,0.00014,3919667,90.92161,4311040
11460,carlossscastro,6,0.00014,3919673,90.92175,4311040
11461,CarltonSemple,6,0.00014,3919679,90.92189,4311040
11462,catherinetcai,6,0.00014,3919685,90.92203,4311040
11463,cavokz,6,0.00014,3919691,90.92217,4311040
11464,cbatra,6,0.00014,3919697,90.92231,4311040
11465,cdavernas,6,0.00014,3919703,90.92245,4311040
11466,ceastman-r7,6,0.00014,3919709,90.92258,4311040
11467,cedricroijakkers,6,0.00014,3919715,90.92272,4311040
11468,ceefour,6,0.00014,3919721,90.92286,4311040
11469,cfergeau,6,0.00014,3919727,90.92300,4311040
11470,cfis,6,0.00014,3919733,90.92314,4311040
11471,chamankang,6,0.00014,3919739,90.92328,4311040
11472,chenquanzhao,6,0.00014,3919745,90.92342,4311040
11473,chensheng0,6,0.00014,3919751,90.92356,4311040
11474,chetan-rns,6,0.00014,3919757,90.92370,4311040
11475,chingyi-lin,6,0.00014,3919763,90.92384,4311040
11476,chirag0002,6,0.00014,3919769,90.92398,4311040
11477,Ciantic,6,0.00014,3919775,90.92412,4311040
11478,clasohm,6,0.00014,3919781,90.92425,4311040
11479,cleverguy25,6,0.00014,3919787,90.92439,4311040
11480,cmceniry,6,0.00014,3919793,90.92453,4311040
11481,coboluxx,6,0.00014,3919799,90.92467,4311040
11482,CodeJjang,6,0.00014,3919805,90.92481,4311040
11483,colegleason,6,0.00014,3919811,90.92495,4311040
11484,Connz,6,0.00014,3919817,90.92509,4311040
11485,cooktheryan,6,0.00014,3919823,90.92523,4311040
11486,coreydaley,6,0.00014,3919829,90.92537,4311040
11487,coryflucas,6,0.00014,3919835,90.92551,4311040
11488,coverprice,6,0.00014,3919841,90.92565,4311040
11489,CpuID,6,0.00014,3919847,90.92579,4311040
11490,crisidev,6,0.00014,3919853,90.92593,4311040
11491,crunchtime-ali,6,0.00014,3919859,90.92606,4311040
11492,csviri,6,0.00014,3919865,90.92620,4311040
11493,ctodea,6,0.00014,3919871,90.92634,4311040
11494,cwangVT,6,0.00014,3919877,90.92648,4311040
11495,daggerok,6,0.00014,3919883,90.92662,4311040
11496,daisuke-yoshimoto,6,0.00014,3919889,90.92676,4311040
11497,damienmg,6,0.00014,3919895,90.92690,4311040
11498,DandyDeveloper,6,0.00014,3919901,90.92704,4311040
11499,danielhass,6,0.00014,3919907,90.92718,4311040
11500,daniellavoie,6,0.00014,3919913,90.92732,4311040
11501,danielwhatmuff,6,0.00014,3919919,90.92746,4311040
11502,danmontgomery,6,0.00014,3919925,90.92760,4311040
11503,danquack,6,0.00014,3919931,90.92773,4311040
11504,darkstarmv,6,0.00014,3919937,90.92787,4311040
11505,daveoy,6,0.00014,3919943,90.92801,4311040
11506,davi5e,6,0.00014,3919949,90.92815,4311040
11507,davidcurrie,6,0.00014,3919955,90.92829,4311040
11508,davidsiefert,6,0.00014,3919961,90.92843,4311040
11509,dbainbri-ciena,6,0.00014,3919967,90.92857,4311040
11510,dboreham,6,0.00014,3919973,90.92871,4311040
11511,dcasati,6,0.00014,3919979,90.92885,4311040
11512,dealako,6,0.00014,3919985,90.92899,4311040
11513,DeanPH,6,0.00014,3919991,90.92913,4311040
11514,deejgregor,6,0.00014,3919997,90.92927,4311040
11515,deiwin,6,0.00014,3920003,90.92940,4311040
11516,dennis-bsi,6,0.00014,3920009,90.92954,4311040
11517,denniseffing,6,0.00014,3920015,90.92968,4311040
11518,derekchiang,6,0.00014,3920021,90.92982,4311040
11519,de-sh,6,0.00014,3920027,90.92996,4311040
11520,dfioravanti,6,0.00014,3920033,90.93010,4311040
11521,dhananjaysathe,6,0.00014,3920039,90.93024,4311040
11522,dhiltgen,6,0.00014,3920045,90.93038,4311040
11523,Diaoul,6,0.00014,3920051,90.93052,4311040
11524,DickChesterwood,6,0.00014,3920057,90.93066,4311040
11525,dileepfrog,6,0.00014,3920063,90.93080,4311040
11526,dnephin,6,0.00014,3920069,90.93094,4311040
11527,dobbymoodge,6,0.00014,3920075,90.93107,4311040
11528,dodwyer,6,0.00014,3920081,90.93121,4311040
11529,domcar,6,0.00014,3920087,90.93135,4311040
11530,drastawi,6,0.00014,3920093,90.93149,4311040
11531,dserodio,6,0.00014,3920099,90.93163,4311040
11532,dsexton,6,0.00014,3920105,90.93177,4311040
11533,dsvetl,6,0.00014,3920111,90.93191,4311040
11534,dtimm,6,0.00014,3920117,90.93205,4311040
11535,dtshepherd,6,0.00014,3920123,90.93219,4311040
11536,DullReferenceException,6,0.00014,3920129,90.93233,4311040
11537,dustin-decker,6,0.00014,3920135,90.93247,4311040
11538,duxinxiao,6,0.00014,3920141,90.93261,4311040
11539,eb129,6,0.00014,3920147,90.93274,4311040
11540,ebauman,6,0.00014,3920153,90.93288,4311040
11541,eburghar,6,0.00014,3920159,90.93302,4311040
11542,ecda909,6,0.00014,3920165,90.93316,4311040
11543,ecrousseau,6,0.00014,3920171,90.93330,4311040
11544,EdwinWalela,6,0.00014,3920177,90.93344,4311040
11545,eh-am,6,0.00014,3920183,90.93358,4311040
11546,eitanpo,6,0.00014,3920189,90.93372,4311040
11547,ekhaydarov,6,0.00014,3920195,90.93386,4311040
11548,elee,6,0.00014,3920201,90.93400,4311040
11549,elvinjgalarza,6,0.00014,3920207,90.93414,4311040
11550,EmpireJones,6,0.00014,3920213,90.93428,4311040
11551,endrec,6,0.00014,3920219,90.93441,4311040
11552,endyman,6,0.00014,3920225,90.93455,4311040
11553,ep4sh,6,0.00014,3920231,90.93469,4311040
11554,ephemeral,6,0.00014,3920237,90.93483,4311040
11555,erfangc,6,0.00014,3920243,90.93497,4311040
11556,ericvn,6,0.00014,3920249,90.93511,4311040
11557,etifontaine,6,0.00014,3920255,90.93525,4311040
11558,Eugst,6,0.00014,3920261,90.93539,4311040
11559,evgf,6,0.00014,3920267,90.93553,4311040
11560,f7753,6,0.00014,3920273,90.93567,4311040
11561,fahedouch,6,0.00014,3920279,90.93581,4311040
11562,faizan82,6,0.00014,3920285,90.93595,4311040
11563,fasmat,6,0.00014,3920291,90.93609,4311040
11564,FedeDP,6,0.00014,3920297,90.93622,4311040
11565,feikesteenbergen,6,0.00014,3920303,90.93636,4311040
11566,ferantivero,6,0.00014,3920309,90.93650,4311040
11567,ferdinandhuebner,6,0.00014,3920315,90.93664,4311040
11568,feynmanliang,6,0.00014,3920321,90.93678,4311040
11569,FeynmanZhou,6,0.00014,3920327,90.93692,4311040
11570,fgrehm,6,0.00014,3920333,90.93706,4311040
11571,ficoos,6,0.00014,3920339,90.93720,4311040
11572,fiftoine,6,0.00014,3920345,90.93734,4311040
11573,filipre,6,0.00014,3920351,90.93748,4311040
11574,flimzy,6,0.00014,3920357,90.93762,4311040
11575,FNSdev,6,0.00014,3920363,90.93776,4311040
11576,forumsheth,6,0.00014,3920369,90.93789,4311040
11577,fotinakis,6,0.00014,3920375,90.93803,4311040
11578,FraBle,6,0.00014,3920381,90.93817,4311040
11579,FrostyLeaf,6,0.00014,3920387,90.93831,4311040
11580,fsigalov,6,0.00014,3920393,90.93845,4311040
11581,FuriKuri,6,0.00014,3920399,90.93859,4311040
11582,fwalker,6,0.00014,3920405,90.93873,4311040
11583,g1eny0ung,6,0.00014,3920411,90.93887,4311040
11584,gadelkareem,6,0.00014,3920417,90.93901,4311040
11585,gadiener,6,0.00014,3920423,90.93915,4311040
11586,gallettilance,6,0.00014,3920429,90.93929,4311040
11587,gaoxinge,6,0.00014,3920435,90.93943,4311040
11588,gdasson,6,0.00014,3920441,90.93956,4311040
11589,geekflyer,6,0.00014,3920447,90.93970,4311040
11590,GeetikaBatra,6,0.00014,3920453,90.93984,4311040
11591,geraldmayr,6,0.00014,3920459,90.93998,4311040
11592,gghonor,6,0.00014,3920465,90.94012,4311040
11593,Ghostbaby,6,0.00014,3920471,90.94026,4311040
11594,githubcdr,6,0.00014,3920477,90.94040,4311040
11595,glennpratt,6,0.00014,3920483,90.94054,4311040
11596,goneri,6,0.00014,3920489,90.94068,4311040
11597,goostleek,6,0.00014,3920495,90.94082,4311040
11598,gordonbondon,6,0.00014,3920501,90.94096,4311040
11599,goshlanguage,6,0.00014,3920507,90.94110,4311040
11600,Gouthamve,6,0.00014,3920513,90.94123,4311040
11601,gparvin,6,0.00014,3920519,90.94137,4311040
11602,grdryn,6,0.00014,3920525,90.94151,4311040
11603,greed42,6,0.00014,3920531,90.94165,4311040
11604,GregHanson,6,0.00014,3920537,90.94179,4311040
11605,guan840912,6,0.00014,3920543,90.94193,4311040
11606,guanxingfeng,6,0.00014,3920549,90.94207,4311040
11607,guilhermeoki,6,0.00014,3920555,90.94221,4311040
11608,Haavare,6,0.00014,3920561,90.94235,4311040
11609,haiker2011,6,0.00014,3920567,90.94249,4311040
11610,halradaideh,6,0.00014,3920573,90.94263,4311040
11611,hamedhsn,6,0.00014,3920579,90.94277,4311040
11612,HamzaZo,6,0.00014,3920585,90.94290,4311040
11613,hansbogert,6,0.00014,3920591,90.94304,4311040
11614,hantsy,6,0.00014,3920597,90.94318,4311040
11615,harlesbayu,6,0.00014,3920603,90.94332,4311040
11616,hawkingrei,6,0.00014,3920609,90.94346,4311040
11617,hawksight,6,0.00014,3920615,90.94360,4311040
11618,hayorov,6,0.00014,3920621,90.94374,4311040
11619,HeroCC,6,0.00014,3920627,90.94388,4311040
11620,hidekuro,6,0.00014,3920633,90.94402,4311040
11621,hikimochi,6,0.00014,3920639,90.94416,4311040
11622,hkaj,6,0.00014,3920645,90.94430,4311040
11623,hoangelos,6,0.00014,3920651,90.94444,4311040
11624,Hugoch,6,0.00014,3920657,90.94457,4311040
11625,iabudiab,6,0.00014,3920663,90.94471,4311040
11626,iamsoorya,6,0.00014,3920669,90.94485,4311040
11627,idanshahar,6,0.00014,3920675,90.94499,4311040
11628,idsvandermolen,6,0.00014,3920681,90.94513,4311040
11629,ifraixedes,6,0.00014,3920687,90.94527,4311040
11630,igor47,6,0.00014,3920693,90.94541,4311040
11631,IlyaSemenov,6,0.00014,3920699,90.94555,4311040
11632,imeshm98,6,0.00014,3920705,90.94569,4311040
11633,imjoey,6,0.00014,3920711,90.94583,4311040
11634,isaaguilar,6,0.00014,3920717,90.94597,4311040
11635,its07195,6,0.00014,3920723,90.94611,4311040
11636,ivandov,6,0.00014,3920729,90.94624,4311040
11637,JadCham,6,0.00014,3920735,90.94638,4311040
11638,jaidevmane,6,0.00014,3920741,90.94652,4311040
11639,Jakob-Naucke,6,0.00014,3920747,90.94666,4311040
11640,jamesharr,6,0.00014,3920753,90.94680,4311040
11641,jamesjoshuahill,6,0.00014,3920759,90.94694,4311040
11642,jasonmcintosh,6,0.00014,3920765,90.94708,4311040
11643,Jasstkn,6,0.00014,3920771,90.94722,4311040
11644,jastBytes,6,0.00014,3920777,90.94736,4311040
11645,javsalgar,6,0.00014,3920783,90.94750,4311040
11646,jayakody,6,0.00014,3920789,90.94764,4311040
11647,jbalonso,6,0.00014,3920795,90.94778,4311040
11648,jcdickinson,6,0.00014,3920801,90.94792,4311040
11649,jck-ccl,6,0.00014,3920807,90.94805,4311040
11650,jcmartins,6,0.00014,3920813,90.94819,4311040
11651,jdamata,6,0.00014,3920819,90.94833,4311040
11652,jdkelley,6,0.00014,3920825,90.94847,4311040
11653,jean-edouard,6,0.00014,3920831,90.94861,4311040
11654,jeff-knurek,6,0.00014,3920837,90.94875,4311040
11655,jeffreywstevens,6,0.00014,3920843,90.94889,4311040
11656,jeinwag,6,0.00014,3920849,90.94903,4311040
11657,jessiezcc,6,0.00014,3920855,90.94917,4311040
11658,jfreeland,6,0.00014,3920861,90.94931,4311040
11659,jgoldschrafe,6,0.00014,3920867,90.94945,4311040
11660,jhorowitz,6,0.00014,3920873,90.94959,4311040
11661,jiangliu,6,0.00014,3920879,90.94972,4311040
11662,jiangpengcheng,6,0.00014,3920885,90.94986,4311040
11663,jimil749,6,0.00014,3920891,90.95000,4311040
11664,Jinchul81,6,0.00014,3920897,90.95014,4311040
11665,jinleileiking,6,0.00014,3920903,90.95028,4311040
11666,jipperinbham,6,0.00014,3920909,90.95042,4311040
11667,JiyeYu,6,0.00014,3920915,90.95056,4311040
11668,jlpedrosa,6,0.00014,3920921,90.95070,4311040
11669,jmervine,6,0.00014,3920927,90.95084,4311040
11670,JoelColledge,6,0.00014,3920933,90.95098,4311040
11671,joesonw,6,0.00014,3920939,90.95112,4311040
11672,johanbrandhorst,6,0.00014,3920945,90.95126,4311040
11673,JohanWork,6,0.00014,3920951,90.95139,4311040
11674,John-Lin,6,0.00014,3920957,90.95153,4311040
11675,johnmanjiro13,6,0.00014,3920963,90.95167,4311040
11676,jojohappy,6,0.00014,3920969,90.95181,4311040
11677,jolcese,6,0.00014,3920975,90.95195,4311040
11678,jonasdebeukelaer,6,0.00014,3920981,90.95209,4311040
11679,jonashackt,6,0.00014,3920987,90.95223,4311040
11680,jonathansloman,6,0.00014,3920993,90.95237,4311040
11681,josvazg,6,0.00014,3920999,90.95251,4311040
11682,jotak,6,0.00014,3921005,90.95265,4311040
11683,jpaulodit,6,0.00014,3921011,90.95279,4311040
11684,jpegleg-k8s,6,0.00014,3921017,90.95293,4311040
11685,jpugliesi,6,0.00014,3921023,90.95306,4311040
11686,jralph,6,0.00014,3921029,90.95320,4311040
11687,jremond,6,0.00014,3921035,90.95334,4311040
11688,jsarkar,6,0.00014,3921041,90.95348,4311040
11689,jschlichtholz,6,0.00014,3921047,90.95362,4311040
11690,jshaw86,6,0.00014,3921053,90.95376,4311040
11691,jsievenpiper,6,0.00014,3921059,90.95390,4311040
11692,jskswamy,6,0.00014,3921065,90.95404,4311040
11693,jsuchenia,6,0.00014,3921071,90.95418,4311040
11694,jtbonhomme,6,0.00014,3921077,90.95432,4311040
11695,julienMichaud,6,0.00014,3921083,90.95446,4311040
11696,julienvey,6,0.00014,3921089,90.95460,4311040
11697,justinburke,6,0.00014,3921095,90.95473,4311040
11698,justindowning,6,0.00014,3921101,90.95487,4311040
11699,juzna,6,0.00014,3921107,90.95501,4311040
11700,jyparketc,6,0.00014,3921113,90.95515,4311040
11701,k3a,6,0.00014,3921119,90.95529,4311040
11702,kaboo-dev,6,0.00014,3921125,90.95543,4311040
11703,kaleo211,6,0.00014,3921131,90.95557,4311040
11704,KanShiori,6,0.00014,3921137,90.95571,4311040
11705,kaushiksrinivas,6,0.00014,3921143,90.95585,4311040
11706,kaycebasques,6,0.00014,3921149,90.95599,4311040
11707,kbaegis,6,0.00014,3921155,90.95613,4311040
11708,kei6u,6,0.00014,3921161,90.95627,4311040
11709,Keramblock,6,0.00014,3921167,90.95640,4311040
11710,kevincantu,6,0.00014,3921173,90.95654,4311040
11711,keyan,6,0.00014,3921179,90.95668,4311040
11712,keymone,6,0.00014,3921185,90.95682,4311040
11713,khrm,6,0.00014,3921191,90.95696,4311040
11714,KieranP,6,0.00014,3921197,90.95710,4311040
11715,kKronstainBrown,6,0.00014,3921203,90.95724,4311040
11716,klenje,6,0.00014,3921209,90.95738,4311040
11717,kmcgrath,6,0.00014,3921215,90.95752,4311040
11718,koalalorenzo,6,0.00014,3921221,90.95766,4311040
11719,Komnomnomnom,6,0.00014,3921227,90.95780,4311040
11720,kopal2212,6,0.00014,3921233,90.95794,4311040
11721,Korijn,6,0.00014,3921239,90.95808,4311040
11722,kpjani,6,0.00014,3921245,90.95821,4311040
11723,krish512,6,0.00014,3921251,90.95835,4311040
11724,krishnadurai,6,0.00014,3921257,90.95849,4311040
11725,krishnaindani,6,0.00014,3921263,90.95863,4311040
11726,ksiadz,6,0.00014,3921269,90.95877,4311040
11727,k-wall,6,0.00014,3921275,90.95891,4311040
11728,l2dy,6,0.00014,3921281,90.95905,4311040
11729,Labbs,6,0.00014,3921287,90.95919,4311040
11730,Lain92,6,0.00014,3921293,90.95933,4311040
11731,lavagetto,6,0.00014,3921299,90.95947,4311040
11732,lchi,6,0.00014,3921305,90.95961,4311040
11733,lead4good,6,0.00014,3921311,90.95975,4311040
11734,leslau,6,0.00014,3921317,90.95988,4311040
11735,lfdversluis,6,0.00014,3921323,90.96002,4311040
11736,lgayatri,6,0.00014,3921329,90.96016,4311040
11737,liebowitz,6,0.00014,3921335,90.96030,4311040
11738,liewegas,6,0.00014,3921341,90.96044,4311040
11739,liorfranko,6,0.00014,3921347,90.96058,4311040
11740,lironrisk,6,0.00014,3921353,90.96072,4311040
11741,litong01,6,0.00014,3921359,90.96086,4311040
11742,lizardruss,6,0.00014,3921365,90.96100,4311040
11743,ljmwaugh,6,0.00014,3921371,90.96114,4311040
11744,llegolas,6,0.00014,3921377,90.96128,4311040
11745,loginakhil,6,0.00014,3921383,90.96142,4311040
11746,lostlivio,6,0.00014,3921389,90.96155,4311040
11747,lsoica,6,0.00014,3921395,90.96169,4311040
11748,LucaPrete,6,0.00014,3921401,90.96183,4311040
11749,lucbas,6,0.00014,3921407,90.96197,4311040
11750,luukasmakila,6,0.00014,3921413,90.96211,4311040
11751,lwmqwer,6,0.00014,3921419,90.96225,4311040
11752,lypht,6,0.00014,3921425,90.96239,4311040
11753,m8ryx,6,0.00014,3921431,90.96253,4311040
11754,MaartenW,6,0.00014,3921437,90.96267,4311040
11755,maazkhan,6,0.00014,3921443,90.96281,4311040
11756,maelfosso,6,0.00014,3921449,90.96295,4311040
11757,mahata,6,0.00014,3921455,90.96309,4311040
11758,maiamcc,6,0.00014,3921461,90.96322,4311040
11759,manparvesh,6,0.00014,3921467,90.96336,4311040
11760,marcandrews,6,0.00014,3921473,90.96350,4311040
11761,marcelomansur,6,0.00014,3921479,90.96364,4311040
11762,mark007,6,0.00014,3921485,90.96378,4311040
11763,markxnelson,6,0.00014,3921491,90.96392,4311040
11764,martininnotec,6,0.00014,3921497,90.96406,4311040
11765,martyanov,6,0.00014,3921503,90.96420,4311040
11766,marvinthepa,6,0.00014,3921509,90.96434,4311040
11767,masseybradley,6,0.00014,3921515,90.96448,4311040
11768,matt-sm,6,0.00014,3921521,90.96462,4311040
11769,matyix,6,0.00014,3921527,90.96476,4311040
11770,mavimo,6,0.00014,3921533,90.96489,4311040
11771,max-k,6,0.00014,3921539,90.96503,4311040
11772,mbaeuerle,6,0.00014,3921545,90.96517,4311040
11773,mccv1r0,6,0.00014,3921551,90.96531,4311040
11774,mercantiandrea,6,0.00014,3921557,90.96545,4311040
11775,merlintang,6,0.00014,3921563,90.96559,4311040
11776,meyerkev,6,0.00014,3921569,90.96573,4311040
11777,mgazza,6,0.00014,3921575,90.96587,4311040
11778,mhofstetter,6,0.00014,3921581,90.96601,4311040
11779,mholt,6,0.00014,3921587,90.96615,4311040
11780,michaelkipper,6,0.00014,3921593,90.96629,4311040
11781,michaelneale,6,0.00014,3921599,90.96643,4311040
11782,mikaelh,6,0.00014,3921605,90.96656,4311040
11783,mildred,6,0.00014,3921611,90.96670,4311040
11784,misterwilliam,6,0.00014,3921617,90.96684,4311040
11785,mitom,6,0.00014,3921623,90.96698,4311040
11786,mjschmidt,6,0.00014,3921629,90.96712,4311040
11787,mknyszek,6,0.00014,3921635,90.96726,4311040
11788,mkobit,6,0.00014,3921641,90.96740,4311040
11789,mmacy,6,0.00014,3921647,90.96754,4311040
11790,mmazur,6,0.00014,3921653,90.96768,4311040
11791,mmoore0011,6,0.00014,3921659,90.96782,4311040
11792,mmpei,6,0.00014,3921665,90.96796,4311040
11793,MMquant,6,0.00014,3921671,90.96810,4311040
11794,momon,6,0.00014,3921677,90.96824,4311040
11795,mpetason,6,0.00014,3921683,90.96837,4311040
11796,mpkonmbk,6,0.00014,3921689,90.96851,4311040
11797,mr-joshua,6,0.00014,3921695,90.96865,4311040
11798,mrSingh007,6,0.00014,3921701,90.96879,4311040
11799,msrb,6,0.00014,3921707,90.96893,4311040
11800,msterin,6,0.00014,3921713,90.96907,4311040
11801,mthaddon,6,0.00014,3921719,90.96921,4311040
11802,mthoretton,6,0.00014,3921725,90.96935,4311040
11803,muang0,6,0.00014,3921731,90.96949,4311040
11804,mwconceicao,6,0.00014,3921737,90.96963,4311040
11805,mwhahaha,6,0.00014,3921743,90.96977,4311040
11806,myoung34,6,0.00014,3921749,90.96991,4311040
11807,NanXiao,6,0.00014,3921755,90.97004,4311040
11808,Nashluffy,6,0.00014,3921761,90.97018,4311040
11809,nashtsai,6,0.00014,3921767,90.97032,4311040
11810,NavidZ,6,0.00014,3921773,90.97046,4311040
11811,nc-ruth,6,0.00014,3921779,90.97060,4311040
11812,ndegory,6,0.00014,3921785,90.97074,4311040
11813,neisw,6,0.00014,3921791,90.97088,4311040
11814,nestorsalceda,6,0.00014,3921797,90.97102,4311040
11815,neuromantik33,6,0.00014,3921803,90.97116,4311040
11816,nicdex,6,0.00014,3921809,90.97130,4311040
11817,nicktrav,6,0.00014,3921815,90.97144,4311040
11818,nicolasduminil,6,0.00014,3921821,90.97158,4311040
11819,NicolasRouquette,6,0.00014,3921827,90.97171,4311040
11820,Nils98Ar,6,0.00014,3921833,90.97185,4311040
11821,nitishm,6,0.00014,3921839,90.97199,4311040
11822,Nittarab,6,0.00014,3921845,90.97213,4311040
11823,nl5887,6,0.00014,3921851,90.97227,4311040
11824,Noremac201,6,0.00014,3921857,90.97241,4311040
11825,notxcain,6,0.00014,3921863,90.97255,4311040
11826,odidev,6,0.00014,3921869,90.97269,4311040
11827,ognjen-it,6,0.00014,3921875,90.97283,4311040
11828,ohaiwalt,6,0.00014,3921881,90.97297,4311040
11829,ojongerius,6,0.00014,3921887,90.97311,4311040
11830,okushchenko,6,0.00014,3921893,90.97325,4311040
11831,OlafSzmidt,6,0.00014,3921899,90.97338,4311040
11832,oleg-filiutsich,6,0.00014,3921905,90.97352,4311040
11833,olivierboudet,6,0.00014,3921911,90.97366,4311040
11834,omaskery,6,0.00014,3921917,90.97380,4311040
11835,om-gupta,6,0.00014,3921923,90.97394,4311040
11836,onuralp,6,0.00014,3921929,90.97408,4311040
11837,owennewo,6,0.00014,3921935,90.97422,4311040
11838,ozankabak,6,0.00014,3921941,90.97436,4311040
11839,PacoDu,6,0.00014,3921947,90.97450,4311040
11840,pallavagarwal07,6,0.00014,3921953,90.97464,4311040
11841,pankona,6,0.00014,3921959,90.97478,4311040
11842,paoloantinori,6,0.00014,3921965,90.97492,4311040
11843,papanito,6,0.00014,3921971,90.97505,4311040
11844,parlakisik,6,0.00014,3921977,90.97519,4311040
11845,parth721,6,0.00014,3921983,90.97533,4311040
11846,patricklucas,6,0.00014,3921989,90.97547,4311040
11847,pauldotyu,6,0.00014,3921995,90.97561,4311040
11848,pavelhritonenko,6,0.00014,3922001,90.97575,4311040
11849,pawankkamboj,6,0.00014,3922007,90.97589,4311040
11850,p-bakker,6,0.00014,3922013,90.97603,4311040
11851,pcx,6,0.00014,3922019,90.97617,4311040
11852,PennyScissors,6,0.00014,3922025,90.97631,4311040
11853,petems,6,0.00014,3922031,90.97645,4311040
11854,peteroruba,6,0.00014,3922037,90.97659,4311040
11855,peterzandbergen,6,0.00014,3922043,90.97672,4311040
11856,petetnt,6,0.00014,3922049,90.97686,4311040
11857,philpennock,6,0.00014,3922055,90.97700,4311040
11858,philwelz,6,0.00014,3922061,90.97714,4311040
11859,pierrebeaucamp,6,0.00014,3922067,90.97728,4311040
11860,PierreF,6,0.00014,3922073,90.97742,4311040
11861,piyush94,6,0.00014,3922079,90.97756,4311040
11862,piyushsingariya,6,0.00014,3922085,90.97770,4311040
11863,pjfanning,6,0.00014,3922091,90.97784,4311040
11864,pkchavva,6,0.00014,3922097,90.97798,4311040
11865,plumenator,6,0.00014,3922103,90.97812,4311040
11866,plwhite,6,0.00014,3922109,90.97826,4311040
11867,pmuller,6,0.00014,3922115,90.97840,4311040
11868,podollb,6,0.00014,3922121,90.97853,4311040
11869,pongad,6,0.00014,3922127,90.97867,4311040
11870,ppanyukov,6,0.00014,3922133,90.97881,4311040
11871,prahaladramji,6,0.00014,3922139,90.97895,4311040
11872,pramodrj07,6,0.00014,3922145,90.97909,4311040
11873,pranjaljain0,6,0.00014,3922151,90.97923,4311040
11874,prashant-shahi,6,0.00014,3922157,90.97937,4311040
11875,psykulsk,6,0.00014,3922163,90.97951,4311040
11876,puneith,6,0.00014,3922169,90.97965,4311040
11877,punya,6,0.00014,3922175,90.97979,4311040
11878,pvlltvk,6,0.00014,3922181,90.97993,4311040
11879,qian0817,6,0.00014,3922187,90.98007,4311040
11880,qiqizjl,6,0.00014,3922193,90.98020,4311040
11881,RagniGarg97,6,0.00014,3922199,90.98034,4311040
11882,rajivm,6,0.00014,3922205,90.98048,4311040
11883,rajivml,6,0.00014,3922211,90.98062,4311040
11884,rajusharma,6,0.00014,3922217,90.98076,4311040
11885,rawhideron,6,0.00014,3922223,90.98090,4311040
11886,rchincha,6,0.00014,3922229,90.98104,4311040
11887,reeceaw,6,0.00014,3922235,90.98118,4311040
11888,reitermarkus,6,0.00014,3922241,90.98132,4311040
11889,renannprado,6,0.00014,3922247,90.98146,4311040
11890,RenatoBrittoAraujo,6,0.00014,3922253,90.98160,4311040
11891,repeatedly,6,0.00014,3922259,90.98174,4311040
11892,Rested,6,0.00014,3922265,90.98187,4311040
11893,rettori,6,0.00014,3922271,90.98201,4311040
11894,rgordill,6,0.00014,3922277,90.98215,4311040
11895,rhs,6,0.00014,3922283,90.98229,4311040
11896,ribbybibby,6,0.00014,3922289,90.98243,4311040
11897,ricardopt,6,0.00014,3922295,90.98257,4311040
11898,RichiCoder1,6,0.00014,3922301,90.98271,4311040
11899,rkapoor028,6,0.00014,3922307,90.98285,4311040
11900,rlenglet,6,0.00014,3922313,90.98299,4311040
11901,rmaugusto,6,0.00014,3922319,90.98313,4311040
11902,rndstr,6,0.00014,3922325,90.98327,4311040
11903,robermorales,6,0.00014,3922331,90.98341,4311040
11904,robzienert,6,0.00014,3922337,90.98354,4311040
11905,RogerSik,6,0.00014,3922343,90.98368,4311040
11906,rogue-gamer-ryt,6,0.00014,3922349,90.98382,4311040
11907,rohfle,6,0.00014,3922355,90.98396,4311040
11908,rossedman,6,0.00014,3922361,90.98410,4311040
11909,rparsonsbb,6,0.00014,3922367,90.98424,4311040
11910,ruigulala,6,0.00014,3922373,90.98438,4311040
11911,Rushit,6,0.00014,3922379,90.98452,4311040
11912,ryandcoates,6,0.00014,3922385,90.98466,4311040
11913,ryanelian,6,0.00014,3922391,90.98480,4311040
11914,RyanGrange,6,0.00014,3922397,90.98494,4311040
11915,ryanmt,6,0.00014,3922403,90.98508,4311040
11916,ryanpeach,6,0.00014,3922409,90.98521,4311040
11917,RyanSquared,6,0.00014,3922415,90.98535,4311040
11918,ryedin,6,0.00014,3922421,90.98549,4311040
11919,ryuheechul,6,0.00014,3922427,90.98563,4311040
11920,SachithKasthuriarachchi,6,0.00014,3922433,90.98577,4311040
11921,sakthivetrivel,6,0.00014,3922439,90.98591,4311040
11922,salaboy,6,0.00014,3922445,90.98605,4311040
11923,sammcj,6,0.00014,3922451,90.98619,4311040
11924,sarahhenkens,6,0.00014,3922457,90.98633,4311040
11925,SaswatB,6,0.00014,3922463,90.98647,4311040
11926,Sathishkunisai,6,0.00014,3922469,90.98661,4311040
11927,satrox28,6,0.00014,3922475,90.98675,4311040
11928,sawanoboly,6,0.00014,3922481,90.98688,4311040
11929,s-bauer,6,0.00014,3922487,90.98702,4311040
11930,sborman,6,0.00014,3922493,90.98716,4311040
11931,schmurfy,6,0.00014,3922499,90.98730,4311040
11932,sctlee,6,0.00014,3922505,90.98744,4311040
11933,ScyDev,6,0.00014,3922511,90.98758,4311040
11934,sdemura,6,0.00014,3922517,90.98772,4311040
11935,sebv,6,0.00014,3922523,90.98786,4311040
11936,SeMeKh,6,0.00014,3922529,90.98800,4311040
11937,sengi,6,0.00014,3922535,90.98814,4311040
11938,serain,6,0.00014,3922541,90.98828,4311040
11939,SergeyMuha,6,0.00014,3922547,90.98842,4311040
11940,shahriak,6,0.00014,3922553,90.98855,4311040
11941,shalk,6,0.00014,3922559,90.98869,4311040
11942,shaneramey,6,0.00014,3922565,90.98883,4311040
11943,sharathsivakumar,6,0.00014,3922571,90.98897,4311040
11944,shrids,6,0.00014,3922577,90.98911,4311040
11945,shubham-singh-748,6,0.00014,3922583,90.98925,4311040
11946,sidharthanup,6,0.00014,3922589,90.98939,4311040
11947,sidprak,6,0.00014,3922595,90.98953,4311040
11948,sighingnow,6,0.00014,3922601,90.98967,4311040
11949,simonwahlgren,6,0.00014,3922607,90.98981,4311040
11950,simster7,6,0.00014,3922613,90.98995,4311040
11951,skevy,6,0.00014,3922619,90.99009,4311040
11952,skloss,6,0.00014,3922625,90.99023,4311040
11953,smarkm,6,0.00014,3922631,90.99036,4311040
11954,smashse,6,0.00014,3922637,90.99050,4311040
11955,smithago,6,0.00014,3922643,90.99064,4311040
11956,smuda,6,0.00014,3922649,90.99078,4311040
11957,sobngwi,6,0.00014,3922655,90.99092,4311040
11958,solonish,6,0.00014,3922661,90.99106,4311040
11959,SomaticIT,6,0.00014,3922667,90.99120,4311040
11960,somesh2905,6,0.00014,3922673,90.99134,4311040
11961,sonnyhcl,6,0.00014,3922679,90.99148,4311040
11962,sosheskaz,6,0.00014,3922685,90.99162,4311040
11963,sourcedelica,6,0.00014,3922691,90.99176,4311040
11964,SpamapS,6,0.00014,3922697,90.99190,4311040
11965,sparkoo,6,0.00014,3922703,90.99203,4311040
11966,spielkind,6,0.00014,3922709,90.99217,4311040
11967,spirosoik,6,0.00014,3922715,90.99231,4311040
11968,spoonben,6,0.00014,3922721,90.99245,4311040
11969,spyroot,6,0.00014,3922727,90.99259,4311040
11970,srikumar-b,6,0.00014,3922733,90.99273,4311040
11971,sserantes,6,0.00014,3922739,90.99287,4311040
11972,stanislavb,6,0.00014,3922745,90.99301,4311040
11973,stapelberg,6,0.00014,3922751,90.99315,4311040
11974,steebchen,6,0.00014,3922757,90.99329,4311040
11975,stefansundin,6,0.00014,3922763,90.99343,4311040
11976,strangiato,6,0.00014,3922769,90.99357,4311040
11977,strigona-worksight,6,0.00014,3922775,90.99370,4311040
11978,stromvirvel,6,0.00014,3922781,90.99384,4311040
11979,Sudharma,6,0.00014,3922787,90.99398,4311040
11980,sudo-bmitch,6,0.00014,3922793,90.99412,4311040
11981,SuhasAnand,6,0.00014,3922799,90.99426,4311040
11982,SukantGujar,6,0.00014,3922805,90.99440,4311040
11983,suquant,6,0.00014,3922811,90.99454,4311040
11984,Surbowl,6,0.00014,3922817,90.99468,4311040
11985,suside,6,0.00014,3922823,90.99482,4311040
11986,svenwltr,6,0.00014,3922829,90.99496,4311040
11987,swimablefish,6,0.00014,3922835,90.99510,4311040
11988,Symbianx,6,0.00014,3922841,90.99524,4311040
11989,Syulin7,6,0.00014,3922847,90.99537,4311040
11990,szEvEz,6,0.00014,3922853,90.99551,4311040
11991,TahsinTunan,6,0.00014,3922859,90.99565,4311040
11992,tall49er,6,0.00014,3922865,90.99579,4311040
11993,tanguofu,6,0.00014,3922871,90.99593,4311040
11994,taragurung,6,0.00014,3922877,90.99607,4311040
11995,tareksha,6,0.00014,3922883,90.99621,4311040
11996,taynguyen,6,0.00014,3922889,90.99635,4311040
11997,tbondarchuk,6,0.00014,3922895,90.99649,4311040
11998,teamsmiley,6,0.00014,3922901,90.99663,4311040
11999,teejae,6,0.00014,3922907,90.99677,4311040
12000,TeoGoddet,6,0.00014,3922913,90.99691,4311040
12001,thakkaryash94,6,0.00014,3922919,90.99704,4311040
12002,thawkins,6,0.00014,3922925,90.99718,4311040
12003,thecodeassassin,6,0.00014,3922931,90.99732,4311040
12004,theherk,6,0.00014,3922937,90.99746,4311040
12005,themarcelor,6,0.00014,3922943,90.99760,4311040
12006,thibserot,6,0.00014,3922949,90.99774,4311040
12007,thomasfricke,6,0.00014,3922955,90.99788,4311040
12008,ThuF,6,0.00014,3922961,90.99802,4311040
12009,tiagolobocastro,6,0.00014,3922967,90.99816,4311040
12010,tico24,6,0.00014,3922973,90.99830,4311040
12011,tillhoff,6,0.00014,3922979,90.99844,4311040
12012,timfpark,6,0.00014,3922985,90.99858,4311040
12013,tjskrish,6,0.00014,3922991,90.99871,4311040
12014,tmatias,6,0.00014,3922997,90.99885,4311040
12015,t-miyake,6,0.00014,3923003,90.99899,4311040
12016,tobstarr,6,0.00014,3923009,90.99913,4311040
12017,todaywasawesome,6,0.00014,3923015,90.99927,4311040
12018,tohjustin,6,0.00014,3923021,90.99941,4311040
12019,tomaslm,6,0.00014,3923027,90.99955,4311040
12020,tomgco,6,0.00014,3923033,90.99969,4311040
12021,tomgeorge,6,0.00014,3923039,90.99983,4311040
12022,tomkennedy513,6,0.00014,3923045,90.99997,4311040
12023,tommy-sho,6,0.00014,3923051,91.00011,4311040
12024,toneill818,6,0.00014,3923057,91.00025,4311040
12025,toshi0607,6,0.00014,3923063,91.00039,4311040
12026,tothandras,6,0.00014,3923069,91.00052,4311040
12027,tpo,6,0.00014,3923075,91.00066,4311040
12028,trobert2,6,0.00014,3923081,91.00080,4311040
12029,trshafer,6,0.00014,3923087,91.00094,4311040
12030,tshak,6,0.00014,3923093,91.00108,4311040
12031,ttz21,6,0.00014,3923099,91.00122,4311040
12032,tumido,6,0.00014,3923105,91.00136,4311040
12033,tuxpeople,6,0.00014,3923111,91.00150,4311040
12034,tyuhara,6,0.00014,3923117,91.00164,4311040
12035,upvas,6,0.00014,3923123,91.00178,4311040
12036,usrbinkat,6,0.00014,3923129,91.00192,4311040
12037,utahcon,6,0.00014,3923135,91.00206,4311040
12038,vaamarnath,6,0.00014,3923141,91.00219,4311040
12039,Vaibhavpbits,6,0.00014,3923147,91.00233,4311040
12040,varenaggarwal,6,0.00014,3923153,91.00247,4311040
12041,varunpalekar,6,0.00014,3923159,91.00261,4311040
12042,vauchok,6,0.00014,3923165,91.00275,4311040
12043,veeramarni,6,0.00014,3923171,91.00289,4311040
12044,vegasbrianc,6,0.00014,3923177,91.00303,4311040
12045,velo,6,0.00014,3923183,91.00317,4311040
12046,Venthe,6,0.00014,3923189,91.00331,4311040
12047,victorhaggqvist,6,0.00014,3923195,91.00345,4311040
12048,Vikash082,6,0.00014,3923201,91.00359,4311040
12049,vinayvenkat,6,0.00014,3923207,91.00373,4311040
12050,vladdy,6,0.00014,3923213,91.00386,4311040
12051,vladimirfx,6,0.00014,3923219,91.00400,4311040
12052,vonneudeck,6,0.00014,3923225,91.00414,4311040
12053,voroniys,6,0.00014,3923231,91.00428,4311040
12054,vorozhko,6,0.00014,3923237,91.00442,4311040
12055,waelghaith,6,0.00014,3923243,91.00456,4311040
12056,wakeful,6,0.00014,3923249,91.00470,4311040
12057,warden,6,0.00014,3923255,91.00484,4311040
12058,wayofthepie,6,0.00014,3923261,91.00498,4311040
12059,WeiZhang555,6,0.00014,3923267,91.00512,4311040
12060,wenjun1,6,0.00014,3923273,91.00526,4311040
12061,wenwenwenjun,6,0.00014,3923279,91.00540,4311040
12062,wez470,6,0.00014,3923285,91.00553,4311040
12063,Whisper40,6,0.00014,3923291,91.00567,4311040
12064,whyvez,6,0.00014,3923297,91.00581,4311040
12065,willdeuschle,6,0.00014,3923303,91.00595,4311040
12066,williamhuangh,6,0.00014,3923309,91.00609,4311040
12067,wjin,6,0.00014,3923315,91.00623,4311040
12068,wmcnamee-tunein,6,0.00014,3923321,91.00637,4311040
12069,woqer,6,0.00014,3923327,91.00651,4311040
12070,wpalmeri,6,0.00014,3923333,91.00665,4311040
12071,XanderStrike,6,0.00014,3923339,91.00679,4311040
12072,xiyanxiyan10,6,0.00014,3923345,91.00693,4311040
12073,xueshanf,6,0.00014,3923351,91.00707,4311040
12074,XuJun00192603,6,0.00014,3923357,91.00720,4311040
12075,y0zg,6,0.00014,3923363,91.00734,4311040
12076,yangyuliufeng,6,0.00014,3923369,91.00748,4311040
12077,ybr,6,0.00014,3923375,91.00762,4311040
12078,yeldiRium,6,0.00014,3923381,91.00776,4311040
12079,Ye-Ting,6,0.00014,3923387,91.00790,4311040
12080,yinghan,6,0.00014,3923393,91.00804,4311040
12081,yordis,6,0.00014,3923399,91.00818,4311040
12082,yuchaoran2011,6,0.00014,3923405,91.00832,4311040
12083,yuta-ron,6,0.00014,3923411,91.00846,4311040
12084,yuv00191,6,0.00014,3923417,91.00860,4311040
12085,Yxnt,6,0.00014,3923423,91.00874,4311040
12086,YYashwanth,6,0.00014,3923429,91.00887,4311040
12087,zackijack,6,0.00014,3923435,91.00901,4311040
12088,Zanadar,6,0.00014,3923441,91.00915,4311040
12089,zdq0394,6,0.00014,3923447,91.00929,4311040
12090,zenvdeluca,6,0.00014,3923453,91.00943,4311040
12091,zhhray,6,0.00014,3923459,91.00957,4311040
12092,zizon,6,0.00014,3923465,91.00971,4311040
12093,zuc,6,0.00014,3923471,91.00985,4311040
12094,zz-bmj,6,0.00014,3923477,91.00999,4311040
12095,0gajun,5,0.00012,3923482,91.01010,4311040
12096,616b2f,5,0.00012,3923487,91.01022,4311040
12097,7AC,5,0.00012,3923492,91.01034,4311040
12098,9len,5,0.00012,3923497,91.01045,4311040
12099,A9u,5,0.00012,3923502,91.01057,4311040
12100,aaronjwood,5,0.00012,3923507,91.01068,4311040
12101,abaskakau,5,0.00012,3923512,91.01080,4311040
12102,Abdullah-alfadhel,5,0.00012,3923517,91.01092,4311040
12103,abelal83,5,0.00012,3923522,91.01103,4311040
12104,abhinavkhanna-sf,5,0.00012,3923527,91.01115,4311040
12105,abhioncbr,5,0.00012,3923532,91.01126,4311040
12106,adamelliotfields,5,0.00012,3923537,91.01138,4311040
12107,adarshaJha,5,0.00012,3923542,91.01150,4311040
12108,adecchi-2inno,5,0.00012,3923547,91.01161,4311040
12109,adr-arroyo,5,0.00012,3923552,91.01173,4311040
12110,adriens,5,0.00012,3923557,91.01184,4311040
12111,aeimer,5,0.00012,3923562,91.01196,4311040
12112,aeneasr,5,0.00012,3923567,91.01208,4311040
12113,aerokite,5,0.00012,3923572,91.01219,4311040
12114,agaudreault-jive,5,0.00012,3923577,91.01231,4311040
12115,ageekymonk,5,0.00012,3923582,91.01242,4311040
12116,agrahamlincoln,5,0.00012,3923587,91.01254,4311040
12117,ahmetkizilay,5,0.00012,3923592,91.01266,4311040
12118,aisbaa,5,0.00012,3923597,91.01277,4311040
12119,akrzos,5,0.00012,3923602,91.01289,4311040
12120,akshaisarathy,5,0.00012,3923607,91.01300,4311040
12121,akshayl,5,0.00012,3923612,91.01312,4311040
12122,aku105,5,0.00012,3923617,91.01324,4311040
12123,alainvanhoof,5,0.00012,3923622,91.01335,4311040
12124,alaslums,5,0.00012,3923627,91.01347,4311040
12125,aleofreddi,5,0.00012,3923632,91.01358,4311040
12126,alesanmed,5,0.00012,3923637,91.01370,4311040
12127,alexouzounis,5,0.00012,3923642,91.01382,4311040
12128,alexsandro-xpt,5,0.00012,3923647,91.01393,4311040
12129,AlexsJones,5,0.00012,3923652,91.01405,4311040
12130,Alienuser,5,0.00012,3923657,91.01416,4311040
12131,alifa20,5,0.00012,3923662,91.01428,4311040
12132,AliRezaTaleghani,5,0.00012,3923667,91.01440,4311040
12133,aloismayr,5,0.00012,3923672,91.01451,4311040
12134,aloneguid,5,0.00012,3923677,91.01463,4311040
12135,alpha-san,5,0.00012,3923682,91.01474,4311040
12136,alter,5,0.00012,3923687,91.01486,4311040
12137,altmas5,5,0.00012,3923692,91.01498,4311040
12138,alvgarvilla,5,0.00012,3923697,91.01509,4311040
12139,alx13,5,0.00012,3923702,91.01521,4311040
12140,amalic,5,0.00012,3923707,91.01532,4311040
12141,amandahla,5,0.00012,3923712,91.01544,4311040
12142,amye,5,0.00012,3923717,91.01556,4311040
12143,amykang2020,5,0.00012,3923722,91.01567,4311040
12144,AnberLu,5,0.00012,3923727,91.01579,4311040
12145,andreamelloncelli,5,0.00012,3923732,91.01590,4311040
12146,andrestc,5,0.00012,3923737,91.01602,4311040
12147,andytom,5,0.00012,3923742,91.01614,4311040
12148,aneurinprice,5,0.00012,3923747,91.01625,4311040
12149,anilkusc,5,0.00012,3923752,91.01637,4311040
12150,anjia0532,5,0.00012,3923757,91.01648,4311040
12151,anjmao,5,0.00012,3923762,91.01660,4311040
12152,ankitrgadiya,5,0.00012,3923767,91.01672,4311040
12153,anonymuse,5,0.00012,3923772,91.01683,4311040
12154,anoopwebs,5,0.00012,3923777,91.01695,4311040
12155,anpanigr,5,0.00012,3923782,91.01706,4311040
12156,an-tex,5,0.00012,3923787,91.01718,4311040
12157,antimack,5,0.00012,3923792,91.01730,4311040
12158,AntonioDiTuri,5,0.00012,3923797,91.01741,4311040
12159,antonydevanchi,5,0.00012,3923802,91.01753,4311040
12160,antonyfray,5,0.00012,3923807,91.01764,4311040
12161,anupreet5,5,0.00012,3923812,91.01776,4311040
12162,anurnomeru,5,0.00012,3923817,91.01788,4311040
12163,anvega,5,0.00012,3923822,91.01799,4311040
12164,anvouk,5,0.00012,3923827,91.01811,4311040
12165,anwesh-b,5,0.00012,3923832,91.01822,4311040
12166,appunni-dishq,5,0.00012,3923837,91.01834,4311040
12167,arangamani,5,0.00012,3923842,91.01845,4311040
12168,arapulido,5,0.00012,3923847,91.01857,4311040
12169,arcolife,5,0.00012,3923852,91.01869,4311040
12170,arhea,5,0.00012,3923857,91.01880,4311040
12171,arieljatib,5,0.00012,3923862,91.01892,4311040
12172,arielmoraes,5,0.00012,3923867,91.01903,4311040
12173,ariestiyansyah,5,0.00012,3923872,91.01915,4311040
12174,aristosvo,5,0.00012,3923877,91.01927,4311040
12175,ArmandGrillet,5,0.00012,3923882,91.01938,4311040
12176,armando-migliaccio,5,0.00012,3923887,91.01950,4311040
12177,arnisoph,5,0.00012,3923892,91.01961,4311040
12178,arugaki,5,0.00012,3923897,91.01973,4311040
12179,ashleydavis,5,0.00012,3923902,91.01985,4311040
12180,aslakknutsen,5,0.00012,3923907,91.01996,4311040
12181,asmith60,5,0.00012,3923912,91.02008,4311040
12182,asoorm,5,0.00012,3923917,91.02019,4311040
12183,asosso,5,0.00012,3923922,91.02031,4311040
12184,atheiman,5,0.00012,3923927,91.02043,4311040
12185,athornton,5,0.00012,3923932,91.02054,4311040
12186,atinsood,5,0.00012,3923937,91.02066,4311040
12187,at-ishikawa,5,0.00012,3923942,91.02077,4311040
12188,aungzanbaw,5,0.00012,3923947,91.02089,4311040
12189,aureq,5,0.00012,3923952,91.02101,4311040
12190,austinlparker,5,0.00012,3923957,91.02112,4311040
12191,avinashkumar1289,5,0.00012,3923962,91.02124,4311040
12192,AvvariSaiBharadwaj,5,0.00012,3923967,91.02135,4311040
12193,AXington,5,0.00012,3923972,91.02147,4311040
12194,azarzar15,5,0.00012,3923977,91.02159,4311040
12195,azemoning,5,0.00012,3923982,91.02170,4311040
12196,bappr,5,0.00012,3923987,91.02182,4311040
12197,barryib,5,0.00012,3923992,91.02193,4311040
12198,basvdlei,5,0.00012,3923997,91.02205,4311040
12199,bbriggs,5,0.00012,3924002,91.02217,4311040
12200,bchelli,5,0.00012,3924007,91.02228,4311040
12201,bdashrad,5,0.00012,3924012,91.02240,4311040
12202,bdurette,5,0.00012,3924017,91.02251,4311040
12203,bearnard,5,0.00012,3924022,91.02263,4311040
12204,beef9999,5,0.00012,3924027,91.02275,4311040
12205,beli-sk,5,0.00012,3924032,91.02286,4311040
12206,bencooper222,5,0.00012,3924037,91.02298,4311040
12207,benhosmer,5,0.00012,3924042,91.02309,4311040
12208,ben-st,5,0.00012,3924047,91.02321,4311040
12209,bentatham,5,0.00012,3924052,91.02333,4311040
12210,berenss,5,0.00012,3924057,91.02344,4311040
12211,bettyjunod,5,0.00012,3924062,91.02356,4311040
12212,BIAOXYZ,5,0.00012,3924067,91.02367,4311040
12213,bithavoc,5,0.00012,3924072,91.02379,4311040
12214,bjartek,5,0.00012,3924077,91.02391,4311040
12215,bklein1,5,0.00012,3924082,91.02402,4311040
12216,BlackBsd,5,0.00012,3924087,91.02414,4311040
12217,Blackclaws,5,0.00012,3924092,91.02425,4311040
12218,blak3mill3r,5,0.00012,3924097,91.02437,4311040
12219,blandger,5,0.00012,3924102,91.02449,4311040
12220,blodan,5,0.00012,3924107,91.02460,4311040
12221,bluestealth,5,0.00012,3924112,91.02472,4311040
12222,bolu,5,0.00012,3924117,91.02483,4311040
12223,boxboatmatt,5,0.00012,3924122,91.02495,4311040
12224,bplotnick,5,0.00012,3924127,91.02507,4311040
12225,brandon-bethke-neudesic,5,0.00012,3924132,91.02518,4311040
12226,BrandonSharp,5,0.00012,3924137,91.02530,4311040
12227,brandshaide,5,0.00012,3924142,91.02541,4311040
12228,brbernardo,5,0.00012,3924147,91.02553,4311040
12229,Brijesh-09,5,0.00012,3924152,91.02565,4311040
12230,BronzeDeer,5,0.00012,3924157,91.02576,4311040
12231,brunowego,5,0.00012,3924162,91.02588,4311040
12232,bshaffer,5,0.00012,3924167,91.02599,4311040
12233,buker,5,0.00012,3924172,91.02611,4311040
12234,ByteAlex,5,0.00012,3924177,91.02623,4311040
12235,c0d1ngm0nk3y,5,0.00012,3924182,91.02634,4311040
12236,c9s,5,0.00012,3924187,91.02646,4311040
12237,camba1,5,0.00012,3924192,91.02657,4311040
12238,caproven,5,0.00012,3924197,91.02669,4311040
12239,carvido1,5,0.00012,3924202,91.02681,4311040
12240,catherineluse,5,0.00012,3924207,91.02692,4311040
12241,cdlliuy,5,0.00012,3924212,91.02704,4311040
12242,cedi,5,0.00012,3924217,91.02715,4311040
12243,cfrantsen,5,0.00012,3924222,91.02727,4311040
12244,cgetzen,5,0.00012,3924227,91.02739,4311040
12245,charithe,5,0.00012,3924232,91.02750,4311040
12246,charlesld,5,0.00012,3924237,91.02762,4311040
12247,chezbut,5,0.00012,3924242,91.02773,4311040
12248,chgeuer,5,0.00012,3924247,91.02785,4311040
12249,chilcano,5,0.00012,3924252,91.02797,4311040
12250,chokhareganesh,5,0.00012,3924257,91.02808,4311040
12251,chrisamert,5,0.00012,3924262,91.02820,4311040
12252,chrismcbride,5,0.00012,3924267,91.02831,4311040
12253,ChrisMcKee,5,0.00012,3924272,91.02843,4311040
12254,christiancadieux,5,0.00012,3924277,91.02855,4311040
12255,Christoph-Raab,5,0.00012,3924282,91.02866,4311040
12256,ChunyiLyu,5,0.00012,3924287,91.02878,4311040
12257,cig0,5,0.00012,3924292,91.02889,4311040
12258,cinder-fish,5,0.00012,3924297,91.02901,4311040
12259,clebs,5,0.00012,3924302,91.02913,4311040
12260,clsung,5,0.00012,3924307,91.02924,4311040
12261,cnfatal,5,0.00012,3924312,91.02936,4311040
12262,codesome,5,0.00012,3924317,91.02947,4311040
12263,codykaup,5,0.00012,3924322,91.02959,4311040
12264,colthreepv,5,0.00012,3924327,91.02971,4311040
12265,Comradin,5,0.00012,3924332,91.02982,4311040
12266,Conky5,5,0.00012,3924337,91.02994,4311040
12267,connorworkman,5,0.00012,3924342,91.03005,4311040
12268,conradj3,5,0.00012,3924347,91.03017,4311040
12269,coopr,5,0.00012,3924352,91.03029,4311040
12270,cosminilie,5,0.00012,3924357,91.03040,4311040
12271,cpboyd,5,0.00012,3924362,91.03052,4311040
12272,craigmonson,5,0.00012,3924367,91.03063,4311040
12273,cricketliu,5,0.00012,3924372,91.03075,4311040
12274,crobby,5,0.00012,3924377,91.03086,4311040
12275,ctaggart,5,0.00012,3924382,91.03098,4311040
12276,cynthia-sg,5,0.00012,3924387,91.03110,4311040
12277,cy-zheng,5,0.00012,3924392,91.03121,4311040
12278,Daemeron,5,0.00012,3924397,91.03133,4311040
12279,dagrayvid,5,0.00012,3924402,91.03144,4311040
12280,dajudge,5,0.00012,3924407,91.03156,4311040
12281,damianoneill,5,0.00012,3924412,91.03168,4311040
12282,danfromtitan,5,0.00012,3924417,91.03179,4311040
12283,daniel00oo,5,0.00012,3924422,91.03191,4311040
12284,danielabbatt,5,0.00012,3924427,91.03202,4311040
12285,Daniel-B-Smith,5,0.00012,3924432,91.03214,4311040
12286,DanielTimLee,5,0.00012,3924437,91.03226,4311040
12287,danielvmw,5,0.00012,3924442,91.03237,4311040
12288,dashahe,5,0.00012,3924447,91.03249,4311040
12289,dav1x,5,0.00012,3924452,91.03260,4311040
12290,DaveKriegerEmerald,5,0.00012,3924457,91.03272,4311040
12291,dave-tucker,5,0.00012,3924462,91.03284,4311040
12292,davidqhr,5,0.00012,3924467,91.03295,4311040
12293,DavidWittman,5,0.00012,3924472,91.03307,4311040
12294,DavidZisky,5,0.00012,3924477,91.03318,4311040
12295,dbaba,5,0.00012,3924482,91.03330,4311040
12296,dclaar,5,0.00012,3924487,91.03342,4311040
12297,ddurham2,5,0.00012,3924492,91.03353,4311040
12298,deepy,5,0.00012,3924497,91.03365,4311040
12299,demikl,5,0.00012,3924502,91.03376,4311040
12300,demobox,5,0.00012,3924507,91.03388,4311040
12301,DenisKolodin,5,0.00012,3924512,91.03400,4311040
12302,DenisPalnitsky,5,0.00012,3924517,91.03411,4311040
12303,denniszielke,5,0.00012,3924522,91.03423,4311040
12304,develar,5,0.00012,3924527,91.03434,4311040
12305,devimc,5,0.00012,3924532,91.03446,4311040
12306,dgsardina,5,0.00012,3924537,91.03458,4311040
12307,dhandma,5,0.00012,3924542,91.03469,4311040
12308,dhermes,5,0.00012,3924547,91.03481,4311040
12309,dibosh,5,0.00012,3924552,91.03492,4311040
12310,didof,5,0.00012,3924557,91.03504,4311040
12311,dimakyriakov,5,0.00012,3924562,91.03516,4311040
12312,dl00,5,0.00012,3924567,91.03527,4311040
12313,dncarley,5,0.00012,3924572,91.03539,4311040
12314,Dohbedoh,5,0.00012,3924577,91.03550,4311040
12315,donmstewart,5,0.00012,3924582,91.03562,4311040
12316,dotLou,5,0.00012,3924587,91.03574,4311040
12317,doublerainbo,5,0.00012,3924592,91.03585,4311040
12318,dploeger,5,0.00012,3924597,91.03597,4311040
12319,dpurrington,5,0.00012,3924602,91.03608,4311040
12320,Drake8710,5,0.00012,3924607,91.03620,4311040
12321,drebes,5,0.00012,3924612,91.03632,4311040
12322,drewboswell,5,0.00012,3924617,91.03643,4311040
12323,dsoprea,5,0.00012,3924622,91.03655,4311040
12324,durp,5,0.00012,3924627,91.03666,4311040
12325,dvrkps,5,0.00012,3924632,91.03678,4311040
12326,dwdraju,5,0.00012,3924637,91.03690,4311040
12327,dzilbermanvmw,5,0.00012,3924642,91.03701,4311040
12328,eakyildirim,5,0.00012,3924647,91.03713,4311040
12329,ebarped,5,0.00012,3924652,91.03724,4311040
12330,ekoome,5,0.00012,3924657,91.03736,4311040
12331,eldada,5,0.00012,3924662,91.03748,4311040
12332,Elgarni,5,0.00012,3924667,91.03759,4311040
12333,elucidsoft,5,0.00012,3924672,91.03771,4311040
12334,EmandM,5,0.00012,3924677,91.03782,4311040
12335,emas80,5,0.00012,3924682,91.03794,4311040
12336,emersonford,5,0.00012,3924687,91.03806,4311040
12337,emiliodangelo,5,0.00012,3924692,91.03817,4311040
12338,engmsaleh,5,0.00012,3924697,91.03829,4311040
12339,enraiha0307,5,0.00012,3924702,91.03840,4311040
12340,EnriqueL8,5,0.00012,3924707,91.03852,4311040
12341,epa095,5,0.00012,3924712,91.03864,4311040
12342,erickhun,5,0.00012,3924717,91.03875,4311040
12343,etherandrius,5,0.00012,3924722,91.03887,4311040
12344,evandigby,5,0.00012,3924727,91.03898,4311040
12345,evenh,5,0.00012,3924732,91.03910,4311040
12346,exdx,5,0.00012,3924737,91.03922,4311040
12347,eyablokov,5,0.00012,3924742,91.03933,4311040
12348,fabriziofortino,5,0.00012,3924747,91.03945,4311040
12349,fengxx,5,0.00012,3924752,91.03956,4311040
12350,ffoysal,5,0.00012,3924757,91.03968,4311040
12351,fjudith,5,0.00012,3924762,91.03980,4311040
12352,flavio-fernandes,5,0.00012,3924767,91.03991,4311040
12353,FlorianJDF,5,0.00012,3924772,91.04003,4311040
12354,francois-travais,5,0.00012,3924777,91.04014,4311040
12355,frandbf,5,0.00012,3924782,91.04026,4311040
12356,freeseacher,5,0.00012,3924787,91.04038,4311040
12357,frickenate,5,0.00012,3924792,91.04049,4311040
12358,fsbaraglia,5,0.00012,3924797,91.04061,4311040
12359,fuhbar,5,0.00012,3924802,91.04072,4311040
12360,fxdgear,5,0.00012,3924807,91.04084,4311040
12361,FxKu,5,0.00012,3924812,91.04096,4311040
12362,Gab-Menezes,5,0.00012,3924817,91.04107,4311040
12363,gabrielhartmann,5,0.00012,3924822,91.04119,4311040
12364,gangseok514,5,0.00012,3924827,91.04130,4311040
12365,garlick,5,0.00012,3924832,91.04142,4311040
12366,gaui,5,0.00012,3924837,91.04154,4311040
12367,gaurav19063,5,0.00012,3924842,91.04165,4311040
12368,gavinmy15,5,0.00012,3924847,91.04177,4311040
12369,gbolo,5,0.00012,3924852,91.04188,4311040
12370,gboor,5,0.00012,3924857,91.04200,4311040
12371,geofflancaster,5,0.00012,3924862,91.04212,4311040
12372,geraldinewhitt,5,0.00012,3924867,91.04223,4311040
12373,gerhard,5,0.00012,3924872,91.04235,4311040
12374,germansosa,5,0.00012,3924877,91.04246,4311040
12375,ghugo,5,0.00012,3924882,91.04258,4311040
12376,gimlet2,5,0.00012,3924887,91.04270,4311040
12377,GJKrupa,5,0.00012,3924892,91.04281,4311040
12378,gkopylov,5,0.00012,3924897,91.04293,4311040
12379,glaubitz,5,0.00012,3924902,91.04304,4311040
12380,g-linville,5,0.00012,3924907,91.04316,4311040
12381,globin,5,0.00012,3924912,91.04327,4311040
12382,g-luo,5,0.00012,3924917,91.04339,4311040
12383,gnosek,5,0.00012,3924922,91.04351,4311040
12384,GoelDeepak,5,0.00012,3924927,91.04362,4311040
12385,golvteppe,5,0.00012,3924932,91.04374,4311040
12386,goodwillcoding,5,0.00012,3924937,91.04385,4311040
12387,Gottox,5,0.00012,3924942,91.04397,4311040
12388,gprashanthkumar,5,0.00012,3924947,91.04409,4311040
12389,GrahamDumpleton,5,0.00012,3924952,91.04420,4311040
12390,gregsheremeta,5,0.00012,3924957,91.04432,4311040
12391,grzesiek,5,0.00012,3924962,91.04443,4311040
12392,gssjl2008,5,0.00012,3924967,91.04455,4311040
12393,g-traveller,5,0.00012,3924972,91.04467,4311040
12394,GuillaumeOuint,5,0.00012,3924977,91.04478,4311040
12395,guizmaii,5,0.00012,3924982,91.04490,4311040
12396,gunine,5,0.00012,3924987,91.04501,4311040
12397,gursimarsm,5,0.00012,3924992,91.04513,4311040
12398,guusvw,5,0.00012,3924997,91.04525,4311040
12399,gwaines,5,0.00012,3925002,91.04536,4311040
12400,haiyuewa,5,0.00012,3925007,91.04548,4311040
12401,hajdukda,5,0.00012,3925012,91.04559,4311040
12402,halcyondude,5,0.00012,3925017,91.04571,4311040
12403,harshavmb,5,0.00012,3925022,91.04583,4311040
12404,hatowang,5,0.00012,3925027,91.04594,4311040
12405,haysclark,5,0.00012,3925032,91.04606,4311040
12406,helenabutowatcisco,5,0.00012,3925037,91.04617,4311040
12407,hellolijj,5,0.00012,3925042,91.04629,4311040
12408,hemendrateli,5,0.00012,3925047,91.04641,4311040
12409,hendrikmaus,5,0.00012,3925052,91.04652,4311040
12410,henrysachs,5,0.00012,3925057,91.04664,4311040
12411,HighwayofLife,5,0.00012,3925062,91.04675,4311040
12412,hlascelles,5,0.00012,3925067,91.04687,4311040
12413,HL-EverGreen,5,0.00012,3925072,91.04699,4311040
12414,hochuenw-dd,5,0.00012,3925077,91.04710,4311040
12415,hoerup,5,0.00012,3925082,91.04722,4311040
12416,holgpar,5,0.00012,3925087,91.04733,4311040
12417,holynakamoto,5,0.00012,3925092,91.04745,4311040
12418,hongbin,5,0.00012,3925097,91.04757,4311040
12419,HowJMay,5,0.00012,3925102,91.04768,4311040
12420,hprotzek,5,0.00012,3925107,91.04780,4311040
12421,hugocf,5,0.00012,3925112,91.04791,4311040
12422,iainfoulds,5,0.00012,3925117,91.04803,4311040
12423,iakshay,5,0.00012,3925122,91.04815,4311040
12424,IbraheemAlSaady,5,0.00012,3925127,91.04826,4311040
12425,iceycake,5,0.00012,3925132,91.04838,4311040
12426,ICGog,5,0.00012,3925137,91.04849,4311040
12427,ideapark,5,0.00012,3925142,91.04861,4311040
12428,igsilya,5,0.00012,3925147,91.04873,4311040
12429,ihoegen-isp,5,0.00012,3925152,91.04884,4311040
12430,iksaif,5,0.00012,3925157,91.04896,4311040
12431,iliul,5,0.00012,3925162,91.04907,4311040
12432,indradhanush,5,0.00012,3925167,91.04919,4311040
12433,indrekj,5,0.00012,3925172,91.04931,4311040
12434,iNoahNothing,5,0.00012,3925177,91.04942,4311040
12435,ipleten,5,0.00012,3925182,91.04954,4311040
12436,isra17,5,0.00012,3925187,91.04965,4311040
12437,isugimpy,5,0.00012,3925192,91.04977,4311040
12438,itamarh,5,0.00012,3925197,91.04989,4311040
12439,ivanovaleksandar,5,0.00012,3925202,91.05000,4311040
12440,ivansenic,5,0.00012,3925207,91.05012,4311040
12441,jack0,5,0.00012,3925212,91.05023,4311040
12442,JacobValdemar,5,0.00012,3925217,91.05035,4311040
12443,jacobwgillespie,5,0.00012,3925222,91.05047,4311040
12444,jahands,5,0.00012,3925227,91.05058,4311040
12445,jahentao,5,0.00012,3925232,91.05070,4311040
12446,jalessio,5,0.00012,3925237,91.05081,4311040
12447,Jameshzc,5,0.00012,3925242,91.05093,4311040
12448,JamesMurkin,5,0.00012,3925247,91.05105,4311040
12449,jamesorlakin,5,0.00012,3925252,91.05116,4311040
12450,jamesthegiantpeach,5,0.00012,3925257,91.05128,4311040
12451,jamiemonserrate,5,0.00012,3925262,91.05139,4311040
12452,jasdel,5,0.00012,3925267,91.05151,4311040
12453,jaygridley,5,0.00012,3925272,91.05163,4311040
12454,jazzdan,5,0.00012,3925277,91.05174,4311040
12455,jbcrail,5,0.00012,3925282,91.05186,4311040
12456,jBouyoud,5,0.00012,3925287,91.05197,4311040
12457,jcantosz,5,0.00012,3925292,91.05209,4311040
12458,jcfj,5,0.00012,3925297,91.05221,4311040
12459,jdgri,5,0.00012,3925302,91.05232,4311040
12460,jedsmith,5,0.00012,3925307,91.05244,4311040
12461,jeffmccune,5,0.00012,3925312,91.05255,4311040
12462,jeffreystoke,5,0.00012,3925317,91.05267,4311040
12463,jerairrest,5,0.00012,3925322,91.05279,4311040
12464,jeromefroe,5,0.00012,3925327,91.05290,4311040
12465,Jerry-HQG,5,0.00012,3925332,91.05302,4311040
12466,jessie-txt,5,0.00012,3925337,91.05313,4311040
12467,JesudassJosephraj,5,0.00012,3925342,91.05325,4311040
12468,jetmuffin,5,0.00012,3925347,91.05337,4311040
12469,jgiannuzzi,5,0.00012,3925352,91.05348,4311040
12470,jhelbling,5,0.00012,3925357,91.05360,4311040
12471,jihdeh,5,0.00012,3925362,91.05371,4311040
12472,jimlindeman,5,0.00012,3925367,91.05383,4311040
12473,jinglina,5,0.00012,3925372,91.05395,4311040
12474,jinxingwang,5,0.00012,3925377,91.05406,4311040
12475,jiraguha,5,0.00012,3925382,91.05418,4311040
12476,jishminor,5,0.00012,3925387,91.05429,4311040
12477,Jitsusama,5,0.00012,3925392,91.05441,4311040
12478,jiuker,5,0.00012,3925397,91.05453,4311040
12479,jjfmarket,5,0.00012,3925402,91.05464,4311040
12480,jlhawn,5,0.00012,3925407,91.05476,4311040
12481,jlyheden,5,0.00012,3925412,91.05487,4311040
12482,jml,5,0.00012,3925417,91.05499,4311040
12483,jmo808,5,0.00012,3925422,91.05511,4311040
12484,joberget,5,0.00012,3925427,91.05522,4311040
12485,joeburke30,5,0.00012,3925432,91.05534,4311040
12486,joemcmahon,5,0.00012,3925437,91.05545,4311040
12487,JoeSainsburys,5,0.00012,3925442,91.05557,4311040
12488,johanoskarsson,5,0.00012,3925447,91.05568,4311040
12489,johnaoss,5,0.00012,3925452,91.05580,4311040
12490,johnhamelink,5,0.00012,3925457,91.05592,4311040
12491,johnnyshields,5,0.00012,3925462,91.05603,4311040
12492,JohnPaton,5,0.00012,3925467,91.05615,4311040
12493,johurul000,5,0.00012,3925472,91.05626,4311040
12494,jolson490,5,0.00012,3925477,91.05638,4311040
12495,jonathanvila,5,0.00012,3925482,91.05650,4311040
12496,jonathonbattista,5,0.00012,3925487,91.05661,4311040
12497,jondot,5,0.00012,3925492,91.05673,4311040
12498,jonk,5,0.00012,3925497,91.05684,4311040
12499,jorahn,5,0.00012,3925502,91.05696,4311040
12500,JorgenG,5,0.00012,3925507,91.05708,4311040
12501,JoshRosso,5,0.00012,3925512,91.05719,4311040
12502,joshughes,5,0.00012,3925517,91.05731,4311040
12503,JoshVee,5,0.00012,3925522,91.05742,4311040
12504,joysarkarhub,5,0.00012,3925527,91.05754,4311040
12505,jslusher,5,0.00012,3925532,91.05766,4311040
12506,jst-cyr,5,0.00012,3925537,91.05777,4311040
12507,jtnord,5,0.00012,3925542,91.05789,4311040
12508,juergenhoetzel,5,0.00012,3925547,91.05800,4311040
12509,julian-labuschagne,5,0.00012,3925552,91.05812,4311040
12510,julienstroheker,5,0.00012,3925557,91.05824,4311040
12511,juusujanar,5,0.00012,3925562,91.05835,4311040
12512,Ka0o0,5,0.00012,3925567,91.05847,4311040
12513,Kaitou786,5,0.00012,3925572,91.05858,4311040
12514,kaizamm,5,0.00012,3925577,91.05870,4311040
12515,kamit78,5,0.00012,3925582,91.05882,4311040
12516,kapekost,5,0.00012,3925587,91.05893,4311040
12517,karinagrullon,5,0.00012,3925592,91.05905,4311040
12518,KastenMike,5,0.00012,3925597,91.05916,4311040
12519,kenm47,5,0.00012,3925602,91.05928,4311040
12520,kestrels,5,0.00012,3925607,91.05940,4311040
12521,kevinscholz,5,0.00012,3925612,91.05951,4311040
12522,khaliddermoumi,5,0.00012,3925617,91.05963,4311040
12523,khalpin11,5,0.00012,3925622,91.05974,4311040
12524,king-11,5,0.00012,3925627,91.05986,4311040
12525,kirgene,5,0.00012,3925632,91.05998,4311040
12526,klinghang,5,0.00012,3925637,91.06009,4311040
12527,klucsik,5,0.00012,3925642,91.06021,4311040
12528,kmat9933,5,0.00012,3925647,91.06032,4311040
12529,kri5,5,0.00012,3925652,91.06044,4311040
12530,kristiandrucker,5,0.00012,3925657,91.06056,4311040
12531,krrrr38,5,0.00012,3925662,91.06067,4311040
12532,kschoche,5,0.00012,3925667,91.06079,4311040
12533,kunalkushwaha,5,0.00012,3925672,91.06090,4311040
12534,kwsorensen,5,0.00012,3925677,91.06102,4311040
12535,kylebevans,5,0.00012,3925682,91.06114,4311040
12536,l15k4,5,0.00012,3925687,91.06125,4311040
12537,laghoule,5,0.00012,3925692,91.06137,4311040
12538,lahabana,5,0.00012,3925697,91.06148,4311040
12539,larrytin,5,0.00012,3925702,91.06160,4311040
12540,lavoiedn,5,0.00012,3925707,91.06172,4311040
12541,lcharkiewicz,5,0.00012,3925712,91.06183,4311040
12542,ldpliu,5,0.00012,3925717,91.06195,4311040
12543,lechen26,5,0.00012,3925722,91.06206,4311040
12544,Leen15,5,0.00012,3925727,91.06218,4311040
12545,leewoobin789,5,0.00012,3925732,91.06230,4311040
12546,leoblanc,5,0.00012,3925737,91.06241,4311040
12547,leogr,5,0.00012,3925742,91.06253,4311040
12548,leokhoa,5,0.00012,3925747,91.06264,4311040
12549,leoluz,5,0.00012,3925752,91.06276,4311040
12550,leongross,5,0.00012,3925757,91.06288,4311040
12551,lgfausak,5,0.00012,3925762,91.06299,4311040
12552,liwenhao0810,5,0.00012,3925767,91.06311,4311040
12553,lizan,5,0.00012,3925772,91.06322,4311040
12554,lizzzcai,5,0.00012,3925777,91.06334,4311040
12555,ljfranklin,5,0.00012,3925782,91.06346,4311040
12556,lmunro-at-shopify,5,0.00012,3925787,91.06357,4311040
12557,lobkovilya,5,0.00012,3925792,91.06369,4311040
12558,loganfuller,5,0.00012,3925797,91.06380,4311040
12559,louis-paul,5,0.00012,3925802,91.06392,4311040
12560,LouisStAmour,5,0.00012,3925807,91.06404,4311040
12561,lowzj,5,0.00012,3925812,91.06415,4311040
12562,LP0101,5,0.00012,3925817,91.06427,4311040
12563,lstoll,5,0.00012,3925822,91.06438,4311040
12564,lucasmellos,5,0.00012,3925827,91.06450,4311040
12565,lucasreed,5,0.00012,3925832,91.06462,4311040
12566,luchillo17,5,0.00012,3925837,91.06473,4311040
12567,luispollo,5,0.00012,3925842,91.06485,4311040
12568,lukeab,5,0.00012,3925847,91.06496,4311040
12569,lukeplausin,5,0.00012,3925852,91.06508,4311040
12570,lukibahr,5,0.00012,3925857,91.06520,4311040
12571,lvlds,5,0.00012,3925862,91.06531,4311040
12572,maateen,5,0.00012,3925867,91.06543,4311040
12573,madetara,5,0.00012,3925872,91.06554,4311040
12574,MahdiZareie,5,0.00012,3925877,91.06566,4311040
12575,majinjing3,5,0.00012,3925882,91.06578,4311040
12576,manast,5,0.00012,3925887,91.06589,4311040
12577,manavsiddharthgupta,5,0.00012,3925892,91.06601,4311040
12578,marcel-dempers,5,0.00012,3925897,91.06612,4311040
12579,MarcMielke,5,0.00012,3925902,91.06624,4311040
12580,marcredhat,5,0.00012,3925907,91.06636,4311040
12581,markpundsack,5,0.00012,3925912,91.06647,4311040
12582,MarounMaroun,5,0.00012,3925917,91.06659,4311040
12583,marshauf,5,0.00012,3925922,91.06670,4311040
12584,MartinKirchner,5,0.00012,3925927,91.06682,4311040
12585,mastertinner,5,0.00012,3925932,91.06694,4311040
12586,mastrolinux,5,0.00012,3925937,91.06705,4311040
12587,mathewpeterson,5,0.00012,3925942,91.06717,4311040
12588,matoszz,5,0.00012,3925947,91.06728,4311040
12589,matthiasgubler,5,0.00012,3925952,91.06740,4311040
12590,mattnenterprise,5,0.00012,3925957,91.06752,4311040
12591,mattsawyer77,5,0.00012,3925962,91.06763,4311040
12592,maugusto-cit,5,0.00012,3925967,91.06775,4311040
12593,MaxDiOrio,5,0.00012,3925972,91.06786,4311040
12594,maximilien,5,0.00012,3925977,91.06798,4311040
12595,mayurwaghmode,5,0.00012,3925982,91.06809,4311040
12596,m-barthelemy,5,0.00012,3925987,91.06821,4311040
12597,McPatate,5,0.00012,3925992,91.06833,4311040
12598,mcred,5,0.00012,3925997,91.06844,4311040
12599,mdhume,5,0.00012,3926002,91.06856,4311040
12600,mdlayher,5,0.00012,3926007,91.06867,4311040
12601,megakoresh,5,0.00012,3926012,91.06879,4311040
12602,mellena1,5,0.00012,3926017,91.06891,4311040
12603,mentos1386,5,0.00012,3926022,91.06902,4311040
12604,metaflow,5,0.00012,3926027,91.06914,4311040
12605,mfdii,5,0.00012,3926032,91.06925,4311040
12606,mflendrich,5,0.00012,3926037,91.06937,4311040
12607,mfojtak,5,0.00012,3926042,91.06949,4311040
12608,mhristache,5,0.00012,3926047,91.06960,4311040
12609,MichaelBitard,5,0.00012,3926052,91.06972,4311040
12610,MichaelCade,5,0.00012,3926057,91.06983,4311040
12611,michaelscheetz,5,0.00012,3926062,91.06995,4311040
12612,michaelvilensky,5,0.00012,3926067,91.07007,4311040
12613,mickours,5,0.00012,3926072,91.07018,4311040
12614,miguelfrde,5,0.00012,3926077,91.07030,4311040
12615,miha-plesko,5,0.00012,3926082,91.07041,4311040
12616,mihneaspirescu,5,0.00012,3926087,91.07053,4311040
12617,mikebell90,5,0.00012,3926092,91.07065,4311040
12618,mikeplavsky,5,0.00012,3926097,91.07076,4311040
12619,MiLk,5,0.00012,3926102,91.07088,4311040
12620,MiloATH,5,0.00012,3926107,91.07099,4311040
12621,mindymo,5,0.00012,3926112,91.07111,4311040
12622,minjae9610,5,0.00012,3926117,91.07123,4311040
12623,MISSEY,5,0.00012,3926122,91.07134,4311040
12624,missinglink,5,0.00012,3926127,91.07146,4311040
12625,mkarg,5,0.00012,3926132,91.07157,4311040
12626,mkuchin,5,0.00012,3926137,91.07169,4311040
12627,mmb,5,0.00012,3926142,91.07181,4311040
12628,mmikulicic,5,0.00012,3926147,91.07192,4311040
12629,MohamedBassem,5,0.00012,3926152,91.07204,4311040
12630,mohammedfakhar,5,0.00012,3926157,91.07215,4311040
12631,moizjv,5,0.00012,3926162,91.07227,4311040
12632,mojojoji,5,0.00012,3926167,91.07239,4311040
12633,monchier,5,0.00012,3926172,91.07250,4311040
12634,MorganBauer,5,0.00012,3926177,91.07262,4311040
12635,morsik,5,0.00012,3926182,91.07273,4311040
12636,Moser-ss,5,0.00012,3926187,91.07285,4311040
12637,mrlihanbo,5,0.00012,3926192,91.07297,4311040
12638,mrnonz,5,0.00012,3926197,91.07308,4311040
12639,msimonin,5,0.00012,3926202,91.07320,4311040
12640,mstrzele,5,0.00012,3926207,91.07331,4311040
12641,mtiller,5,0.00012,3926212,91.07343,4311040
12642,muhammad-rafi,5,0.00012,3926217,91.07355,4311040
12643,mybesthd,5,0.00012,3926222,91.07366,4311040
12644,mykolaichuk,5,0.00012,3926227,91.07378,4311040
12645,mylons,5,0.00012,3926232,91.07389,4311040
12646,myugan,5,0.00012,3926237,91.07401,4311040
12647,NathanMcCauley,5,0.00012,3926242,91.07413,4311040
12648,nielsslot,5,0.00012,3926247,91.07424,4311040
12649,nilanjan-samajdar,5,0.00012,3926252,91.07436,4311040
12650,nisan270390,5,0.00012,3926257,91.07447,4311040
12651,nishanth-pinnapareddy,5,0.00012,3926262,91.07459,4311040
12652,njucjc,5,0.00012,3926267,91.07471,4311040
12653,NOX73,5,0.00012,3926272,91.07482,4311040
12654,npalm,5,0.00012,3926277,91.07494,4311040
12655,nparfait,5,0.00012,3926282,91.07505,4311040
12656,nrjohnstone,5,0.00012,3926287,91.07517,4311040
12657,nsmith5,5,0.00012,3926292,91.07529,4311040
12658,numansiddique,5,0.00012,3926297,91.07540,4311040
12659,nunix,5,0.00012,3926302,91.07552,4311040
12660,nvsd,5,0.00012,3926307,91.07563,4311040
12661,obeleh,5,0.00012,3926312,91.07575,4311040
12662,object88,5,0.00012,3926317,91.07587,4311040
12663,octonawish-akcodes,5,0.00012,3926322,91.07598,4311040
12664,oleg-andreyev,5,0.00012,3926327,91.07610,4311040
12665,OlivierBoucher,5,0.00012,3926332,91.07621,4311040
12666,olostan,5,0.00012,3926337,91.07633,4311040
12667,omeryounus,5,0.00012,3926342,91.07645,4311040
12668,OndroNR,5,0.00012,3926347,91.07656,4311040
12669,OpenSourceZombie,5,0.00012,3926352,91.07668,4311040
12670,oreissig,5,0.00012,3926357,91.07679,4311040
12671,otaviof,5,0.00012,3926362,91.07691,4311040
12672,oyvindio,5,0.00012,3926367,91.07703,4311040
12673,packetcollision,5,0.00012,3926372,91.07714,4311040
12674,paprickar,5,0.00012,3926377,91.07726,4311040
12675,pastudan,5,0.00012,3926382,91.07737,4311040
12676,patelrutva,5,0.00012,3926387,91.07749,4311040
12677,patricekrakow,5,0.00012,3926392,91.07761,4311040
12678,patrickeasters,5,0.00012,3926397,91.07772,4311040
12679,patrickmslatteryvt,5,0.00012,3926402,91.07784,4311040
12680,patricks,5,0.00012,3926407,91.07795,4311040
12681,paulwitt,5,0.00012,3926412,91.07807,4311040
12682,paulzim,5,0.00012,3926417,91.07819,4311040
12683,pavan2004it,5,0.00012,3926422,91.07830,4311040
12684,paveq,5,0.00012,3926427,91.07842,4311040
12685,pbchekin,5,0.00012,3926432,91.07853,4311040
12686,Peefy,5,0.00012,3926437,91.07865,4311040
12687,Pefou-flo,5,0.00012,3926442,91.07877,4311040
12688,perezd,5,0.00012,3926447,91.07888,4311040
12689,petemiron,5,0.00012,3926452,91.07900,4311040
12690,peteroneilljr,5,0.00012,3926457,91.07911,4311040
12691,peter-svensson,5,0.00012,3926462,91.07923,4311040
12692,pfcurtis,5,0.00012,3926467,91.07935,4311040
12693,phanikumarp,5,0.00012,3926472,91.07946,4311040
12694,PhilipSchmid,5,0.00012,3926477,91.07958,4311040
12695,phoban01,5,0.00012,3926482,91.07969,4311040
12696,PhoenixAD,5,0.00012,3926487,91.07981,4311040
12697,pliljenberg,5,0.00012,3926492,91.07993,4311040
12698,pmint93,5,0.00012,3926497,91.08004,4311040
12699,pniederlag,5,0.00012,3926502,91.08016,4311040
12700,polefishu,5,0.00012,3926507,91.08027,4311040
12701,pop,5,0.00012,3926512,91.08039,4311040
12702,potatopankakes,5,0.00012,3926517,91.08050,4311040
12703,potterhe,5,0.00012,3926522,91.08062,4311040
12704,poy,5,0.00012,3926527,91.08074,4311040
12705,Pradeepkumarbk,5,0.00012,3926532,91.08085,4311040
12706,pramodsetlur,5,0.00012,3926537,91.08097,4311040
12707,prateekjainaa,5,0.00012,3926542,91.08108,4311040
12708,pratikmallya,5,0.00012,3926547,91.08120,4311040
12709,procinger,5,0.00012,3926552,91.08132,4311040
12710,prondubuisi,5,0.00012,3926557,91.08143,4311040
12711,ProZsolt,5,0.00012,3926562,91.08155,4311040
12712,prudhvinag06,5,0.00012,3926567,91.08166,4311040
12713,puckpuck,5,0.00012,3926572,91.08178,4311040
12714,PurpleBooth,5,0.00012,3926577,91.08190,4311040
12715,purplezimmermann,5,0.00012,3926582,91.08201,4311040
12716,pv93,5,0.00012,3926587,91.08213,4311040
12717,pwhittlesea,5,0.00012,3926592,91.08224,4311040
12718,qnetter,5,0.00012,3926597,91.08236,4311040
12719,quater,5,0.00012,3926602,91.08248,4311040
12720,rafan,5,0.00012,3926607,91.08259,4311040
12721,rajatjindal83,5,0.00012,3926612,91.08271,4311040
12722,rajeevchukkapalli,5,0.00012,3926617,91.08282,4311040
12723,rajeshwrn,5,0.00012,3926622,91.08294,4311040
12724,rakeshvanga,5,0.00012,3926627,91.08306,4311040
12725,RamazanKara,5,0.00012,3926632,91.08317,4311040
12726,ramkumardevanathan,5,0.00012,3926637,91.08329,4311040
12727,Rastusik,5,0.00012,3926642,91.08340,4311040
12728,razius,5,0.00012,3926647,91.08352,4311040
12729,remiville,5,0.00012,3926652,91.08364,4311040
12730,RhnSharma,5,0.00012,3926657,91.08375,4311040
12731,rhyas,5,0.00012,3926662,91.08387,4311040
12732,riaan53,5,0.00012,3926667,91.08398,4311040
12733,richerlariviere,5,0.00012,3926672,91.08410,4311040
12734,richmondwang,5,0.00012,3926677,91.08422,4311040
12735,RickyCook,5,0.00012,3926682,91.08433,4311040
12736,rileyL6122428,5,0.00012,3926687,91.08445,4311040
12737,rimey,5,0.00012,3926692,91.08456,4311040
12738,rivimont,5,0.00012,3926697,91.08468,4311040
12739,rjmco,5,0.00012,3926702,91.08480,4311040
12740,rluvaton,5,0.00012,3926707,91.08491,4311040
12741,rmacian,5,0.00012,3926712,91.08503,4311040
12742,rmazzine,5,0.00012,3926717,91.08514,4311040
12743,rmfitzpatrick,5,0.00012,3926722,91.08526,4311040
12744,rnarkk,5,0.00012,3926727,91.08538,4311040
12745,rnwolfe,5,0.00012,3926732,91.08549,4311040
12746,robberphex,5,0.00012,3926737,91.08561,4311040
12747,roberthstrand,5,0.00012,3926742,91.08572,4311040
12748,robertoalcantara,5,0.00012,3926747,91.08584,4311040
12749,Robert-Stam,5,0.00012,3926752,91.08596,4311040
12750,robinkb,5,0.00012,3926757,91.08607,4311040
12751,RobinMcCorkell,5,0.00012,3926762,91.08619,4311040
12752,rohan-kulkarni-25,5,0.00012,3926767,91.08630,4311040
12753,Rohithzr,5,0.00012,3926772,91.08642,4311040
12754,rohitsakala,5,0.00012,3926777,91.08654,4311040
12755,romanzdk,5,0.00012,3926782,91.08665,4311040
12756,rom-stratoscale,5,0.00012,3926787,91.08677,4311040
12757,rreinurm,5,0.00012,3926792,91.08688,4311040
12758,rsvancara,5,0.00012,3926797,91.08700,4311040
12759,rtluckie,5,0.00012,3926802,91.08712,4311040
12760,Rugvip,5,0.00012,3926807,91.08723,4311040
12761,ruizeng,5,0.00012,3926812,91.08735,4311040
12762,Rukeith,5,0.00012,3926817,91.08746,4311040
12763,ruromero,5,0.00012,3926822,91.08758,4311040
12764,rusenask,5,0.00012,3926827,91.08770,4311040
12765,rwmjones,5,0.00012,3926832,91.08781,4311040
12766,saada,5,0.00012,3926837,91.08793,4311040
12767,sabre1041,5,0.00012,3926842,91.08804,4311040
12768,sahansera,5,0.00012,3926847,91.08816,4311040
12769,sahid,5,0.00012,3926852,91.08828,4311040
12770,samgiles,5,0.00012,3926857,91.08839,4311040
12771,samjo-nyang,5,0.00012,3926862,91.08851,4311040
12772,samuelvl,5,0.00012,3926867,91.08862,4311040
12773,sandhose,5,0.00012,3926872,91.08874,4311040
12774,sanyu,5,0.00012,3926877,91.08886,4311040
12775,sbonds,5,0.00012,3926882,91.08897,4311040
12776,scharissis,5,0.00012,3926887,91.08909,4311040
12777,schlomo,5,0.00012,3926892,91.08920,4311040
12778,schmalliso,5,0.00012,3926897,91.08932,4311040
12779,SchSeba,5,0.00012,3926902,91.08944,4311040
12780,seanduncandatadog,5,0.00012,3926907,91.08955,4311040
12781,sebagomez,5,0.00012,3926912,91.08967,4311040
12782,sebastiangaiser,5,0.00012,3926917,91.08978,4311040
12783,sebastian-sch,5,0.00012,3926922,91.08990,4311040
12784,sebastiansterk,5,0.00012,3926927,91.09002,4311040
12785,sebastienc,5,0.00012,3926932,91.09013,4311040
12786,sebglon,5,0.00012,3926937,91.09025,4311040
12787,segator,5,0.00012,3926942,91.09036,4311040
12788,selmanj,5,0.00012,3926947,91.09048,4311040
12789,serefacet,5,0.00012,3926952,91.09060,4311040
12790,sfriedel,5,0.00012,3926957,91.09071,4311040
12791,sgran,5,0.00012,3926962,91.09083,4311040
12792,Sha01in,5,0.00012,3926967,91.09094,4311040
12793,shacharSilbert,5,0.00012,3926972,91.09106,4311040
12794,shadiramadan,5,0.00012,3926977,91.09118,4311040
12795,Shareed2k,5,0.00012,3926982,91.09129,4311040
12796,shashankpradhan,5,0.00012,3926987,91.09141,4311040
12797,shashanktomar,5,0.00012,3926992,91.09152,4311040
12798,ShaunakJoshi1407,5,0.00012,3926997,91.09164,4311040
12799,sheeeng,5,0.00012,3927002,91.09176,4311040
12800,shenkonghui,5,0.00012,3927007,91.09187,4311040
12801,shivanshs9,5,0.00012,3927012,91.09199,4311040
12802,sho-abe,5,0.00012,3927017,91.09210,4311040
12803,shyr,5,0.00012,3927022,91.09222,4311040
12804,Silvenga,5,0.00012,3927027,91.09234,4311040
12805,Silveryfu,5,0.00012,3927032,91.09245,4311040
12806,simar7,5,0.00012,3927037,91.09257,4311040
12807,Simon-Li,5,0.00012,3927042,91.09268,4311040
12808,SirishaGopigiri,5,0.00012,3927047,91.09280,4311040
12809,siyuan0322,5,0.00012,3927052,91.09291,4311040
12810,skwasiborski,5,0.00012,3927057,91.09303,4311040
12811,skyline09,5,0.00012,3927062,91.09315,4311040
12812,slabber,5,0.00012,3927067,91.09326,4311040
12813,slowr,5,0.00012,3927072,91.09338,4311040
12814,smalnote,5,0.00012,3927077,91.09349,4311040
12815,smanpathak,5,0.00012,3927082,91.09361,4311040
12816,smijolovic,5,0.00012,3927087,91.09373,4311040
12817,smortex,5,0.00012,3927092,91.09384,4311040
12818,sneako,5,0.00012,3927097,91.09396,4311040
12819,Snehil03,5,0.00012,3927102,91.09407,4311040
12820,soheilhy,5,0.00012,3927107,91.09419,4311040
12821,so-jelly,5,0.00012,3927112,91.09431,4311040
12822,solarnz,5,0.00012,3927117,91.09442,4311040
12823,soudaburger,5,0.00012,3927122,91.09454,4311040
12824,spaparaju,5,0.00012,3927127,91.09465,4311040
12825,sp-manuel-jurado,5,0.00012,3927132,91.09477,4311040
12826,spolti,5,0.00012,3927137,91.09489,4311040
12827,sprutner,5,0.00012,3927142,91.09500,4311040
12828,srkunze,5,0.00012,3927147,91.09512,4311040
12829,steffeneichler,5,0.00012,3927152,91.09523,4311040
12830,stevecrozz,5,0.00012,3927157,91.09535,4311040
12831,SteveLasker,5,0.00012,3927162,91.09547,4311040
12832,stevewolter,5,0.00012,3927167,91.09558,4311040
12833,stijnbrouwers,5,0.00012,3927172,91.09570,4311040
12834,stockhausenj,5,0.00012,3927177,91.09581,4311040
12835,storozhilov,5,0.00012,3927182,91.09593,4311040
12836,stoyanr,5,0.00012,3927187,91.09605,4311040
12837,strainovic,5,0.00012,3927192,91.09616,4311040
12838,stuart-mclaren,5,0.00012,3927197,91.09628,4311040
12839,stuartnelson3,5,0.00012,3927202,91.09639,4311040
12840,subesokun,5,0.00012,3927207,91.09651,4311040
12841,sudip-moengage,5,0.00012,3927212,91.09663,4311040
12842,sudmis,5,0.00012,3927217,91.09674,4311040
12843,suhail34,5,0.00012,3927222,91.09686,4311040
12844,supertetelman,5,0.00012,3927227,91.09697,4311040
12845,surajgautam,5,0.00012,3927232,91.09709,4311040
12846,surensinghkhatana,5,0.00012,3927237,91.09721,4311040
12847,svmaris,5,0.00012,3927242,91.09732,4311040
12848,szczeles,5,0.00012,3927247,91.09744,4311040
12849,szh,5,0.00012,3927252,91.09755,4311040
12850,taisph,5,0.00012,3927257,91.09767,4311040
12851,talklittle,5,0.00012,3927262,91.09779,4311040
12852,TalyaF,5,0.00012,3927267,91.09790,4311040
12853,tanguyfalconnet,5,0.00012,3927272,91.09802,4311040
12854,tanmaykm,5,0.00012,3927277,91.09813,4311040
12855,tanyifeng,5,0.00012,3927282,91.09825,4311040
12856,tcarland,5,0.00012,3927287,91.09837,4311040
12857,techieforfun,5,0.00012,3927292,91.09848,4311040
12858,tetsuya28,5,0.00012,3927297,91.09860,4311040
12859,thekoma,5,0.00012,3927302,91.09871,4311040
12860,therevoman,5,0.00012,3927307,91.09883,4311040
12861,thesayyn,5,0.00012,3927312,91.09895,4311040
12862,TheSpiritXIII,5,0.00012,3927317,91.09906,4311040
12863,TheYkk,5,0.00012,3927322,91.09918,4311040
12864,thiagolsfortunato,5,0.00012,3927327,91.09929,4311040
12865,thisisshi,5,0.00012,3927332,91.09941,4311040
12866,thrawn01,5,0.00012,3927337,91.09953,4311040
12867,tillig,5,0.00012,3927342,91.09964,4311040
12868,timfeirg,5,0.00012,3927347,91.09976,4311040
12869,timoschwarzer,5,0.00012,3927352,91.09987,4311040
12870,timothydowney,5,0.00012,3927357,91.09999,4311040
12871,tivvit,5,0.00012,3927362,91.10011,4311040
12872,tlycken,5,0.00012,3927367,91.10022,4311040
12873,tniita,5,0.00012,3927372,91.10034,4311040
12874,tnyeanderson,5,0.00012,3927377,91.10045,4311040
12875,toddnni,5,0.00012,3927382,91.10057,4311040
12876,toliu,5,0.00012,3927387,91.10069,4311040
12877,tomahawk28,5,0.00012,3927392,91.10080,4311040
12878,tomalbrecht,5,0.00012,3927397,91.10092,4311040
12879,tomasAlabes,5,0.00012,3927402,91.10103,4311040
12880,tomaszsek,5,0.00012,3927407,91.10115,4311040
12881,tomelliff,5,0.00012,3927412,91.10127,4311040
12882,ToonvanStrijp,5,0.00012,3927417,91.10138,4311040
12883,trenton42,5,0.00012,3927422,91.10150,4311040
12884,trungnvfet,5,0.00012,3927427,91.10161,4311040
12885,tsuzu,5,0.00012,3927432,91.10173,4311040
12886,tuladhar,5,0.00012,3927437,91.10185,4311040
12887,tv42,5,0.00012,3927442,91.10196,4311040
12888,tvsaru,5,0.00012,3927447,91.10208,4311040
12889,twistedpair,5,0.00012,3927452,91.10219,4311040
12890,ukinau,5,0.00012,3927457,91.10231,4311040
12891,ulfox,5,0.00012,3927462,91.10243,4311040
12892,ulrich,5,0.00012,3927467,91.10254,4311040
12893,umamukkara,5,0.00012,3927472,91.10266,4311040
12894,underyx,5,0.00012,3927477,91.10277,4311040
12895,userravs,5,0.00012,3927482,91.10289,4311040
12896,Uvedale,5,0.00012,3927487,91.10301,4311040
12897,valichek,5,0.00012,3927492,91.10312,4311040
12898,vamsichilukuri,5,0.00012,3927497,91.10324,4311040
12899,VariableDeclared,5,0.00012,3927502,91.10335,4311040
12900,varunagarwal315,5,0.00012,3927507,91.10347,4311040
12901,vdesjardins,5,0.00012,3927512,91.10359,4311040
12902,veeramalla-f5,5,0.00012,3927517,91.10370,4311040
12903,VeraLyu,5,0.00012,3927522,91.10382,4311040
12904,vgarcia-te,5,0.00012,3927527,91.10393,4311040
12905,vic3lord,5,0.00012,3927532,91.10405,4311040
12906,victorgetz,5,0.00012,3927537,91.10417,4311040
12907,victorpras,5,0.00012,3927542,91.10428,4311040
12908,victoru,5,0.00012,3927547,91.10440,4311040
12909,VihanAgarwal97,5,0.00012,3927552,91.10451,4311040
12910,vincepower,5,0.00012,3927557,91.10463,4311040
12911,vishnoianil,5,0.00012,3927562,91.10475,4311040
12912,vitarkah,5,0.00012,3927567,91.10486,4311040
12913,VivekBhat,5,0.00012,3927572,91.10498,4311040
12914,vsiddharth,5,0.00012,3927577,91.10509,4311040
12915,vukor,5,0.00012,3927582,91.10521,4311040
12916,w3aman,5,0.00012,3927587,91.10532,4311040
12917,wadeholler,5,0.00012,3927592,91.10544,4311040
12918,waelmas,5,0.00012,3927597,91.10556,4311040
12919,webratz,5,0.00012,3927602,91.10567,4311040
12920,wernerb,5,0.00012,3927607,91.10579,4311040
12921,WesleySugarFree,5,0.00012,3927612,91.10590,4311040
12922,wgebis,5,0.00012,3927617,91.10602,4311040
12923,wilbry,5,0.00012,3927622,91.10614,4311040
12924,wilsonjackson,5,0.00012,3927627,91.10625,4311040
12925,wiltonfelix,5,0.00012,3927632,91.10637,4311040
12926,wjrogers,5,0.00012,3927637,91.10648,4311040
12927,wnz27,5,0.00012,3927642,91.10660,4311040
12928,wonkarthik,5,0.00012,3927647,91.10672,4311040
12929,woutergd,5,0.00012,3927652,91.10683,4311040
12930,wrdls,5,0.00012,3927657,91.10695,4311040
12931,wrossmann,5,0.00012,3927662,91.10706,4311040
12932,wssgyyg,5,0.00012,3927667,91.10718,4311040
12933,wsxiaozhang,5,0.00012,3927672,91.10730,4311040
12934,x1022as,5,0.00012,3927677,91.10741,4311040
12935,xie-jinwei,5,0.00012,3927682,91.10753,4311040
12936,xin3liang,5,0.00012,3927687,91.10764,4311040
12937,xingxingxia,5,0.00012,3927692,91.10776,4311040
12938,xinity,5,0.00012,3927697,91.10788,4311040
12939,xin-styra,5,0.00012,3927702,91.10799,4311040
12940,xuwang,5,0.00012,3927707,91.10811,4311040
12941,xwisen,5,0.00012,3927712,91.10822,4311040
12942,y1r,5,0.00012,3927717,91.10834,4311040
12943,yaakov-berkovitch,5,0.00012,3927722,91.10846,4311040
12944,yangzhares,5,0.00012,3927727,91.10857,4311040
12945,yanivoliver,5,0.00012,3927732,91.10869,4311040
12946,ycao56,5,0.00012,3927737,91.10880,4311040
12947,yehuis4,5,0.00012,3927742,91.10892,4311040
12948,yellowred,5,0.00012,3927747,91.10904,4311040
12949,Ye-Tian-Zero,5,0.00012,3927752,91.10915,4311040
12950,yfried,5,0.00012,3927757,91.10927,4311040
12951,ymesika,5,0.00012,3927762,91.10938,4311040
12952,yonran,5,0.00012,3927767,91.10950,4311040
12953,YujiOshima,5,0.00012,3927772,91.10962,4311040
12954,YujiShen,5,0.00012,3927777,91.10973,4311040
12955,zach-dunton-sf,5,0.00012,3927782,91.10985,4311040
12956,zbbfufu,5,0.00012,3927787,91.10996,4311040
12957,zen-xu,5,0.00012,3927792,91.11008,4311040
12958,zettaittenani,5,0.00012,3927797,91.11020,4311040
12959,zhenghuiwang,5,0.00012,3927802,91.11031,4311040
12960,zhjwpku,5,0.00012,3927807,91.11043,4311040
12961,zimme,5,0.00012,3927812,91.11054,4311040
12962,zishen,5,0.00012,3927817,91.11066,4311040
12963,ziyadbasheer,5,0.00012,3927822,91.11078,4311040
12964,zmlka,5,0.00012,3927827,91.11089,4311040
12965,zqfan,5,0.00012,3927832,91.11101,4311040
12966,zscholl,5,0.00012,3927837,91.11112,4311040
12967,zvictor,5,0.00012,3927842,91.11124,4311040
12968,0xlen,4,0.00009,3927846,91.11133,4311040
12969,180254,4,0.00009,3927850,91.11143,4311040
12970,486,4,0.00009,3927854,91.11152,4311040
12971,76creates,4,0.00009,3927858,91.11161,4311040
12972,a8uhnf,4,0.00009,3927862,91.11170,4311040
12973,aario,4,0.00009,3927866,91.11180,4311040
12974,acj,4,0.00009,3927870,91.11189,4311040
12975,adams0619,4,0.00009,3927874,91.11198,4311040
12976,adg,4,0.00009,3927878,91.11208,4311040
12977,adiantum,4,0.00009,3927882,91.11217,4311040
12978,adyromantika,4,0.00009,3927886,91.11226,4311040
12979,AeroNotix,4,0.00009,3927890,91.11235,4311040
12980,afoninsky,4,0.00009,3927894,91.11245,4311040
12981,agentreno,4,0.00009,3927898,91.11254,4311040
12982,aggress,4,0.00009,3927902,91.11263,4311040
12983,agsmith,4,0.00009,3927906,91.11272,4311040
12984,ahmad-hamade,4,0.00009,3927910,91.11282,4311040
12985,ahume,4,0.00009,3927914,91.11291,4311040
12986,AidanDelaney,4,0.00009,3927918,91.11300,4311040
12987,aistein,4,0.00009,3927922,91.11310,4311040
12988,aivarssilins,4,0.00009,3927926,91.11319,4311040
12989,ajanthan,4,0.00009,3927930,91.11328,4311040
12990,ak895912,4,0.00009,3927934,91.11337,4311040
12991,akanshujamwal,4,0.00009,3927938,91.11347,4311040
12992,akefirad,4,0.00009,3927942,91.11356,4311040
12993,alecthomas,4,0.00009,3927946,91.11365,4311040
12994,AlecTroemel,4,0.00009,3927950,91.11375,4311040
12995,AlexandreBrown,4,0.00009,3927954,91.11384,4311040
12996,alexandrem,4,0.00009,3927958,91.11393,4311040
12997,alexandre-mendes,4,0.00009,3927962,91.11402,4311040
12998,alex-dixon,4,0.00009,3927966,91.11412,4311040
12999,alexdyas,4,0.00009,3927970,91.11421,4311040
13000,alexfrieden,4,0.00009,3927974,91.11430,4311040
13001,alexgeek,4,0.00009,3927978,91.11439,4311040
13002,AlexisHW,4,0.00009,3927982,91.11449,4311040
13003,alexkappa,4,0.00009,3927986,91.11458,4311040
13004,AlexStasko,4,0.00009,3927990,91.11467,4311040
13005,alexwlchan,4,0.00009,3927994,91.11477,4311040
13006,Alex-ZL,4,0.00009,3927998,91.11486,4311040
13007,alfsuse,4,0.00009,3928002,91.11495,4311040
13008,alirezazamani,4,0.00009,3928006,91.11504,4311040
13009,aliscott,4,0.00009,3928010,91.11514,4311040
13010,allanlei,4,0.00009,3928014,91.11523,4311040
13011,allen-servedio,4,0.00009,3928018,91.11532,4311040
13012,allyford,4,0.00009,3928022,91.11542,4311040
13013,alukyan,4,0.00009,3928026,91.11551,4311040
13014,alxndr13,4,0.00009,3928030,91.11560,4311040
13015,AmandaCameron,4,0.00009,3928034,91.11569,4311040
13016,amazingandyyy,4,0.00009,3928038,91.11579,4311040
13017,AmetPreply,4,0.00009,3928042,91.11588,4311040
13018,ameyaagashe,4,0.00009,3928046,91.11597,4311040
13019,amitlt,4,0.00009,3928050,91.11606,4311040
13020,anandfresh,4,0.00009,3928054,91.11616,4311040
13021,andor-pierdelacabeza,4,0.00009,3928058,91.11625,4311040
13022,andreasgerstmayr,4,0.00009,3928062,91.11634,4311040
13023,andreipetrescu95,4,0.00009,3928066,91.11644,4311040
13024,AndrewMcFarren,4,0.00009,3928070,91.11653,4311040
13025,andrewrk,4,0.00009,3928074,91.11662,4311040
13026,andrewrothstein,4,0.00009,3928078,91.11671,4311040
13027,AndriySidliarskiy,4,0.00009,3928082,91.11681,4311040
13028,andyjeffries,4,0.00009,3928086,91.11690,4311040
13029,anfredette,4,0.00009,3928090,91.11699,4311040
13030,angelosanramon,4,0.00009,3928094,91.11709,4311040
13031,anishkny,4,0.00009,3928098,91.11718,4311040
13032,ankushagarwal,4,0.00009,3928102,91.11727,4311040
13033,anowak-ct,4,0.00009,3928106,91.11736,4311040
13034,antonfisher,4,0.00009,3928110,91.11746,4311040
13035,antoniomo,4,0.00009,3928114,91.11755,4311040
13036,antonionappi88,4,0.00009,3928118,91.11764,4311040
13037,aoboturov,4,0.00009,3928122,91.11773,4311040
13038,apoorvajagtap,4,0.00009,3928126,91.11783,4311040
13039,apryiomka,4,0.00009,3928130,91.11792,4311040
13040,aquarhead,4,0.00009,3928134,91.11801,4311040
13041,aram535,4,0.00009,3928138,91.11811,4311040
13042,arielb135,4,0.00009,3928142,91.11820,4311040
13043,ark-g,4,0.00009,3928146,91.11829,4311040
13044,armenr,4,0.00009,3928150,91.11838,4311040
13045,aroundthecode,4,0.00009,3928154,91.11848,4311040
13046,artazar,4,0.00009,3928158,91.11857,4311040
13047,arugal,4,0.00009,3928162,91.11866,4311040
13048,arush-sal,4,0.00009,3928166,91.11876,4311040
13049,asheshambasta,4,0.00009,3928170,91.11885,4311040
13050,aslom,4,0.00009,3928174,91.11894,4311040
13051,asm89,4,0.00009,3928178,91.11903,4311040
13052,asmith030,4,0.00009,3928182,91.11913,4311040
13053,AssafShaikevich,4,0.00009,3928186,91.11922,4311040
13054,Asuforce,4,0.00009,3928190,91.11931,4311040
13055,atamgp,4,0.00009,3928194,91.11941,4311040
13056,aterreno,4,0.00009,3928198,91.11950,4311040
13057,atif1996,4,0.00009,3928202,91.11959,4311040
13058,atulabhi,4,0.00009,3928206,91.11968,4311040
13059,avestuk,4,0.00009,3928210,91.11978,4311040
13060,avishnu,4,0.00009,3928214,91.11987,4311040
13061,avrahams,4,0.00009,3928218,91.11996,4311040
13062,Avtandilko,4,0.00009,3928222,91.12005,4311040
13063,aychang95,4,0.00009,3928226,91.12015,4311040
13064,B0go,4,0.00009,3928230,91.12024,4311040
13065,badoet,4,0.00009,3928234,91.12033,4311040
13066,baichinger,4,0.00009,3928238,91.12043,4311040
13067,bakhtin,4,0.00009,3928242,91.12052,4311040
13068,ballerabdude,4,0.00009,3928246,91.12061,4311040
13069,baracoder,4,0.00009,3928250,91.12070,4311040
13070,baranov1ch,4,0.00009,3928254,91.12080,4311040
13071,barrydobson,4,0.00009,3928258,91.12089,4311040
13072,basit9958,4,0.00009,3928262,91.12098,4311040
13073,bbearce,4,0.00009,3928266,91.12108,4311040
13074,bcha,4,0.00009,3928270,91.12117,4311040
13075,bclermont,4,0.00009,3928274,91.12126,4311040
13076,bdwyertech,4,0.00009,3928278,91.12135,4311040
13077,benjaminapetersen,4,0.00009,3928282,91.12145,4311040
13078,benjamin-tucker,4,0.00009,3928286,91.12154,4311040
13079,bernardoVale,4,0.00009,3928290,91.12163,4311040
13080,bgdnlp,4,0.00009,3928294,91.12172,4311040
13081,bgvladedivac,4,0.00009,3928298,91.12182,4311040
13082,Bhargav-InfraCloud,4,0.00009,3928302,91.12191,4311040
13083,bhiravabhatla,4,0.00009,3928306,91.12200,4311040
13084,bigangryrobot,4,0.00009,3928310,91.12210,4311040
13085,bigeasy,4,0.00009,3928314,91.12219,4311040
13086,billmetangmo,4,0.00009,3928318,91.12228,4311040
13087,blackbird29,4,0.00009,3928322,91.12237,4311040
13088,blairdrummond,4,0.00009,3928326,91.12247,4311040
13089,blankenshipz,4,0.00009,3928330,91.12256,4311040
13090,blhagadorn,4,0.00009,3928334,91.12265,4311040
13091,blixt,4,0.00009,3928338,91.12275,4311040
13092,blublinsky,4,0.00009,3928342,91.12284,4311040
13093,bmbferreira,4,0.00009,3928346,91.12293,4311040
13094,bmcustodio,4,0.00009,3928350,91.12302,4311040
13095,bobmayuze,4,0.00009,3928354,91.12312,4311040
13096,bolipereira,4,0.00009,3928358,91.12321,4311040
13097,BondAnthony,4,0.00009,3928362,91.12330,4311040
13098,booninite,4,0.00009,3928366,91.12339,4311040
13099,borekb,4,0.00009,3928370,91.12349,4311040
13100,BorjaEst,4,0.00009,3928374,91.12358,4311040
13101,borkmann,4,0.00009,3928378,91.12367,4311040
13102,BostjanBozic,4,0.00009,3928382,91.12377,4311040
13103,boxcee,4,0.00009,3928386,91.12386,4311040
13104,bradfordcp,4,0.00009,3928390,91.12395,4311040
13105,brandonh-msft,4,0.00009,3928394,91.12404,4311040
13106,brandon-mabey,4,0.00009,3928398,91.12414,4311040
13107,brettcurtis,4,0.00009,3928402,91.12423,4311040
13108,BrianBlandKY,4,0.00009,3928406,91.12432,4311040
13109,BrijJhala,4,0.00009,3928410,91.12442,4311040
13110,brindasanth,4,0.00009,3928414,91.12451,4311040
13111,brodier,4,0.00009,3928418,91.12460,4311040
13112,brouberol,4,0.00009,3928422,91.12469,4311040
13113,browning,4,0.00009,3928426,91.12479,4311040
13114,BruceHunter,4,0.00009,3928430,91.12488,4311040
13115,brunopadz,4,0.00009,3928434,91.12497,4311040
13116,brunoqc,4,0.00009,3928438,91.12506,4311040
13117,BrunoVernay,4,0.00009,3928442,91.12516,4311040
13118,bryteise,4,0.00009,3928446,91.12525,4311040
13119,bstick12,4,0.00009,3928450,91.12534,4311040
13120,btwseeu78,4,0.00009,3928454,91.12544,4311040
13121,buckhx,4,0.00009,3928458,91.12553,4311040
13122,burgerdev,4,0.00009,3928462,91.12562,4311040
13123,Cajga,4,0.00009,3928466,91.12571,4311040
13124,calvinyv,4,0.00009,3928470,91.12581,4311040
13125,captncraig,4,0.00009,3928474,91.12590,4311040
13126,CarlosGuemS,4,0.00009,3928478,91.12599,4311040
13127,carpenike,4,0.00009,3928482,91.12609,4311040
13128,cartmanume,4,0.00009,3928486,91.12618,4311040
13129,cbron,4,0.00009,3928490,91.12627,4311040
13130,cdancy,4,0.00009,3928494,91.12636,4311040
13131,cdelpinogeo,4,0.00009,3928498,91.12646,4311040
13132,cedlerouge,4,0.00009,3928502,91.12655,4311040
13133,cedricmckinnie,4,0.00009,3928506,91.12664,4311040
13134,cedricziel,4,0.00009,3928510,91.12674,4311040
13135,ceroloy,4,0.00009,3928514,91.12683,4311040
13136,cfarquhar,4,0.00009,3928518,91.12692,4311040
13137,chaitanya1731,4,0.00009,3928522,91.12701,4311040
13138,chambridge,4,0.00009,3928526,91.12711,4311040
13139,changsijay,4,0.00009,3928530,91.12720,4311040
13140,chen23,4,0.00009,3928534,91.12729,4311040
13141,chicks-net,4,0.00009,3928538,91.12738,4311040
13142,Chinwendu20,4,0.00009,3928542,91.12748,4311040
13143,chiraggadasc,4,0.00009,3928546,91.12757,4311040
13144,chris13524,4,0.00009,3928550,91.12766,4311040
13145,ChrisCooney,4,0.00009,3928554,91.12776,4311040
13146,chris-kr,4,0.00009,3928558,91.12785,4311040
13147,chris-rock,4,0.00009,3928562,91.12794,4311040
13148,chrisUsick,4,0.00009,3928566,91.12803,4311040
13149,citananda,4,0.00009,3928570,91.12813,4311040
13150,ckotzbauer,4,0.00009,3928574,91.12822,4311040
13151,clemens-tolboom,4,0.00009,3928578,91.12831,4311040
13152,clipperhouse,4,0.00009,3928582,91.12841,4311040
13153,clive-jevons,4,0.00009,3928586,91.12850,4311040
13154,clnperez,4,0.00009,3928590,91.12859,4311040
13155,CMajeri,4,0.00009,3928594,91.12868,4311040
13156,cmendible,4,0.00009,3928598,91.12878,4311040
13157,code-chris,4,0.00009,3928602,91.12887,4311040
13158,codejamninja,4,0.00009,3928606,91.12896,4311040
13159,complexsplit,4,0.00009,3928610,91.12905,4311040
13160,comxd,4,0.00009,3928614,91.12915,4311040
13161,connor4312,4,0.00009,3928618,91.12924,4311040
13162,craigatgoogle,4,0.00009,3928622,91.12933,4311040
13163,crosvera,4,0.00009,3928626,91.12943,4311040
13164,csreegn,4,0.00009,3928630,91.12952,4311040
13165,cucxabong,4,0.00009,3928634,91.12961,4311040
13166,cuong-ts,4,0.00009,3928638,91.12970,4311040
13167,cwyl02,4,0.00009,3928642,91.12980,4311040
13168,czerasz,4,0.00009,3928646,91.12989,4311040
13169,d2iq-shadowbq,4,0.00009,3928650,91.12998,4311040
13170,D3nn,4,0.00009,3928654,91.13008,4311040
13171,dalbhanj,4,0.00009,3928658,91.13017,4311040
13172,damerakd,4,0.00009,3928662,91.13026,4311040
13173,danieldabate,4,0.00009,3928666,91.13035,4311040
13174,danielfrg,4,0.00009,3928670,91.13045,4311040
13175,danielgblanco,4,0.00009,3928674,91.13054,4311040
13176,danielmbarlow,4,0.00009,3928678,91.13063,4311040
13177,dansemedo,4,0.00009,3928682,91.13072,4311040
13178,danylohetmantsev,4,0.00009,3928686,91.13082,4311040
13179,dariopb,4,0.00009,3928690,91.13091,4311040
13180,darrenmutz,4,0.00009,3928694,91.13100,4311040
13181,dasch,4,0.00009,3928698,91.13110,4311040
13182,Data-drone,4,0.00009,3928702,91.13119,4311040
13183,dataviruset,4,0.00009,3928706,91.13128,4311040
13184,davejhahn,4,0.00009,3928710,91.13137,4311040
13185,davidcorbin,4,0.00009,3928714,91.13147,4311040
13186,davidgibbons,4,0.00009,3928718,91.13156,4311040
13187,DavidS-om,4,0.00009,3928722,91.13165,4311040
13188,david-thrower,4,0.00009,3928726,91.13175,4311040
13189,dbpolito,4,0.00009,3928730,91.13184,4311040
13190,deevroman,4,0.00009,3928734,91.13193,4311040
13191,Delorien84,4,0.00009,3928738,91.13202,4311040
13192,delwaterman,4,0.00009,3928742,91.13212,4311040
13193,DerekHeldtWerle,4,0.00009,3928746,91.13221,4311040
13194,derektamsen,4,0.00009,3928750,91.13230,4311040
13195,desagar,4,0.00009,3928754,91.13239,4311040
13196,desdic,4,0.00009,3928758,91.13249,4311040
13197,desreela,4,0.00009,3928762,91.13258,4311040
13198,Dev0Null,4,0.00009,3928766,91.13267,4311040
13199,Dev25,4,0.00009,3928770,91.13277,4311040
13200,devnulled,4,0.00009,3928774,91.13286,4311040
13201,dfredell,4,0.00009,3928778,91.13295,4311040
13202,dgorst,4,0.00009,3928782,91.13304,4311040
13203,DGreenstein,4,0.00009,3928786,91.13314,4311040
13204,dharmeshkakadia,4,0.00009,3928790,91.13323,4311040
13205,didrocks,4,0.00009,3928794,91.13332,4311040
13206,digger18,4,0.00009,3928798,91.13342,4311040
13207,dimakievua,4,0.00009,3928802,91.13351,4311040
13208,dineshb-jnpr,4,0.00009,3928806,91.13360,4311040
13209,dirtGit,4,0.00009,3928810,91.13369,4311040
13210,dispensable,4,0.00009,3928814,91.13379,4311040
13211,distorhead,4,0.00009,3928818,91.13388,4311040
13212,divoxx,4,0.00009,3928822,91.13397,4311040
13213,divy4,4,0.00009,3928826,91.13407,4311040
13214,diwakar-s-maurya,4,0.00009,3928830,91.13416,4311040
13215,djhaskin987,4,0.00009,3928834,91.13425,4311040
13216,dkoston,4,0.00009,3928838,91.13434,4311040
13217,dlovitch,4,0.00009,3928842,91.13444,4311040
13218,dmildh,4,0.00009,3928846,91.13453,4311040
13219,dmlf,4,0.00009,3928850,91.13462,4311040
13220,dnelson,4,0.00009,3928854,91.13471,4311040
13221,dniasoff,4,0.00009,3928858,91.13481,4311040
13222,dolisss,4,0.00009,3928862,91.13490,4311040
13223,Dongxiugang,4,0.00009,3928866,91.13499,4311040
13224,donofriov,4,0.00009,3928870,91.13509,4311040
13225,doug-papenthien-by,4,0.00009,3928874,91.13518,4311040
13226,druchoo,4,0.00009,3928878,91.13527,4311040
13227,dsalaza4,4,0.00009,3928882,91.13536,4311040
13228,dseynaev,4,0.00009,3928886,91.13546,4311040
13229,dsvua,4,0.00009,3928890,91.13555,4311040
13230,dsy3502,4,0.00009,3928894,91.13564,4311040
13231,DTadrzak,4,0.00009,3928898,91.13574,4311040
13232,dthomson25,4,0.00009,3928902,91.13583,4311040
13233,DuMaM,4,0.00009,3928906,91.13592,4311040
13234,Duncan-tree-zhou,4,0.00009,3928910,91.13601,4311040
13235,dwding18,4,0.00009,3928914,91.13611,4311040
13236,dweitzman-codaio,4,0.00009,3928918,91.13620,4311040
13237,dy-dx,4,0.00009,3928922,91.13629,4311040
13238,dzzg,4,0.00009,3928926,91.13638,4311040
13239,EArminjon,4,0.00009,3928930,91.13648,4311040
13240,eastlunar,4,0.00009,3928934,91.13657,4311040
13241,ecki,4,0.00009,3928938,91.13666,4311040
13242,ecliptik,4,0.00009,3928942,91.13676,4311040
13243,edalford11,4,0.00009,3928946,91.13685,4311040
13244,e-dard,4,0.00009,3928950,91.13694,4311040
13245,edlee2121,4,0.00009,3928954,91.13703,4311040
13246,eggsbenjamin,4,0.00009,3928958,91.13713,4311040
13247,ejamesc,4,0.00009,3928962,91.13722,4311040
13248,ejether,4,0.00009,3928966,91.13731,4311040
13249,ejholmes,4,0.00009,3928970,91.13741,4311040
13250,ekesken,4,0.00009,3928974,91.13750,4311040
13251,EladGabay,4,0.00009,3928978,91.13759,4311040
13252,elliott-davis,4,0.00009,3928982,91.13768,4311040
13253,elppc,4,0.00009,3928986,91.13778,4311040
13254,emfree,4,0.00009,3928990,91.13787,4311040
13255,Emruz-Hossain,4,0.00009,3928994,91.13796,4311040
13256,enigma99a,4,0.00009,3928998,91.13805,4311040
13257,e-nikolov,4,0.00009,3929002,91.13815,4311040
13258,eoli3n,4,0.00009,3929006,91.13824,4311040
13259,ephur,4,0.00009,3929010,91.13833,4311040
13260,epk,4,0.00009,3929014,91.13843,4311040
13261,equinox0815,4,0.00009,3929018,91.13852,4311040
13262,eranchetz,4,0.00009,3929022,91.13861,4311040
13263,ericat,4,0.00009,3929026,91.13870,4311040
13264,ErikBean,4,0.00009,3929030,91.13880,4311040
13265,ermik,4,0.00009,3929034,91.13889,4311040
13266,ethanchowell,4,0.00009,3929038,91.13898,4311040
13267,EwanValentine,4,0.00009,3929042,91.13908,4311040
13268,ewbankkit,4,0.00009,3929046,91.13917,4311040
13269,ewolinetz,4,0.00009,3929050,91.13926,4311040
13270,extesy,4,0.00009,3929054,91.13935,4311040
13271,fabboe,4,0.00009,3929058,91.13945,4311040
13272,fabiant7t,4,0.00009,3929062,91.13954,4311040
13273,fabiormoura,4,0.00009,3929066,91.13963,4311040
13274,FabriceSalvaire,4,0.00009,3929070,91.13972,4311040
13275,faizanbashir,4,0.00009,3929074,91.13982,4311040
13276,fandujar,4,0.00009,3929078,91.13991,4311040
13277,fanminshi,4,0.00009,3929082,91.14000,4311040
13278,farrellit,4,0.00009,3929086,91.14010,4311040
13279,FavourDaniel,4,0.00009,3929090,91.14019,4311040
13280,fbalicchia,4,0.00009,3929094,91.14028,4311040
13281,fbcbarbosa,4,0.00009,3929098,91.14037,4311040
13282,Feder1co5oave,4,0.00009,3929102,91.14047,4311040
13283,FedericoYST,4,0.00009,3929106,91.14056,4311040
13284,felipeek,4,0.00009,3929110,91.14065,4311040
13285,fernandrone,4,0.00009,3929114,91.14075,4311040
13286,ferrantim,4,0.00009,3929118,91.14084,4311040
13287,ffjlabo,4,0.00009,3929122,91.14093,4311040
13288,finkr,4,0.00009,3929126,91.14102,4311040
13289,FireDrunk,4,0.00009,3929130,91.14112,4311040
13290,firemanxbr,4,0.00009,3929134,91.14121,4311040
13291,fjvela,4,0.00009,3929138,91.14130,4311040
13292,fkautz,4,0.00009,3929142,91.14140,4311040
13293,Flask,4,0.00009,3929146,91.14149,4311040
13294,FlavioF,4,0.00009,3929150,91.14158,4311040
13295,FlorentFlament,4,0.00009,3929154,91.14167,4311040
13296,floriantraber,4,0.00009,3929158,91.14177,4311040
13297,FogDong,4,0.00009,3929162,91.14186,4311040
13298,fr0stbyte,4,0.00009,3929166,91.14195,4311040
13299,fracasula,4,0.00009,3929170,91.14204,4311040
13300,francisu,4,0.00009,3929174,91.14214,4311040
13301,franklinyu,4,0.00009,3929178,91.14223,4311040
13302,frankreno,4,0.00009,3929182,91.14232,4311040
13303,Fredy-Z,4,0.00009,3929186,91.14242,4311040
13304,FrimIdan,4,0.00009,3929190,91.14251,4311040
13305,fristonio,4,0.00009,3929194,91.14260,4311040
13306,frosas,4,0.00009,3929198,91.14269,4311040
13307,gaetanquentin,4,0.00009,3929202,91.14279,4311040
13308,gageorsburn,4,0.00009,3929206,91.14288,4311040
13309,gaieges,4,0.00009,3929210,91.14297,4311040
13310,galal-hussein,4,0.00009,3929214,91.14307,4311040
13311,galiacheng,4,0.00009,3929218,91.14316,4311040
13312,galvesribeiro,4,0.00009,3929222,91.14325,4311040
13313,garethcmurphy,4,0.00009,3929226,91.14334,4311040
13314,garethjevans,4,0.00009,3929230,91.14344,4311040
13315,gashcrumb,4,0.00009,3929234,91.14353,4311040
13316,gautam2187,4,0.00009,3929238,91.14362,4311040
13317,gdamberg,4,0.00009,3929242,91.14371,4311040
13318,gd-jroberts,4,0.00009,3929246,91.14381,4311040
13319,gdubya,4,0.00009,3929250,91.14390,4311040
13320,gedw99,4,0.00009,3929254,91.14399,4311040
13321,Geethree,4,0.00009,3929258,91.14409,4311040
13322,gerald1248,4,0.00009,3929262,91.14418,4311040
13323,gerardgorrion,4,0.00009,3929266,91.14427,4311040
13324,gfelixc,4,0.00009,3929270,91.14436,4311040
13325,ghigt,4,0.00009,3929274,91.14446,4311040
13326,ghostwriternr,4,0.00009,3929278,91.14455,4311040
13327,gil-excelero,4,0.00009,3929282,91.14464,4311040
13328,gitnik,4,0.00009,3929286,91.14474,4311040
13329,gkleiman,4,0.00009,3929290,91.14483,4311040
13330,glazychev-art,4,0.00009,3929294,91.14492,4311040
13331,glenonn,4,0.00009,3929298,91.14501,4311040
13332,glnds,4,0.00009,3929302,91.14511,4311040
13333,glothriel,4,0.00009,3929306,91.14520,4311040
13334,gmaslowski,4,0.00009,3929310,91.14529,4311040
13335,go-nelango,4,0.00009,3929314,91.14538,4311040
13336,gonzaloserrano,4,0.00009,3929318,91.14548,4311040
13337,gotwarlost,4,0.00009,3929322,91.14557,4311040
13338,gowalking,4,0.00009,3929326,91.14566,4311040
13339,gpkc,4,0.00009,3929330,91.14576,4311040
13340,gramidt,4,0.00009,3929334,91.14585,4311040
13341,GsssC,4,0.00009,3929338,91.14594,4311040
13342,gtarcoder,4,0.00009,3929342,91.14603,4311040
13343,gturbat,4,0.00009,3929346,91.14613,4311040
13344,guersam,4,0.00009,3929350,91.14622,4311040
13345,gunterze,4,0.00009,3929354,91.14631,4311040
13346,gvd22,4,0.00009,3929358,91.14641,4311040
13347,haguenau,4,0.00009,3929362,91.14650,4311040
13348,Haimantika,4,0.00009,3929366,91.14659,4311040
13349,haimari,4,0.00009,3929370,91.14668,4311040
13350,hamelsmu,4,0.00009,3929374,91.14678,4311040
13351,hameno,4,0.00009,3929378,91.14687,4311040
13352,hans-d,4,0.00009,3929382,91.14696,4311040
13353,haooliveira84,4,0.00009,3929386,91.14706,4311040
13354,harai,4,0.00009,3929390,91.14715,4311040
13355,Harshitavkb26,4,0.00009,3929394,91.14724,4311040
13356,hbrueckner,4,0.00009,3929398,91.14733,4311040
13357,hd-deman,4,0.00009,3929402,91.14743,4311040
13358,henri9813,4,0.00009,3929406,91.14752,4311040
13359,himani93,4,0.00009,3929410,91.14761,4311040
13360,hmalphettes,4,0.00009,3929414,91.14770,4311040
13361,hpasapp,4,0.00009,3929418,91.14780,4311040
13362,hSATAC,4,0.00009,3929422,91.14789,4311040
13363,huangshanhui,4,0.00009,3929426,91.14798,4311040
13364,hueifeng,4,0.00009,3929430,91.14808,4311040
13365,huineng,4,0.00009,3929434,91.14817,4311040
13366,HWiese1980,4,0.00009,3929438,91.14826,4311040
13367,hyandell,4,0.00009,3929442,91.14835,4311040
13368,iamnande,4,0.00009,3929446,91.14845,4311040
13369,ianjuma,4,0.00009,3929450,91.14854,4311040
13370,ibm-jason,4,0.00009,3929454,91.14863,4311040
13371,icanhazbroccoli,4,0.00009,3929458,91.14873,4311040
13372,IdanAdar,4,0.00009,3929462,91.14882,4311040
13373,ide,4,0.00009,3929466,91.14891,4311040
13374,idryomov,4,0.00009,3929470,91.14900,4311040
13375,iJanki,4,0.00009,3929474,91.14910,4311040
13376,ilanpillemer,4,0.00009,3929478,91.14919,4311040
13377,ilya-lesikov,4,0.00009,3929482,91.14928,4311040
13378,imba-tjd,4,0.00009,3929486,91.14937,4311040
13379,ImDevinC,4,0.00009,3929490,91.14947,4311040
13380,imlcl,4,0.00009,3929494,91.14956,4311040
13381,impl,4,0.00009,3929498,91.14965,4311040
13382,infa-anisrini,4,0.00009,3929502,91.14975,4311040
13383,infernix,4,0.00009,3929506,91.14984,4311040
13384,ingshtrom,4,0.00009,3929510,91.14993,4311040
13385,InTheCage,4,0.00009,3929514,91.15002,4311040
13386,inverse,4,0.00009,3929518,91.15012,4311040
13387,ipatrykx,4,0.00009,3929522,91.15021,4311040
13388,iqbalsound,4,0.00009,3929526,91.15030,4311040
13389,iredelmeier,4,0.00009,3929530,91.15040,4311040
13390,IrinaAndronachi,4,0.00009,3929534,91.15049,4311040
13391,iris-garcia,4,0.00009,3929538,91.15058,4311040
13392,ironknight78,4,0.00009,3929542,91.15067,4311040
13393,isavcic,4,0.00009,3929546,91.15077,4311040
13394,Ishmeet,4,0.00009,3929550,91.15086,4311040
13395,ismaeIfm,4,0.00009,3929554,91.15095,4311040
13396,itamar-marom,4,0.00009,3929558,91.15104,4311040
13397,itsLucario,4,0.00009,3929562,91.15114,4311040
13398,itssimon,4,0.00009,3929566,91.15123,4311040
13399,ittus,4,0.00009,3929570,91.15132,4311040
13400,ivasilyev-servicetitan-com,4,0.00009,3929574,91.15142,4311040
13401,jabelone,4,0.00009,3929578,91.15151,4311040
13402,JackDanger,4,0.00009,3929582,91.15160,4311040
13403,jack-evans,4,0.00009,3929586,91.15169,4311040
13404,JakeC1020,4,0.00009,3929590,91.15179,4311040
13405,jakub-bochenski,4,0.00009,3929594,91.15188,4311040
13406,JamesJJ,4,0.00009,3929598,91.15197,4311040
13407,jamestutton,4,0.00009,3929602,91.15207,4311040
13408,jamiees2,4,0.00009,3929606,91.15216,4311040
13409,jan25,4,0.00009,3929610,91.15225,4311040
13410,jansel,4,0.00009,3929614,91.15234,4311040
13411,jaredbischof,4,0.00009,3929618,91.15244,4311040
13412,Jaxing,4,0.00009,3929622,91.15253,4311040
13413,jaydipdave,4,0.00009,3929626,91.15262,4311040
13414,jbdalido,4,0.00009,3929630,91.15271,4311040
13415,jcrossley3,4,0.00009,3929634,91.15281,4311040
13416,jcsp,4,0.00009,3929638,91.15290,4311040
13417,Jean-Baptiste-Lasselle,4,0.00009,3929642,91.15299,4311040
13418,JeffResc,4,0.00009,3929646,91.15309,4311040
13419,jeffutter,4,0.00009,3929650,91.15318,4311040
13420,jeliasson,4,0.00009,3929654,91.15327,4311040
13421,jeremejevs,4,0.00009,3929658,91.15336,4311040
13422,jeremyzhou,4,0.00009,3929662,91.15346,4311040
13423,jessegonzalez-life360,4,0.00009,3929666,91.15355,4311040
13424,jessejohnston-isp,4,0.00009,3929670,91.15364,4311040
13425,jharrington22,4,0.00009,3929674,91.15374,4311040
13426,jhunthrop,4,0.00009,3929678,91.15383,4311040
13427,jiahao,4,0.00009,3929682,91.15392,4311040
13428,jiazhang0,4,0.00009,3929686,91.15401,4311040
13429,JihadMotii-REISys,4,0.00009,3929690,91.15411,4311040
13430,jimisan,4,0.00009,3929694,91.15420,4311040
13431,Jim-Lin,4,0.00009,3929698,91.15429,4311040
13432,jimmyraywv,4,0.00009,3929702,91.15439,4311040
13433,jknipper,4,0.00009,3929706,91.15448,4311040
13434,jkt628,4,0.00009,3929710,91.15457,4311040
13435,jlumme,4,0.00009,3929714,91.15466,4311040
13436,jmaitrehenry,4,0.00009,3929718,91.15476,4311040
13437,jmhardison,4,0.00009,3929722,91.15485,4311040
13438,jmhwang7,4,0.00009,3929726,91.15494,4311040
13439,jmiddleton,4,0.00009,3929730,91.15503,4311040
13440,jmthvt,4,0.00009,3929734,91.15513,4311040
13441,jniebuhr,4,0.00009,3929738,91.15522,4311040
13442,JoeyZwicker,4,0.00009,3929742,91.15531,4311040
13443,johnmccabe,4,0.00009,3929746,91.15541,4311040
13444,johnnyhuy,4,0.00009,3929750,91.15550,4311040
13445,johnpemberton,4,0.00009,3929754,91.15559,4311040
13446,jonaskint,4,0.00009,3929758,91.15568,4311040
13447,jonas-lu,4,0.00009,3929762,91.15578,4311040
13448,jonatas,4,0.00009,3929766,91.15587,4311040
13449,jonfairbanks,4,0.00009,3929770,91.15596,4311040
13450,jon-whit,4,0.00009,3929774,91.15606,4311040
13451,joshdk,4,0.00009,3929778,91.15615,4311040
13452,joshgav,4,0.00009,3929782,91.15624,4311040
13453,joshuaswaney,4,0.00009,3929786,91.15633,4311040
13454,josiahbryan,4,0.00009,3929790,91.15643,4311040
13455,jotaoncode,4,0.00009,3929794,91.15652,4311040
13456,jpantsjoha,4,0.00009,3929798,91.15661,4311040
13457,jpiccari,4,0.00009,3929802,91.15670,4311040
13458,jppitout,4,0.00009,3929806,91.15680,4311040
13459,jpza,4,0.00009,3929810,91.15689,4311040
13460,JRBANCEL,4,0.00009,3929814,91.15698,4311040
13461,jshaughn,4,0.00009,3929818,91.15708,4311040
13462,jsulinski,4,0.00009,3929822,91.15717,4311040
13463,jttyeung,4,0.00009,3929826,91.15726,4311040
13464,juckerf,4,0.00009,3929830,91.15735,4311040
13465,julianxhokaxhiu,4,0.00009,3929834,91.15745,4311040
13466,juliorenner,4,0.00009,3929838,91.15754,4311040
13467,jungopro,4,0.00009,3929842,91.15763,4311040
13468,juretta,4,0.00009,3929846,91.15773,4311040
13469,justinabrahms,4,0.00009,3929850,91.15782,4311040
13470,justinclayton,4,0.00009,3929854,91.15791,4311040
13471,justinfx,4,0.00009,3929858,91.15800,4311040
13472,juv,4,0.00009,3929862,91.15810,4311040
13473,jverce,4,0.00009,3929866,91.15819,4311040
13474,jyoshise,4,0.00009,3929870,91.15828,4311040
13475,k15r,4,0.00009,3929874,91.15837,4311040
13476,kam1kaze,4,0.00009,3929878,91.15847,4311040
13477,kamirendawkins,4,0.00009,3929882,91.15856,4311040
13478,kanekoh,4,0.00009,3929886,91.15865,4311040
13479,kapilpau,4,0.00009,3929890,91.15875,4311040
13480,karlvr,4,0.00009,3929894,91.15884,4311040
13481,KarolisL,4,0.00009,3929898,91.15893,4311040
13482,kaushikchaubal,4,0.00009,3929902,91.15902,4311040
13483,KenjiKanedaNVIDIA,4,0.00009,3929906,91.15912,4311040
13484,kennethkalmer,4,0.00009,3929910,91.15921,4311040
13485,kennytrytek-wf,4,0.00009,3929914,91.15930,4311040
13486,kentakozuka,4,0.00009,3929918,91.15940,4311040
13487,kessiler,4,0.00009,3929922,91.15949,4311040
13488,kevinkirkup,4,0.00009,3929926,91.15958,4311040
13489,keymon,4,0.00009,3929930,91.15967,4311040
13490,kflansburg,4,0.00009,3929934,91.15977,4311040
13491,kfoozminus,4,0.00009,3929938,91.15986,4311040
13492,kikov79,4,0.00009,3929942,91.15995,4311040
13493,killmeplz,4,0.00009,3929946,91.16004,4311040
13494,kimsterv,4,0.00009,3929950,91.16014,4311040
13495,kinoute,4,0.00009,3929954,91.16023,4311040
13496,kishorenc,4,0.00009,3929958,91.16032,4311040
13497,kissgyorgy,4,0.00009,3929962,91.16042,4311040
13498,Kitanotori,4,0.00009,3929966,91.16051,4311040
13499,kiwenlau,4,0.00009,3929970,91.16060,4311040
13500,kjenney,4,0.00009,3929974,91.16069,4311040
13501,kjinan,4,0.00009,3929978,91.16079,4311040
13502,kkallday,4,0.00009,3929982,91.16088,4311040
13503,klebediev,4,0.00009,3929986,91.16097,4311040
13504,kleimkuhler,4,0.00009,3929990,91.16107,4311040
13505,kop,4,0.00009,3929994,91.16116,4311040
13506,KostyaSha,4,0.00009,3929998,91.16125,4311040
13507,kpiyush17,4,0.00009,3930002,91.16134,4311040
13508,krokwen,4,0.00009,3930006,91.16144,4311040
13509,krsna1729,4,0.00009,3930010,91.16153,4311040
13510,ksemaev,4,0.00009,3930014,91.16162,4311040
13511,kuppuswamy,4,0.00009,3930018,91.16172,4311040
13512,kuritka,4,0.00009,3930022,91.16181,4311040
13513,kuzm1ch,4,0.00009,3930026,91.16190,4311040
13514,kvaradhan3,4,0.00009,3930030,91.16199,4311040
13515,kvenkata986,4,0.00009,3930034,91.16209,4311040
13516,kvitajakub,4,0.00009,3930038,91.16218,4311040
13517,kvz,4,0.00009,3930042,91.16227,4311040
13518,lalithsuresh,4,0.00009,3930046,91.16236,4311040
13519,larslevie,4,0.00009,3930050,91.16246,4311040
13520,lautou,4,0.00009,3930054,91.16255,4311040
13521,lavanyachennupati,4,0.00009,3930058,91.16264,4311040
13522,laxathom,4,0.00009,3930062,91.16274,4311040
13523,LeankitJSmith,4,0.00009,3930066,91.16283,4311040
13524,leitzler,4,0.00009,3930070,91.16292,4311040
13525,lenny87,4,0.00009,3930074,91.16301,4311040
13526,levsha,4,0.00009,3930078,91.16311,4311040
13527,lexsys27,4,0.00009,3930082,91.16320,4311040
13528,lgnashold,4,0.00009,3930086,91.16329,4311040
13529,liavyona,4,0.00009,3930090,91.16339,4311040
13530,LilMonk,4,0.00009,3930094,91.16348,4311040
13531,linjmeyer,4,0.00009,3930098,91.16357,4311040
13532,lminzhw,4,0.00009,3930102,91.16366,4311040
13533,lnhrdt,4,0.00009,3930106,91.16376,4311040
13534,lnikell,4,0.00009,3930110,91.16385,4311040
13535,lnshi,4,0.00009,3930114,91.16394,4311040
13536,Logiraptor,4,0.00009,3930118,91.16403,4311040
13537,loicfrering,4,0.00009,3930122,91.16413,4311040
13538,lucas-cegatti,4,0.00009,3930126,91.16422,4311040
13539,LucaSoato,4,0.00009,3930130,91.16431,4311040
13540,LUEDDEA,4,0.00009,3930134,91.16441,4311040
13541,lukestuts,4,0.00009,3930138,91.16450,4311040
13542,lullen,4,0.00009,3930142,91.16459,4311040
13543,lurraca,4,0.00009,3930146,91.16468,4311040
13544,lzecca78,4,0.00009,3930150,91.16478,4311040
13545,m4rcu5,4,0.00009,3930154,91.16487,4311040
13546,machgo,4,0.00009,3930158,91.16496,4311040
13547,Macrame,4,0.00009,3930162,91.16506,4311040
13548,MadalinaPatrichi,4,0.00009,3930166,91.16515,4311040
13549,mads-hartmann,4,0.00009,3930170,91.16524,4311040
13550,MagicSong,4,0.00009,3930174,91.16533,4311040
13551,MakDon,4,0.00009,3930178,91.16543,4311040
13552,MalikMlitat,4,0.00009,3930182,91.16552,4311040
13553,MalKeshar,4,0.00009,3930186,91.16561,4311040
13554,manosnoam,4,0.00009,3930190,91.16570,4311040
13555,marcelcorso,4,0.00009,3930194,91.16580,4311040
13556,marcelfranca,4,0.00009,3930198,91.16589,4311040
13557,marcelobartsch,4,0.00009,3930202,91.16598,4311040
13558,marchmallow,4,0.00009,3930206,91.16608,4311040
13559,marcinkubica,4,0.00009,3930210,91.16617,4311040
13560,marciopuga,4,0.00009,3930214,91.16626,4311040
13561,marcust,4,0.00009,3930218,91.16635,4311040
13562,Mario54,4,0.00009,3930222,91.16645,4311040
13563,mariomac,4,0.00009,3930226,91.16654,4311040
13564,markbenschop,4,0.00009,3930230,91.16663,4311040
13565,MarkKropf,4,0.00009,3930234,91.16673,4311040
13566,markpeek,4,0.00009,3930238,91.16682,4311040
13567,markvincze,4,0.00009,3930242,91.16691,4311040
13568,marrem,4,0.00009,3930246,91.16700,4311040
13569,martina-if,4,0.00009,3930250,91.16710,4311040
13570,matdehaast,4,0.00009,3930254,91.16719,4311040
13571,matt-demers,4,0.00009,3930258,91.16728,4311040
13572,MatthewPattell,4,0.00009,3930262,91.16737,4311040
13573,mattpopa,4,0.00009,3930266,91.16747,4311040
13574,max0ne,4,0.00009,3930270,91.16756,4311040
13575,maxandersen,4,0.00009,3930274,91.16765,4311040
13576,maxkokocom,4,0.00009,3930278,91.16775,4311040
13577,maxnowack,4,0.00009,3930282,91.16784,4311040
13578,MazenElzanaty,4,0.00009,3930286,91.16793,4311040
13579,mazocode,4,0.00009,3930290,91.16802,4311040
13580,mbarrien,4,0.00009,3930294,91.16812,4311040
13581,mbertschler,4,0.00009,3930298,91.16821,4311040
13582,MbolotSuse,4,0.00009,3930302,91.16830,4311040
13583,MCamp859,4,0.00009,3930306,91.16840,4311040
13584,mcfearsome,4,0.00009,3930310,91.16849,4311040
13585,mdaverde,4,0.00009,3930314,91.16858,4311040
13586,mdonoughe,4,0.00009,3930318,91.16867,4311040
13587,medzin,4,0.00009,3930322,91.16877,4311040
13588,Meegul,4,0.00009,3930326,91.16886,4311040
13589,MeghanaSrinath,4,0.00009,3930330,91.16895,4311040
13590,mehdicopter,4,0.00009,3930334,91.16905,4311040
13591,mehdy,4,0.00009,3930338,91.16914,4311040
13592,merakdu,4,0.00009,3930342,91.16923,4311040
13593,merlindorin,4,0.00009,3930346,91.16932,4311040
13594,metadave,4,0.00009,3930350,91.16942,4311040
13595,mhamrah,4,0.00009,3930354,91.16951,4311040
13596,michaelswierszcz,4,0.00009,3930358,91.16960,4311040
13597,michal-franc,4,0.00009,3930362,91.16969,4311040
13598,micheam,4,0.00009,3930366,91.16979,4311040
13599,micheleissa,4,0.00009,3930370,91.16988,4311040
13600,michel-slm,4,0.00009,3930374,91.16997,4311040
13601,miguelaeh,4,0.00009,3930378,91.17007,4311040
13602,mik-dass,4,0.00009,3930382,91.17016,4311040
13603,mikechau,4,0.00009,3930386,91.17025,4311040
13604,mikewied,4,0.00009,3930390,91.17034,4311040
13605,mikwieczorek,4,0.00009,3930394,91.17044,4311040
13606,milan-stikic-cif,4,0.00009,3930398,91.17053,4311040
13607,milosgajdos,4,0.00009,3930402,91.17062,4311040
13608,mirageglobe,4,0.00009,3930406,91.17072,4311040
13609,mitalipaygude,4,0.00009,3930410,91.17081,4311040
13610,mitchmckenzie,4,0.00009,3930414,91.17090,4311040
13611,mixalako,4,0.00009,3930418,91.17099,4311040
13612,MkhIr,4,0.00009,3930422,91.17109,4311040
13613,mkhpalm,4,0.00009,3930426,91.17118,4311040
13614,mlsorensen,4,0.00009,3930430,91.17127,4311040
13615,mluds,4,0.00009,3930434,91.17136,4311040
13616,mmontes11,4,0.00009,3930438,91.17146,4311040
13617,mojochao,4,0.00009,3930442,91.17155,4311040
13618,monday0rsunday,4,0.00009,3930446,91.17164,4311040
13619,monder,4,0.00009,3930450,91.17174,4311040
13620,montaro,4,0.00009,3930454,91.17183,4311040
13621,Monte-Christo,4,0.00009,3930458,91.17192,4311040
13622,moretea,4,0.00009,3930462,91.17201,4311040
13623,moshfeu,4,0.00009,3930466,91.17211,4311040
13624,movergan,4,0.00009,3930470,91.17220,4311040
13625,mrajadurai2413,4,0.00009,3930474,91.17229,4311040
13626,mrbrownt,4,0.00009,3930478,91.17239,4311040
13627,mrezaei00,4,0.00009,3930482,91.17248,4311040
13628,MrSimonEmms,4,0.00009,3930486,91.17257,4311040
13629,mryan43,4,0.00009,3930490,91.17266,4311040
13630,mshenhera,4,0.00009,3930494,91.17276,4311040
13631,msherif1234,4,0.00009,3930498,91.17285,4311040
13632,mshindo,4,0.00009,3930502,91.17294,4311040
13633,mterwill,4,0.00009,3930506,91.17303,4311040
13634,mtsmfm,4,0.00009,3930510,91.17313,4311040
13635,Mumrau,4,0.00009,3930514,91.17322,4311040
13636,mvbakker,4,0.00009,3930518,91.17331,4311040
13637,mvertes,4,0.00009,3930522,91.17341,4311040
13638,mvoitko,4,0.00009,3930526,91.17350,4311040
13639,mynameismevin,4,0.00009,3930530,91.17359,4311040
13640,myvker,4,0.00009,3930534,91.17368,4311040
13641,NamPNQ,4,0.00009,3930538,91.17378,4311040
13642,naotospace,4,0.00009,3930542,91.17387,4311040
13643,natiki,4,0.00009,3930546,91.17396,4311040
13644,NaurisSadovskis,4,0.00009,3930550,91.17406,4311040
13645,navidsh,4,0.00009,3930554,91.17415,4311040
13646,nd2730,4,0.00009,3930558,91.17424,4311040
13647,nebhale,4,0.00009,3930562,91.17433,4311040
13648,Neeraj-Natu,4,0.00009,3930566,91.17443,4311040
13649,neerfri,4,0.00009,3930570,91.17452,4311040
13650,Negashev,4,0.00009,3930574,91.17461,4311040
13651,neogopher,4,0.00009,3930578,91.17470,4311040
13652,nfillot,4,0.00009,3930582,91.17480,4311040
13653,ngnix,4,0.00009,3930586,91.17489,4311040
13654,nickithewatt,4,0.00009,3930590,91.17498,4311040
13655,nickytd,4,0.00009,3930594,91.17508,4311040
13656,NicolasFloquet,4,0.00009,3930598,91.17517,4311040
13657,nictownsend,4,0.00009,3930602,91.17526,4311040
13658,nightmareze1,4,0.00009,3930606,91.17535,4311040
13659,nightwatchcyber,4,0.00009,3930610,91.17545,4311040
13660,nineunderground,4,0.00009,3930614,91.17554,4311040
13661,Nit123,4,0.00009,3930618,91.17563,4311040
13662,nitheshrayuduv,4,0.00009,3930622,91.17573,4311040
13663,nlacasse,4,0.00009,3930626,91.17582,4311040
13664,nllptr,4,0.00009,3930630,91.17591,4311040
13665,noahjd,4,0.00009,3930634,91.17600,4311040
13666,noamangel,4,0.00009,3930638,91.17610,4311040
13667,noinarisak,4,0.00009,3930642,91.17619,4311040
13668,nojvek,4,0.00009,3930646,91.17628,4311040
13669,nour-karoui,4,0.00009,3930650,91.17638,4311040
13670,NPellet,4,0.00009,3930654,91.17647,4311040
13671,nprajilesh,4,0.00009,3930658,91.17656,4311040
13672,nrkfeller,4,0.00009,3930662,91.17665,4311040
13673,nyener,4,0.00009,3930666,91.17675,4311040
13674,Nymria,4,0.00009,3930670,91.17684,4311040
13675,obedmr,4,0.00009,3930674,91.17693,4311040
13676,oblogic7,4,0.00009,3930678,91.17702,4311040
13677,OddBloke,4,0.00009,3930682,91.17712,4311040
13678,offbyone,4,0.00009,3930686,91.17721,4311040
13679,ofiliz,4,0.00009,3930690,91.17730,4311040
13680,Oghenebrume50,4,0.00009,3930694,91.17740,4311040
13681,ohthehugemanatee,4,0.00009,3930698,91.17749,4311040
13682,oikomi,4,0.00009,3930702,91.17758,4311040
13683,OleksiiPasihnyk,4,0.00009,3930706,91.17767,4311040
13684,omarkj,4,0.00009,3930710,91.17777,4311040
13685,omerxx,4,0.00009,3930714,91.17786,4311040
13686,OmriHarary,4,0.00009,3930718,91.17795,4311040
13687,onyxet,4,0.00009,3930722,91.17805,4311040
13688,opklnm102,4,0.00009,3930726,91.17814,4311040
13689,orangejulius,4,0.00009,3930730,91.17823,4311040
13690,orkhanM,4,0.00009,3930734,91.17832,4311040
13691,oskapt,4,0.00009,3930738,91.17842,4311040
13692,oskarpearson,4,0.00009,3930742,91.17851,4311040
13693,otisg,4,0.00009,3930746,91.17860,4311040
13694,ouyanggh,4,0.00009,3930750,91.17869,4311040
13695,oxygen0211,4,0.00009,3930754,91.17879,4311040
13696,oybed,4,0.00009,3930758,91.17888,4311040
13697,pankajmt,4,0.00009,3930762,91.17897,4311040
13698,patoarvizu,4,0.00009,3930766,91.17907,4311040
13699,patrickleet,4,0.00009,3930770,91.17916,4311040
13700,patrikbeno,4,0.00009,3930774,91.17925,4311040
13701,patvdleer,4,0.00009,3930778,91.17934,4311040
13702,paulbellamy,4,0.00009,3930782,91.17944,4311040
13703,paulosman,4,0.00009,3930786,91.17953,4311040
13704,pavel-khritonenko,4,0.00009,3930790,91.17962,4311040
13705,pavelmaliy,4,0.00009,3930794,91.17972,4311040
13706,pbalogh-sa,4,0.00009,3930798,91.17981,4311040
13707,pborreli,4,0.00009,3930802,91.17990,4311040
13708,pcfens,4,0.00009,3930806,91.17999,4311040
13709,pclinger,4,0.00009,3930810,91.18009,4311040
13710,pc-mreeves,4,0.00009,3930814,91.18018,4311040
13711,pdonchst,4,0.00009,3930818,91.18027,4311040
13712,PeterGrace,4,0.00009,3930822,91.18036,4311040
13713,Petrox,4,0.00009,3930826,91.18046,4311040
13714,pfeodrippe,4,0.00009,3930830,91.18055,4311040
13715,phekmat,4,0.00009,3930834,91.18064,4311040
13716,philbrookes,4,0.00009,3930838,91.18074,4311040
13717,phvu,4,0.00009,3930842,91.18083,4311040
13718,phyrog,4,0.00009,3930846,91.18092,4311040
13719,Piccirello,4,0.00009,3930850,91.18101,4311040
13720,Pigmalion,4,0.00009,3930854,91.18111,4311040
13721,pingsutw,4,0.00009,3930858,91.18120,4311040
13722,pirgeo,4,0.00009,3930862,91.18129,4311040
13723,pivotaljohn,4,0.00009,3930866,91.18139,4311040
13724,pizzaz93,4,0.00009,3930870,91.18148,4311040
13725,pkern,4,0.00009,3930874,91.18157,4311040
13726,placydo,4,0.00009,3930878,91.18166,4311040
13727,plantfansam,4,0.00009,3930882,91.18176,4311040
13728,pmcfadden,4,0.00009,3930886,91.18185,4311040
13729,pmoust,4,0.00009,3930890,91.18194,4311040
13730,portepa,4,0.00009,3930894,91.18203,4311040
13731,powerman,4,0.00009,3930898,91.18213,4311040
13732,pragkent,4,0.00009,3930902,91.18222,4311040
13733,pranaypratyush,4,0.00009,3930906,91.18231,4311040
13734,pratham-m,4,0.00009,3930910,91.18241,4311040
13735,pruan-rht,4,0.00009,3930914,91.18250,4311040
13736,pseudonator,4,0.00009,3930918,91.18259,4311040
13737,psimms-r7,4,0.00009,3930922,91.18268,4311040
13738,pstauffer,4,0.00009,3930926,91.18278,4311040
13739,pugangxa,4,0.00009,3930930,91.18287,4311040
13740,purebluesong,4,0.00009,3930934,91.18296,4311040
13741,pwang7,4,0.00009,3930938,91.18306,4311040
13742,q42jaap,4,0.00009,3930942,91.18315,4311040
13743,qcu,4,0.00009,3930946,91.18324,4311040
13744,r00twayne,4,0.00009,3930950,91.18333,4311040
13745,raboof,4,0.00009,3930954,91.18343,4311040
13746,raclepoulpe,4,0.00009,3930958,91.18352,4311040
13747,rade,4,0.00009,3930962,91.18361,4311040
13748,rafilkmp3,4,0.00009,3930966,91.18371,4311040
13749,rahulgrover99,4,0.00009,3930970,91.18380,4311040
13750,ralonsoh,4,0.00009,3930974,91.18389,4311040
13751,ramanavakka,4,0.00009,3930978,91.18398,4311040
13752,ramanNarasimhan77,4,0.00009,3930982,91.18408,4311040
13753,ramaraochavali,4,0.00009,3930986,91.18417,4311040
13754,ramessesii2,4,0.00009,3930990,91.18426,4311040
13755,ramukima,4,0.00009,3930994,91.18435,4311040
13756,RandyAbernethy,4,0.00009,3930998,91.18445,4311040
13757,Rauno56,4,0.00009,3931002,91.18454,4311040
13758,ravisharda,4,0.00009,3931006,91.18463,4311040
13759,rbaumgar,4,0.00009,3931010,91.18473,4311040
13760,rbudiharso,4,0.00009,3931014,91.18482,4311040
13761,rbuskens,4,0.00009,3931018,91.18491,4311040
13762,rcarrillocruz,4,0.00009,3931022,91.18500,4311040
13763,rclsilver,4,0.00009,3931026,91.18510,4311040
13764,rcomanne,4,0.00009,3931030,91.18519,4311040
13765,rday,4,0.00009,3931034,91.18528,4311040
13766,rdelpret,4,0.00009,3931038,91.18538,4311040
13767,RedbackThomson,4,0.00009,3931042,91.18547,4311040
13768,reenl,4,0.00009,3931046,91.18556,4311040
13769,remcohaszing,4,0.00009,3931050,91.18565,4311040
13770,renan-campos,4,0.00009,3931054,91.18575,4311040
13771,reprogrammer,4,0.00009,3931058,91.18584,4311040
13772,returntrip,4,0.00009,3931062,91.18593,4311040
13773,rexxar-liang,4,0.00009,3931066,91.18602,4311040
13774,rgruyters,4,0.00009,3931070,91.18612,4311040
13775,rhim,4,0.00009,3931074,91.18621,4311040
13776,rhysemmas,4,0.00009,3931078,91.18630,4311040
13777,riceo,4,0.00009,3931082,91.18640,4311040
13778,RichardAvendano,4,0.00009,3931086,91.18649,4311040
13779,richardse,4,0.00009,3931090,91.18658,4311040
13780,rioriost,4,0.00009,3931094,91.18667,4311040
13781,RishiKumarRay,4,0.00009,3931098,91.18677,4311040
13782,ritikaguptams,4,0.00009,3931102,91.18686,4311040
13783,rjshrjndrn,4,0.00009,3931106,91.18695,4311040
13784,rkettelerij,4,0.00009,3931110,91.18705,4311040
13785,rljohnsn,4,0.00009,3931114,91.18714,4311040
13786,rmoesbergen,4,0.00009,3931118,91.18723,4311040
13787,rmuehlbauer,4,0.00009,3931122,91.18732,4311040
13788,robamaton,4,0.00009,3931126,91.18742,4311040
13789,RobbieJVMW,4,0.00009,3931130,91.18751,4311040
13790,RobbieMcKinstry,4,0.00009,3931134,91.18760,4311040
13791,RobDolinMS,4,0.00009,3931138,91.18769,4311040
13792,Roberdvs,4,0.00009,3931142,91.18779,4311040
13793,robertglen,4,0.00009,3931146,91.18788,4311040
13794,RobertNorthard,4,0.00009,3931150,91.18797,4311040
13795,robertscherbarth,4,0.00009,3931154,91.18807,4311040
13796,robyoung,4,0.00009,3931158,91.18816,4311040
13797,rohanKanojia,4,0.00009,3931162,91.18825,4311040
13798,rohitg00,4,0.00009,3931166,91.18834,4311040
13799,romeokienzler,4,0.00009,3931170,91.18844,4311040
13800,rossdotpink,4,0.00009,3931174,91.18853,4311040
13801,rot26,4,0.00009,3931178,91.18862,4311040
13802,rstarmer,4,0.00009,3931182,91.18872,4311040
13803,rtoma,4,0.00009,3931186,91.18881,4311040
13804,ruebenramirez,4,0.00009,3931190,91.18890,4311040
13805,rugwirobaker,4,0.00009,3931194,91.18899,4311040
13806,rumyantseva,4,0.00009,3931198,91.18909,4311040
13807,rung,4,0.00009,3931202,91.18918,4311040
13808,rwong2888,4,0.00009,3931206,91.18927,4311040
13809,ryanlitalien,4,0.00009,3931210,91.18936,4311040
13810,ryan-williams,4,0.00009,3931214,91.18946,4311040
13811,rzetelskik,4,0.00009,3931218,91.18955,4311040
13812,s4nch3z,4,0.00009,3931222,91.18964,4311040
13813,sacoefrancis,4,0.00009,3931226,91.18974,4311040
13814,Saeger,4,0.00009,3931230,91.18983,4311040
13815,saifshaikh48,4,0.00009,3931234,91.18992,4311040
13816,Sajmani,4,0.00009,3931238,91.19001,4311040
13817,salkin,4,0.00009,3931242,91.19011,4311040
13818,SamClinckspoor,4,0.00009,3931246,91.19020,4311040
13819,SameerMahajan-GSLab,4,0.00009,3931250,91.19029,4311040
13820,samv,4,0.00009,3931254,91.19039,4311040
13821,sandesha-rao-by,4,0.00009,3931258,91.19048,4311040
13822,sandric,4,0.00009,3931262,91.19057,4311040
13823,SangshikLee,4,0.00009,3931266,91.19066,4311040
13824,sanjaynaikwadi,4,0.00009,3931270,91.19076,4311040
13825,sansmoraxz,4,0.00009,3931274,91.19085,4311040
13826,sarlaccpit,4,0.00009,3931278,91.19094,4311040
13827,sassanh,4,0.00009,3931282,91.19104,4311040
13828,saurabhtmba2005,4,0.00009,3931286,91.19113,4311040
13829,SaveTheRbtz,4,0.00009,3931290,91.19122,4311040
13830,scottkurz,4,0.00009,3931294,91.19131,4311040
13831,sdavids13,4,0.00009,3931298,91.19141,4311040
13832,seanson,4,0.00009,3931302,91.19150,4311040
13833,sebradloff,4,0.00009,3931306,91.19159,4311040
13834,sedooe,4,0.00009,3931310,91.19168,4311040
13835,segrax,4,0.00009,3931314,91.19178,4311040
13836,senior7515,4,0.00009,3931318,91.19187,4311040
13837,senthilnathan,4,0.00009,3931322,91.19196,4311040
13838,sergey-shambir,4,0.00009,3931326,91.19206,4311040
13839,sergiomcalzada,4,0.00009,3931330,91.19215,4311040
13840,seriousben,4,0.00009,3931334,91.19224,4311040
13841,sevein,4,0.00009,3931338,91.19233,4311040
13842,sfc-gh-pkrishnamurthy,4,0.00009,3931342,91.19243,4311040
13843,Shadi,4,0.00009,3931346,91.19252,4311040
13844,shahzzzam,4,0.00009,3931350,91.19261,4311040
13845,sharmaansh21,4,0.00009,3931354,91.19271,4311040
13846,sharmaanshul21,4,0.00009,3931358,91.19280,4311040
13847,Shegox,4,0.00009,3931362,91.19289,4311040
13848,shelbyspees,4,0.00009,3931366,91.19298,4311040
13849,shillasaebi,4,0.00009,3931370,91.19308,4311040
13850,shivamerla,4,0.00009,3931374,91.19317,4311040
13851,shlomizadok,4,0.00009,3931378,91.19326,4311040
13852,shogomuranushi,4,0.00009,3931382,91.19335,4311040
13853,shonenada,4,0.00009,3931386,91.19345,4311040
13854,shreemaan-abhishek,4,0.00009,3931390,91.19354,4311040
13855,shry15harsh,4,0.00009,3931394,91.19363,4311040
13856,shubhambhattar,4,0.00009,3931398,91.19373,4311040
13857,Shubham-koli,4,0.00009,3931402,91.19382,4311040
13858,shuguet,4,0.00009,3931406,91.19391,4311040
13859,shydefoo,4,0.00009,3931410,91.19400,4311040
13860,silasb,4,0.00009,3931414,91.19410,4311040
13861,silverkorn,4,0.00009,3931418,91.19419,4311040
13862,simmessa,4,0.00009,3931422,91.19428,4311040
13863,sinthetix,4,0.00009,3931426,91.19438,4311040
13864,sipsma,4,0.00009,3931430,91.19447,4311040
13865,sishbi,4,0.00009,3931434,91.19456,4311040
13866,skomma,4,0.00009,3931438,91.19465,4311040
13867,Skymirrh,4,0.00009,3931442,91.19475,4311040
13868,slashmili,4,0.00009,3931446,91.19484,4311040
13869,slithernix,4,0.00009,3931450,91.19493,4311040
13870,smoyer64,4,0.00009,3931454,91.19502,4311040
13871,snehachhabria,4,0.00009,3931458,91.19512,4311040
13872,snehakpersistent,4,0.00009,3931462,91.19521,4311040
13873,snelis,4,0.00009,3931466,91.19530,4311040
13874,snoopdave,4,0.00009,3931470,91.19540,4311040
13875,soft-way,4,0.00009,3931474,91.19549,4311040
13876,songford,4,0.00009,3931478,91.19558,4311040
13877,sonots,4,0.00009,3931482,91.19567,4311040
13878,sonowz,4,0.00009,3931486,91.19577,4311040
13879,sourabhmodi,4,0.00009,3931490,91.19586,4311040
13880,SpectralHiss,4,0.00009,3931494,91.19595,4311040
13881,speedfl,4,0.00009,3931498,91.19605,4311040
13882,speer,4,0.00009,3931502,91.19614,4311040
13883,sr229,4,0.00009,3931506,91.19623,4311040
13884,sreetummidi,4,0.00009,3931510,91.19632,4311040
13885,srikanth-dev,4,0.00009,3931514,91.19642,4311040
13886,sseneca,4,0.00009,3931518,91.19651,4311040
13887,stefandevo,4,0.00009,3931522,91.19660,4311040
13888,stefanloerwald,4,0.00009,3931526,91.19669,4311040
13889,StephenKing,4,0.00009,3931530,91.19679,4311040
13890,Stijn98s,4,0.00009,3931534,91.19688,4311040
13891,StiviiK,4,0.00009,3931538,91.19697,4311040
13892,stormmore,4,0.00009,3931542,91.19707,4311040
13893,stshrive,4,0.00009,3931546,91.19716,4311040
13894,stsukrov,4,0.00009,3931550,91.19725,4311040
13895,StuartHarris,4,0.00009,3931554,91.19734,4311040
13896,stuzfuz,4,0.00009,3931558,91.19744,4311040
13897,stv0g,4,0.00009,3931562,91.19753,4311040
13898,SudoBrendan,4,0.00009,3931566,91.19762,4311040
13899,sudo-NithishKarthik,4,0.00009,3931570,91.19772,4311040
13900,suleymanakbas91,4,0.00009,3931574,91.19781,4311040
13901,sverch,4,0.00009,3931578,91.19790,4311040
13902,Swaps76,4,0.00009,3931582,91.19799,4311040
13903,swinges,4,0.00009,3931586,91.19809,4311040
13904,szemek,4,0.00009,3931590,91.19818,4311040
13905,t0mk,4,0.00009,3931594,91.19827,4311040
13906,takaishi,4,0.00009,3931598,91.19837,4311040
13907,tamipangadil,4,0.00009,3931602,91.19846,4311040
13908,tamird,4,0.00009,3931606,91.19855,4311040
13909,tanjacky,4,0.00009,3931610,91.19864,4311040
13910,Tarjei400,4,0.00009,3931614,91.19874,4311040
13911,tastypackets,4,0.00009,3931618,91.19883,4311040
13912,taxilian,4,0.00009,3931622,91.19892,4311040
13913,tdeshetler,4,0.00009,3931626,91.19901,4311040
13914,tdiesler,4,0.00009,3931630,91.19911,4311040
13915,techmaharaj,4,0.00009,3931634,91.19920,4311040
13916,tejaswiniVadlamudi,4,0.00009,3931638,91.19929,4311040
13917,tenfourty,4,0.00009,3931642,91.19939,4311040
13918,teresy,4,0.00009,3931646,91.19948,4311040
13919,Th3NightHawk,4,0.00009,3931650,91.19957,4311040
13920,thebeardisred,4,0.00009,3931654,91.19966,4311040
13921,thejmazz,4,0.00009,3931658,91.19976,4311040
13922,theletterf,4,0.00009,3931662,91.19985,4311040
13923,theMagicalKarp,4,0.00009,3931666,91.19994,4311040
13924,TheOriginalAlex,4,0.00009,3931670,91.20004,4311040
13925,thibaultcha,4,0.00009,3931674,91.20013,4311040
13926,thomasf7,4,0.00009,3931678,91.20022,4311040
13927,thomasschickinger,4,0.00009,3931682,91.20031,4311040
13928,ThomVivet,4,0.00009,3931686,91.20041,4311040
13929,tibbe,4,0.00009,3931690,91.20050,4311040
13930,tiffanyfj,4,0.00009,3931694,91.20059,4311040
13931,tima,4,0.00009,3931698,91.20068,4311040
13932,TimDumol,4,0.00009,3931702,91.20078,4311040
13933,timonwong,4,0.00009,3931706,91.20087,4311040
13934,TimZaman,4,0.00009,3931710,91.20096,4311040
13935,tjma2001,4,0.00009,3931714,91.20106,4311040
13936,tklovett,4,0.00009,3931718,91.20115,4311040
13937,tkopczynski,4,0.00009,3931722,91.20124,4311040
13938,tlawrie,4,0.00009,3931726,91.20133,4311040
13939,t-matsuo,4,0.00009,3931730,91.20143,4311040
13940,tmerello2001,4,0.00009,3931734,91.20152,4311040
13941,tmlbl,4,0.00009,3931738,91.20161,4311040
13942,tmxak,4,0.00009,3931742,91.20171,4311040
13943,toaler,4,0.00009,3931746,91.20180,4311040
13944,toanant,4,0.00009,3931750,91.20189,4311040
13945,tobiajo,4,0.00009,3931754,91.20198,4311040
13946,ToddMorrill,4,0.00009,3931758,91.20208,4311040
13947,tokomeno,4,0.00009,3931762,91.20217,4311040
13948,Toma5OD,4,0.00009,3931766,91.20226,4311040
13949,tomas321,4,0.00009,3931770,91.20235,4311040
13950,tommyreilly,4,0.00009,3931774,91.20245,4311040
13951,tonychoe,4,0.00009,3931778,91.20254,4311040
13952,toshiiw,4,0.00009,3931782,91.20263,4311040
13953,tpdownes,4,0.00009,3931786,91.20273,4311040
13954,tremaineeto,4,0.00009,3931790,91.20282,4311040
13955,trishnaguha,4,0.00009,3931794,91.20291,4311040
13956,tsisodia10,4,0.00009,3931798,91.20300,4311040
13957,TsuyoshiUshio,4,0.00009,3931802,91.20310,4311040
13958,ttacon,4,0.00009,3931806,91.20319,4311040
13959,ttelfer,4,0.00009,3931810,91.20328,4311040
13960,turkenh,4,0.00009,3931814,91.20338,4311040
13961,tvalasek,4,0.00009,3931818,91.20347,4311040
13962,TylerBrock,4,0.00009,3931822,91.20356,4311040
13963,tylergu,4,0.00009,3931826,91.20365,4311040
13964,tyu0912,4,0.00009,3931830,91.20375,4311040
13965,tz70s,4,0.00009,3931834,91.20384,4311040
13966,TzlilSwimmer123,4,0.00009,3931838,91.20393,4311040
13967,tzununbekov,4,0.00009,3931842,91.20403,4311040
13968,Uanid,4,0.00009,3931846,91.20412,4311040
13969,ukitazume,4,0.00009,3931850,91.20421,4311040
13970,Ultrafenrir,4,0.00009,3931854,91.20430,4311040
13971,underrun,4,0.00009,3931858,91.20440,4311040
13972,untoldone,4,0.00009,3931862,91.20449,4311040
13973,uptoknow,4,0.00009,3931866,91.20458,4311040
13974,utkarsh-pandey-ext,4,0.00009,3931870,91.20467,4311040
13975,Vacant2333,4,0.00009,3931874,91.20477,4311040
13976,VaibhavPage,4,0.00009,3931878,91.20486,4311040
13977,vaibhavrtk,4,0.00009,3931882,91.20495,4311040
13978,valery-zhurbenko,4,0.00009,3931886,91.20505,4311040
13979,Vanuan,4,0.00009,3931890,91.20514,4311040
13980,vasily-codefresh,4,0.00009,3931894,91.20523,4311040
13981,vaspahomov,4,0.00009,3931898,91.20532,4311040
13982,vassilvk,4,0.00009,3931902,91.20542,4311040
13983,vavdoshka,4,0.00009,3931906,91.20551,4311040
13984,vcozzolino,4,0.00009,3931910,91.20560,4311040
13985,vdksystem,4,0.00009,3931914,91.20570,4311040
13986,veerendra2,4,0.00009,3931918,91.20579,4311040
13987,venugopalthati,4,0.00009,3931922,91.20588,4311040
13988,vicki-c,4,0.00009,3931926,91.20597,4311040
13989,VileBrigandier,4,0.00009,3931930,91.20607,4311040
13990,vilmosnagy,4,0.00009,3931934,91.20616,4311040
13991,vinayan3,4,0.00009,3931938,91.20625,4311040
13992,vincib,4,0.00009,3931942,91.20634,4311040
13993,vishrantgupta,4,0.00009,3931946,91.20644,4311040
13994,vit100,4,0.00009,3931950,91.20653,4311040
13995,vizeit,4,0.00009,3931954,91.20662,4311040
13996,vkuznet,4,0.00009,3931958,91.20672,4311040
13997,vlajos,4,0.00009,3931962,91.20681,4311040
13998,vndroid,4,0.00009,3931966,91.20690,4311040
13999,vnzongzna,4,0.00009,3931970,91.20699,4311040
14000,Voziv,4,0.00009,3931974,91.20709,4311040
14001,vyasgun,4,0.00009,3931978,91.20718,4311040
14002,wainersm,4,0.00009,3931982,91.20727,4311040
14003,waltforme,4,0.00009,3931986,91.20737,4311040
14004,wangxunbo,4,0.00009,3931990,91.20746,4311040
14005,wangzihao05,4,0.00009,3931994,91.20755,4311040
14006,wanix,4,0.00009,3931998,91.20764,4311040
14007,WarheadsSE,4,0.00009,3932002,91.20774,4311040
14008,wawlian,4,0.00009,3932006,91.20783,4311040
14009,waynebrantley,4,0.00009,3932010,91.20792,4311040
14010,wearethefoos,4,0.00009,3932014,91.20801,4311040
14011,weisongf,4,0.00009,3932018,91.20811,4311040
14012,westurner,4,0.00009,3932022,91.20820,4311040
14013,whateverv5,4,0.00009,3932026,91.20829,4311040
14014,whut,4,0.00009,3932030,91.20839,4311040
14015,wilk,4,0.00009,3932034,91.20848,4311040
14016,willb,4,0.00009,3932038,91.20857,4311040
14017,williamcaban,4,0.00009,3932042,91.20866,4311040
14018,willnewby,4,0.00009,3932046,91.20876,4311040
14019,willnorris,4,0.00009,3932050,91.20885,4311040
14020,winggundamth,4,0.00009,3932054,91.20894,4311040
14021,wirehead,4,0.00009,3932058,91.20904,4311040
14022,wmaintw,4,0.00009,3932062,91.20913,4311040
14023,wrouesnel,4,0.00009,3932066,91.20922,4311040
14024,xiaopeng163,4,0.00009,3932070,91.20931,4311040
14025,xstevens,4,0.00009,3932074,91.20941,4311040
14026,yanatan16,4,0.00009,3932078,91.20950,4311040
14027,yanns,4,0.00009,3932082,91.20959,4311040
14028,yaoice,4,0.00009,3932086,91.20968,4311040
14029,yechnlin,4,0.00009,3932090,91.20978,4311040
14030,ykhr53,4,0.00009,3932094,91.20987,4311040
14031,yoichiwo7,4,0.00009,3932098,91.20996,4311040
14032,ypicard,4,0.00009,3932102,91.21006,4311040
14033,yrobla,4,0.00009,3932106,91.21015,4311040
14034,ysh7,4,0.00009,3932110,91.21024,4311040
14035,ysicing,4,0.00009,3932114,91.21033,4311040
14036,yubingjiaocn,4,0.00009,3932118,91.21043,4311040
14037,yue-wen,4,0.00009,3932122,91.21052,4311040
14038,yuliyantsvetkov,4,0.00009,3932126,91.21061,4311040
14039,yunxi-zhang,4,0.00009,3932130,91.21071,4311040
14040,YuraBeznos,4,0.00009,3932134,91.21080,4311040
14041,yuyicai,4,0.00009,3932138,91.21089,4311040
14042,yuzeming,4,0.00009,3932142,91.21098,4311040
14043,zachdaniel,4,0.00009,3932146,91.21108,4311040
14044,ZachEddy,4,0.00009,3932150,91.21117,4311040
14045,zaheerm,4,0.00009,3932154,91.21126,4311040
14046,zalsader,4,0.00009,3932158,91.21136,4311040
14047,zarqman,4,0.00009,3932162,91.21145,4311040
14048,zdtsw,4,0.00009,3932166,91.21154,4311040
14049,zdzichu,4,0.00009,3932170,91.21163,4311040
14050,zee-ahmed,4,0.00009,3932174,91.21173,4311040
14051,zeze1004,4,0.00009,3932178,91.21182,4311040
14052,zhaochenglan,4,0.00009,3932182,91.21191,4311040
14053,zhihuiwu,4,0.00009,3932186,91.21200,4311040
14054,zillani,4,0.00009,3932190,91.21210,4311040
14055,zmunro,4,0.00009,3932194,91.21219,4311040
14056,112101160,3,0.00007,3932197,91.21226,4311040
14057,16yuki0702,3,0.00007,3932200,91.21233,4311040
14058,2ffs2nns,3,0.00007,3932203,91.21240,4311040
14059,45cali,3,0.00007,3932206,91.21247,4311040
14060,a0s,3,0.00007,3932209,91.21254,4311040
14061,a14n,3,0.00007,3932212,91.21261,4311040
14062,a86c6f7964,3,0.00007,3932215,91.21268,4311040
14063,aak74,3,0.00007,3932218,91.21275,4311040
14064,AaronME,3,0.00007,3932221,91.21282,4311040
14065,aarononeal,3,0.00007,3932224,91.21289,4311040
14066,Aashrutisingh,3,0.00007,3932227,91.21296,4311040
14067,abaruni,3,0.00007,3932230,91.21303,4311040
14068,AbdullahArean,3,0.00007,3932233,91.21309,4311040
14069,aberres,3,0.00007,3932236,91.21316,4311040
14070,AbhijithGanesh,3,0.00007,3932239,91.21323,4311040
14071,abhishekkarigar,3,0.00007,3932242,91.21330,4311040
14072,Abhishekvrshny,3,0.00007,3932245,91.21337,4311040
14073,abhranilc,3,0.00007,3932248,91.21344,4311040
14074,abierbaum,3,0.00007,3932251,91.21351,4311040
14075,ablekh,3,0.00007,3932254,91.21358,4311040
14076,abonillasuse,3,0.00007,3932257,91.21365,4311040
14077,abrenaut,3,0.00007,3932260,91.21372,4311040
14078,acehead,3,0.00007,3932263,91.21379,4311040
14079,achetal01,3,0.00007,3932266,91.21386,4311040
14080,achille-roussel,3,0.00007,3932269,91.21393,4311040
14081,adamdunstan,3,0.00007,3932272,91.21400,4311040
14082,adamhenson,3,0.00007,3932275,91.21407,4311040
14083,adammil2000,3,0.00007,3932278,91.21414,4311040
14084,adamtulinius,3,0.00007,3932281,91.21421,4311040
14085,addprs,3,0.00007,3932284,91.21428,4311040
14086,adityassharma-ss,3,0.00007,3932287,91.21435,4311040
14087,ad-m,3,0.00007,3932290,91.21442,4311040
14088,Adracus,3,0.00007,3932293,91.21449,4311040
14089,AdriaGS,3,0.00007,3932296,91.21456,4311040
14090,adrianfdez469,3,0.00007,3932299,91.21463,4311040
14091,adriangb,3,0.00007,3932302,91.21470,4311040
14092,adusumillipraveen,3,0.00007,3932305,91.21476,4311040
14093,adymitruk,3,0.00007,3932308,91.21483,4311040
14094,aeneaswiener,3,0.00007,3932311,91.21490,4311040
14095,afalko,3,0.00007,3932314,91.21497,4311040
14096,afewell,3,0.00007,3932317,91.21504,4311040
14097,afong94,3,0.00007,3932320,91.21511,4311040
14098,agaffney,3,0.00007,3932323,91.21518,4311040
14099,agilinsky,3,0.00007,3932326,91.21525,4311040
14100,agramner,3,0.00007,3932329,91.21532,4311040
14101,ahharu,3,0.00007,3932332,91.21539,4311040
14102,Ahmad-Faizan,3,0.00007,3932335,91.21546,4311040
14103,ahmet-uyar,3,0.00007,3932338,91.21553,4311040
14104,ahojcn,3,0.00007,3932341,91.21560,4311040
14105,aidan-og,3,0.00007,3932344,91.21567,4311040
14106,ajessup,3,0.00007,3932347,91.21574,4311040
14107,akafazov,3,0.00007,3932350,91.21581,4311040
14108,AKarbas,3,0.00007,3932353,91.21588,4311040
14109,akashjain971,3,0.00007,3932356,91.21595,4311040
14110,akash-yadagouda,3,0.00007,3932359,91.21602,4311040
14111,akharlamov,3,0.00007,3932362,91.21609,4311040
14112,akhfa,3,0.00007,3932365,91.21616,4311040
14113,akieling,3,0.00007,3932368,91.21623,4311040
14114,akozichev,3,0.00007,3932371,91.21630,4311040
14115,akramer,3,0.00007,3932374,91.21637,4311040
14116,AkselAllas,3,0.00007,3932377,91.21644,4311040
14117,akshaypatidar1999,3,0.00007,3932380,91.21650,4311040
14118,Alan-Cha,3,0.00007,3932383,91.21657,4311040
14119,alanprot,3,0.00007,3932386,91.21664,4311040
14120,albertmichaelj,3,0.00007,3932389,91.21671,4311040
14121,albertoleal,3,0.00007,3932392,91.21678,4311040
14122,albertomilan,3,0.00007,3932395,91.21685,4311040
14123,albertteoh,3,0.00007,3932398,91.21692,4311040
14124,alecmerdler,3,0.00007,3932401,91.21699,4311040
14125,alecrajeev,3,0.00007,3932404,91.21706,4311040
14126,AlexDHoffer,3,0.00007,3932407,91.21713,4311040
14127,alexey-gavrilov-flant,3,0.00007,3932410,91.21720,4311040
14128,alexlatchford,3,0.00007,3932413,91.21727,4311040
14129,AlexMuresan,3,0.00007,3932416,91.21734,4311040
14130,alexvaque,3,0.00007,3932419,91.21741,4311040
14131,alex-vlasov,3,0.00007,3932422,91.21748,4311040
14132,alexzhc,3,0.00007,3932425,91.21755,4311040
14133,AlfonsoCiampaNTT,3,0.00007,3932428,91.21762,4311040
14134,alfonso-presa,3,0.00007,3932431,91.21769,4311040
14135,alin-amana,3,0.00007,3932434,91.21776,4311040
14136,alinoaimi,3,0.00007,3932437,91.21783,4311040
14137,alistarle,3,0.00007,3932440,91.21790,4311040
14138,allancaffee,3,0.00007,3932443,91.21797,4311040
14139,allandegnan,3,0.00007,3932446,91.21804,4311040
14140,allcentury,3,0.00007,3932449,91.21811,4311040
14141,Allenhaozi,3,0.00007,3932452,91.21817,4311040
14142,allenmiller,3,0.00007,3932455,91.21824,4311040
14143,alonbl,3,0.00007,3932458,91.21831,4311040
14144,alonSadan,3,0.00007,3932461,91.21838,4311040
14145,Alos,3,0.00007,3932464,91.21845,4311040
14146,amalagaura,3,0.00007,3932467,91.21852,4311040
14147,amandadebler,3,0.00007,3932470,91.21859,4311040
14148,amarlearning,3,0.00007,3932473,91.21866,4311040
14149,amincheloh,3,0.00007,3932476,91.21873,4311040
14150,amitkrishna,3,0.00007,3932479,91.21880,4311040
14151,amitsehgal,3,0.00007,3932482,91.21887,4311040
14152,Amyth07,3,0.00007,3932485,91.21894,4311040
14153,anakaiti,3,0.00007,3932488,91.21901,4311040
14154,anastazya,3,0.00007,3932491,91.21908,4311040
14155,and3rson,3,0.00007,3932494,91.21915,4311040
14156,AndersBennedsgaard,3,0.00007,3932497,91.21922,4311040
14157,andre2007,3,0.00007,3932500,91.21929,4311040
14158,andreas-ibm,3,0.00007,3932503,91.21936,4311040
14159,andredasilvapinto,3,0.00007,3932506,91.21943,4311040
14160,andreialecu,3,0.00007,3932509,91.21950,4311040
14161,andrelop,3,0.00007,3932512,91.21957,4311040
14162,andrew-jones,3,0.00007,3932515,91.21964,4311040
14163,andrewmchen,3,0.00007,3932518,91.21971,4311040
14164,andrewnazarov,3,0.00007,3932521,91.21978,4311040
14165,andrewward,3,0.00007,3932524,91.21984,4311040
14166,AndriiNeverov,3,0.00007,3932527,91.21991,4311040
14167,andy-kimball,3,0.00007,3932530,91.21998,4311040
14168,andypost,3,0.00007,3932533,91.22005,4311040
14169,andysworkshop,3,0.00007,3932536,91.22012,4311040
14170,aniketdivekar,3,0.00007,3932539,91.22019,4311040
14171,aniketsingh03,3,0.00007,3932542,91.22026,4311040
14172,anirudhmurali,3,0.00007,3932545,91.22033,4311040
14173,Anita-ihuman,3,0.00007,3932548,91.22040,4311040
14174,Anosh21,3,0.00007,3932551,91.22047,4311040
14175,anravi,3,0.00007,3932554,91.22054,4311040
14176,anthonyalayo,3,0.00007,3932557,91.22061,4311040
14177,antweiss,3,0.00007,3932560,91.22068,4311040
14178,anwather,3,0.00007,3932563,91.22075,4311040
14179,apetrovYa,3,0.00007,3932566,91.22082,4311040
14180,arashkaffamanesh,3,0.00007,3932569,91.22089,4311040
14181,arianf,3,0.00007,3932572,91.22096,4311040
14182,ArieShout,3,0.00007,3932575,91.22103,4311040
14183,arikbidny,3,0.00007,3932578,91.22110,4311040
14184,arlando,3,0.00007,3932581,91.22117,4311040
14185,armandmcqueen,3,0.00007,3932584,91.22124,4311040
14186,arminc,3,0.00007,3932587,91.22131,4311040
14187,arnaldopereira,3,0.00007,3932590,91.22138,4311040
14188,arnd,3,0.00007,3932593,91.22145,4311040
14189,arslanbekov,3,0.00007,3932596,91.22151,4311040
14190,artem-shorokhov,3,0.00007,3932599,91.22158,4311040
14191,artheus,3,0.00007,3932602,91.22165,4311040
14192,arthur-c,3,0.00007,3932605,91.22172,4311040
14193,arun11299,3,0.00007,3932608,91.22179,4311040
14194,arykalin,3,0.00007,3932611,91.22186,4311040
14195,asampal,3,0.00007,3932614,91.22193,4311040
14196,ASAPHAANING,3,0.00007,3932617,91.22200,4311040
14197,asaushkin,3,0.00007,3932620,91.22207,4311040
14198,asavaritayal,3,0.00007,3932623,91.22214,4311040
14199,ashiquzzaman33,3,0.00007,3932626,91.22221,4311040
14200,ashish235,3,0.00007,3932629,91.22228,4311040
14201,ashlineldridge,3,0.00007,3932632,91.22235,4311040
14202,ashwanth1109,3,0.00007,3932635,91.22242,4311040
14203,ashwinpagarkhed,3,0.00007,3932638,91.22249,4311040
14204,asincu,3,0.00007,3932641,91.22256,4311040
14205,asiragusa,3,0.00007,3932644,91.22263,4311040
14206,askcarter,3,0.00007,3932647,91.22270,4311040
14207,askhalil,3,0.00007,3932650,91.22277,4311040
14208,asnowfix,3,0.00007,3932653,91.22284,4311040
14209,AsterYujano,3,0.00007,3932656,91.22291,4311040
14210,astronaut0131,3,0.00007,3932659,91.22298,4311040
14211,astub,3,0.00007,3932662,91.22305,4311040
14212,asubmani,3,0.00007,3932665,91.22312,4311040
14213,athampy,3,0.00007,3932668,91.22319,4311040
14214,atkuzmanov,3,0.00007,3932671,91.22325,4311040
14215,atrauzzi,3,0.00007,3932674,91.22332,4311040
14216,aure-olli,3,0.00007,3932677,91.22339,4311040
14217,austinwheelock,3,0.00007,3932680,91.22346,4311040
14218,autodidaddict,3,0.00007,3932683,91.22353,4311040
14219,AutonomicMattRoy,3,0.00007,3932686,91.22360,4311040
14220,autopp,3,0.00007,3932689,91.22367,4311040
14221,avasquez614,3,0.00007,3932692,91.22374,4311040
14222,aven-ai,3,0.00007,3932695,91.22381,4311040
14223,avinal,3,0.00007,3932698,91.22388,4311040
14224,avivgold098,3,0.00007,3932701,91.22395,4311040
14225,aviweit,3,0.00007,3932704,91.22402,4311040
14226,aweis89,3,0.00007,3932707,91.22409,4311040
14227,awwithro,3,0.00007,3932710,91.22416,4311040
14228,axdotl,3,0.00007,3932713,91.22423,4311040
14229,axelsimon,3,0.00007,3932716,91.22430,4311040
14230,axeltanxl,3,0.00007,3932719,91.22437,4311040
14231,ayesha-kr,3,0.00007,3932722,91.22444,4311040
14232,azakrzewski,3,0.00007,3932725,91.22451,4311040
14233,azarezade,3,0.00007,3932728,91.22458,4311040
14234,azerbe,3,0.00007,3932731,91.22465,4311040
14235,b2cbre,3,0.00007,3932734,91.22472,4311040
14236,baelish,3,0.00007,3932737,91.22479,4311040
14237,Baitanik,3,0.00007,3932740,91.22486,4311040
14238,bakayolo,3,0.00007,3932743,91.22492,4311040
14239,Banchio,3,0.00007,3932746,91.22499,4311040
14240,barryzhounb,3,0.00007,3932749,91.22506,4311040
14241,barthoda,3,0.00007,3932752,91.22513,4311040
14242,bartonjs,3,0.00007,3932755,91.22520,4311040
14243,basilisk487,3,0.00007,3932758,91.22527,4311040
14244,BastienL,3,0.00007,3932761,91.22534,4311040
14245,BastienM,3,0.00007,3932764,91.22541,4311040
14246,BbolroC,3,0.00007,3932767,91.22548,4311040
14247,bbroniewski,3,0.00007,3932770,91.22555,4311040
14248,bbruun,3,0.00007,3932773,91.22562,4311040
14249,bcdurden,3,0.00007,3932776,91.22569,4311040
14250,bdangit,3,0.00007,3932779,91.22576,4311040
14251,b-dean,3,0.00007,3932782,91.22583,4311040
14252,bdevloed,3,0.00007,3932785,91.22590,4311040
14253,beilber,3,0.00007,3932788,91.22597,4311040
14254,benaskikutis,3,0.00007,3932791,91.22604,4311040
14255,BenderV,3,0.00007,3932794,91.22611,4311040
14256,bendory,3,0.00007,3932797,91.22618,4311040
14257,benjamingorman,3,0.00007,3932800,91.22625,4311040
14258,benjick,3,0.00007,3932803,91.22632,4311040
14259,benoist,3,0.00007,3932806,91.22639,4311040
14260,benoittgt,3,0.00007,3932809,91.22646,4311040
14261,BenPope,3,0.00007,3932812,91.22653,4311040
14262,benvdh,3,0.00007,3932815,91.22659,4311040
14263,bertux,3,0.00007,3932818,91.22666,4311040
14264,bhaweshintouch,3,0.00007,3932821,91.22673,4311040
14265,bilalx20,3,0.00007,3932824,91.22680,4311040
14266,Billy99,3,0.00007,3932827,91.22687,4311040
14267,BingGuanqi,3,0.00007,3932830,91.22694,4311040
14268,birdayz,3,0.00007,3932833,91.22701,4311040
14269,bitzhuxb,3,0.00007,3932836,91.22708,4311040
14270,bjrowlett2,3,0.00007,3932839,91.22715,4311040
14271,bkleef,3,0.00007,3932842,91.22722,4311040
14272,bkmeneguello,3,0.00007,3932845,91.22729,4311040
14273,blachniet,3,0.00007,3932848,91.22736,4311040
14274,blacs30,3,0.00007,3932851,91.22743,4311040
14275,blankenhaus,3,0.00007,3932854,91.22750,4311040
14276,blisscs,3,0.00007,3932857,91.22757,4311040
14277,bluenote10,3,0.00007,3932860,91.22764,4311040
14278,b-luu,3,0.00007,3932863,91.22771,4311040
14279,Boca13,3,0.00007,3932866,91.22778,4311040
14280,BogdanSorlea,3,0.00007,3932869,91.22785,4311040
14281,Boriszn,3,0.00007,3932872,91.22792,4311040
14282,BorntraegerMarc,3,0.00007,3932875,91.22799,4311040
14283,boucher,3,0.00007,3932878,91.22806,4311040
14284,Bouncey,3,0.00007,3932881,91.22813,4311040
14285,Bowser1704,3,0.00007,3932884,91.22820,4311040
14286,bporter2387,3,0.00007,3932887,91.22827,4311040
14287,brackendawson,3,0.00007,3932890,91.22833,4311040
14288,bradbeck,3,0.00007,3932893,91.22840,4311040
14289,braxtone,3,0.00007,3932896,91.22847,4311040
14290,brenarth,3,0.00007,3932899,91.22854,4311040
14291,BrentonWatt,3,0.00007,3932902,91.22861,4311040
14292,breun,3,0.00007,3932905,91.22868,4311040
14293,brf153,3,0.00007,3932908,91.22875,4311040
14294,brianstorti,3,0.00007,3932911,91.22882,4311040
14295,bricksky,3,0.00007,3932914,91.22889,4311040
14296,brondum,3,0.00007,3932917,91.22896,4311040
14297,browningjp,3,0.00007,3932920,91.22903,4311040
14298,bruno-garcia,3,0.00007,3932923,91.22910,4311040
14299,bryankaraffa,3,0.00007,3932926,91.22917,4311040
14300,bsmith1180,3,0.00007,3932929,91.22924,4311040
14301,bspaans,3,0.00007,3932932,91.22931,4311040
14302,burdandrei,3,0.00007,3932935,91.22938,4311040
14303,buzzy,3,0.00007,3932938,91.22945,4311040
14304,c10l,3,0.00007,3932941,91.22952,4311040
14305,cabiad,3,0.00007,3932944,91.22959,4311040
14306,caike,3,0.00007,3932947,91.22966,4311040
14307,cakuros,3,0.00007,3932950,91.22973,4311040
14308,Callek,3,0.00007,3932953,91.22980,4311040
14309,camartinez04,3,0.00007,3932956,91.22987,4311040
14310,caogj,3,0.00007,3932959,91.22994,4311040
14311,caoyukun0430,3,0.00007,3932962,91.23000,4311040
14312,CapOM,3,0.00007,3932965,91.23007,4311040
14313,caretak3r,3,0.00007,3932968,91.23014,4311040
14314,carlocorradini,3,0.00007,3932971,91.23021,4311040
14315,carloscastrojumo,3,0.00007,3932974,91.23028,4311040
14316,carrodher,3,0.00007,3932977,91.23035,4311040
14317,casiodk,3,0.00007,3932980,91.23042,4311040
14318,CastixGitHub,3,0.00007,3932983,91.23049,4311040
14319,cbcoutinho,3,0.00007,3932986,91.23056,4311040
14320,cbeneke,3,0.00007,3932989,91.23063,4311040
14321,cbl315,3,0.00007,3932992,91.23070,4311040
14322,ccl0326,3,0.00007,3932995,91.23077,4311040
14323,cdchris12,3,0.00007,3932998,91.23084,4311040
14324,cdoan1,3,0.00007,3933001,91.23091,4311040
14325,ceich,3,0.00007,3933004,91.23098,4311040
14326,cfontes,3,0.00007,3933007,91.23105,4311040
14327,cfregly,3,0.00007,3933010,91.23112,4311040
14328,cfreiner,3,0.00007,3933013,91.23119,4311040
14329,cguertin14,3,0.00007,3933016,91.23126,4311040
14330,cgurnik,3,0.00007,3933019,91.23133,4311040
14331,chadell,3,0.00007,3933022,91.23140,4311040
14332,chaitanyabisht,3,0.00007,3933025,91.23147,4311040
14333,Champ-Goblem,3,0.00007,3933028,91.23154,4311040
14334,chandresh-pancholi,3,0.00007,3933031,91.23161,4311040
14335,chaospuppy,3,0.00007,3933034,91.23167,4311040
14336,charlesakalugwu,3,0.00007,3933037,91.23174,4311040
14337,Charles-Johnson,3,0.00007,3933040,91.23181,4311040
14338,charpty,3,0.00007,3933043,91.23188,4311040
14339,chartotu19,3,0.00007,3933046,91.23195,4311040
14340,chauhanshubham,3,0.00007,3933049,91.23202,4311040
14341,chazapis,3,0.00007,3933052,91.23209,4311040
14342,checkaayush,3,0.00007,3933055,91.23216,4311040
14343,cheddarwhizzy,3,0.00007,3933058,91.23223,4311040
14344,chenyb4,3,0.00007,3933061,91.23230,4311040
14345,chicco785,3,0.00007,3933064,91.23237,4311040
14346,ChihiroKitada,3,0.00007,3933067,91.23244,4311040
14347,chinmay22897,3,0.00007,3933070,91.23251,4311040
14348,cholcombe973,3,0.00007,3933073,91.23258,4311040
14349,ChristianAlexander,3,0.00007,3933076,91.23265,4311040
14350,chriwill,3,0.00007,3933079,91.23272,4311040
14351,Cidan,3,0.00007,3933082,91.23279,4311040
14352,Ciello89,3,0.00007,3933085,91.23286,4311040
14353,cieni,3,0.00007,3933088,91.23293,4311040
14354,cimnine,3,0.00007,3933091,91.23300,4311040
14355,cjdcordeiro,3,0.00007,3933094,91.23307,4311040
14356,cjdrake,3,0.00007,3933097,91.23314,4311040
14357,cjoprey,3,0.00007,3933100,91.23321,4311040
14358,ckross01,3,0.00007,3933103,91.23328,4311040
14359,clarenceb,3,0.00007,3933106,91.23335,4311040
14360,ClementGautier,3,0.00007,3933109,91.23341,4311040
14361,cloudties,3,0.00007,3933112,91.23348,4311040
14362,cmaloney,3,0.00007,3933115,91.23355,4311040
14363,cmoore15,3,0.00007,3933118,91.23362,4311040
14364,cneijenhuis,3,0.00007,3933121,91.23369,4311040
14365,codeboten,3,0.00007,3933124,91.23376,4311040
14366,codepitbull,3,0.00007,3933127,91.23383,4311040
14367,CodingFabian,3,0.00007,3933130,91.23390,4311040
14368,codyaray,3,0.00007,3933133,91.23397,4311040
14369,codyoss,3,0.00007,3933136,91.23404,4311040
14370,ColinHebert,3,0.00007,3933139,91.23411,4311040
14371,colmm99,3,0.00007,3933142,91.23418,4311040
14372,coltonmorris,3,0.00007,3933145,91.23425,4311040
14373,corburn,3,0.00007,3933148,91.23432,4311040
14374,coreywagehoft,3,0.00007,3933151,91.23439,4311040
14375,CoRfr,3,0.00007,3933154,91.23446,4311040
14376,cp1408,3,0.00007,3933157,91.23453,4311040
14377,cptaffe,3,0.00007,3933160,91.23460,4311040
14378,creativcoder,3,0.00007,3933163,91.23467,4311040
14379,crhuber,3,0.00007,3933166,91.23474,4311040
14380,cruisehall,3,0.00007,3933169,91.23481,4311040
14381,csams,3,0.00007,3933172,91.23488,4311040
14382,csmarchbanks,3,0.00007,3933175,91.23495,4311040
14383,ctab,3,0.00007,3933178,91.23502,4311040
14384,cwchoe,3,0.00007,3933181,91.23508,4311040
14385,cwen0,3,0.00007,3933184,91.23515,4311040
14386,cwitte4191,3,0.00007,3933187,91.23522,4311040
14387,cwoolum,3,0.00007,3933190,91.23529,4311040
14388,cwpenhale,3,0.00007,3933193,91.23536,4311040
14389,Cyanopus,3,0.00007,3933196,91.23543,4311040
14390,Cytrian,3,0.00007,3933199,91.23550,4311040
14391,dadadom,3,0.00007,3933202,91.23557,4311040
14392,dailyherold,3,0.00007,3933205,91.23564,4311040
14393,DakshMiglani,3,0.00007,3933208,91.23571,4311040
14394,damascenorakuten,3,0.00007,3933211,91.23578,4311040
14395,damianobarbati,3,0.00007,3933214,91.23585,4311040
14396,damomurf,3,0.00007,3933217,91.23592,4311040
14397,damora,3,0.00007,3933220,91.23599,4311040
14398,DanCech,3,0.00007,3933223,91.23606,4311040
14399,dani07,3,0.00007,3933226,91.23613,4311040
14400,DANic-git,3,0.00007,3933229,91.23620,4311040
14401,DanielClaudeBaeriswyl,3,0.00007,3933232,91.23627,4311040
14402,danielmotaleite,3,0.00007,3933235,91.23634,4311040
14403,danielpops,3,0.00007,3933238,91.23641,4311040
14404,danisla,3,0.00007,3933241,91.23648,4311040
14405,DanLipsitt,3,0.00007,3933244,91.23655,4311040
14406,danp,3,0.00007,3933247,91.23662,4311040
14407,danpawlik,3,0.00007,3933250,91.23669,4311040
14408,DanTulovsky,3,0.00007,3933253,91.23675,4311040
14409,darren-bell-nanthealth,3,0.00007,3933256,91.23682,4311040
14410,darren-mcdonald,3,0.00007,3933259,91.23689,4311040
14411,davidandreoletti,3,0.00007,3933262,91.23696,4311040
14412,david-dumas,3,0.00007,3933265,91.23703,4311040
14413,davidghiurco,3,0.00007,3933268,91.23710,4311040
14414,DavidObando,3,0.00007,3933271,91.23717,4311040
14415,davidvanlaatum,3,0.00007,3933274,91.23724,4311040
14416,daxtens,3,0.00007,3933277,91.23731,4311040
14417,day112,3,0.00007,3933280,91.23738,4311040
14418,dayglojesus,3,0.00007,3933283,91.23745,4311040
14419,dcberg,3,0.00007,3933286,91.23752,4311040
14420,dciccale,3,0.00007,3933289,91.23759,4311040
14421,dctrwatson,3,0.00007,3933292,91.23766,4311040
14422,ddmunhoz,3,0.00007,3933295,91.23773,4311040
14423,deaquino,3,0.00007,3933298,91.23780,4311040
14424,deathgaze,3,0.00007,3933301,91.23787,4311040
14425,deftdawg,3,0.00007,3933304,91.23794,4311040
14426,defunctzombie,3,0.00007,3933307,91.23801,4311040
14427,delapsley,3,0.00007,3933310,91.23808,4311040
14428,dellkeji,3,0.00007,3933313,91.23815,4311040
14429,demohi,3,0.00007,3933316,91.23822,4311040
14430,denisvmedia,3,0.00007,3933319,91.23829,4311040
14431,DennisVis,3,0.00007,3933322,91.23836,4311040
14432,dennisxrow,3,0.00007,3933325,91.23843,4311040
14433,denysvitali,3,0.00007,3933328,91.23849,4311040
14434,depohmel,3,0.00007,3933331,91.23856,4311040
14435,derbeneviv,3,0.00007,3933334,91.23863,4311040
14436,derdanne,3,0.00007,3933337,91.23870,4311040
14437,Detoxify92,3,0.00007,3933340,91.23877,4311040
14438,detro,3,0.00007,3933343,91.23884,4311040
14439,DevipriyaSarkar,3,0.00007,3933346,91.23891,4311040
14440,dewjam,3,0.00007,3933349,91.23898,4311040
14441,dfarr,3,0.00007,3933352,91.23905,4311040
14442,dgeorgievski,3,0.00007,3933355,91.23912,4311040
14443,dgoscn,3,0.00007,3933358,91.23919,4311040
14444,dheerajgss,3,0.00007,3933361,91.23926,4311040
14445,dhensen,3,0.00007,3933364,91.23933,4311040
14446,digitalsanctum,3,0.00007,3933367,91.23940,4311040
14447,dijeesh,3,0.00007,3933370,91.23947,4311040
14448,diogonicoleti,3,0.00007,3933373,91.23954,4311040
14449,DirtyCajunRice,3,0.00007,3933376,91.23961,4311040
14450,dirtycajunrice1,3,0.00007,3933379,91.23968,4311040
14451,djmitche,3,0.00007,3933382,91.23975,4311040
14452,djtaylor,3,0.00007,3933385,91.23982,4311040
14453,dj-wasabi,3,0.00007,3933388,91.23989,4311040
14454,dkapanidis,3,0.00007,3933391,91.23996,4311040
14455,dkravetz,3,0.00007,3933394,91.24003,4311040
14456,dmccaffery,3,0.00007,3933397,91.24010,4311040
14457,dmetzler,3,0.00007,3933400,91.24016,4311040
14458,dmilind,3,0.00007,3933403,91.24023,4311040
14459,dns2utf8,3,0.00007,3933406,91.24030,4311040
14460,docent-net,3,0.00007,3933409,91.24037,4311040
14461,doctornkz,3,0.00007,3933412,91.24044,4311040
14462,domhauton,3,0.00007,3933415,91.24051,4311040
14463,dominikhahn,3,0.00007,3933418,91.24058,4311040
14464,doriordan,3,0.00007,3933421,91.24065,4311040
14465,doroncarmeli,3,0.00007,3933424,91.24072,4311040
14466,doschkinow,3,0.00007,3933427,91.24079,4311040
14467,dosten,3,0.00007,3933430,91.24086,4311040
14468,douglarek,3,0.00007,3933433,91.24093,4311040
14469,Downchuck,3,0.00007,3933436,91.24100,4311040
14470,dperny,3,0.00007,3933439,91.24107,4311040
14471,dpifke,3,0.00007,3933442,91.24114,4311040
14472,droger88,3,0.00007,3933445,91.24121,4311040
14473,drohnow,3,0.00007,3933448,91.24128,4311040
14474,drymonsoon,3,0.00007,3933451,91.24135,4311040
14475,dsandersAzure,3,0.00007,3933454,91.24142,4311040
14476,dsiebel,3,0.00007,3933457,91.24149,4311040
14477,dthaler,3,0.00007,3933460,91.24156,4311040
14478,dthomason,3,0.00007,3933463,91.24163,4311040
14479,dttung2905,3,0.00007,3933466,91.24170,4311040
14480,duhow,3,0.00007,3933469,91.24177,4311040
14481,dustinmoris,3,0.00007,3933472,91.24183,4311040
14482,dvic,3,0.00007,3933475,91.24190,4311040
14483,dvob,3,0.00007,3933478,91.24197,4311040
14484,dvoytik,3,0.00007,3933481,91.24204,4311040
14485,dweidenfeld,3,0.00007,3933484,91.24211,4311040
14486,ecejjar,3,0.00007,3933487,91.24218,4311040
14487,EdDev,3,0.00007,3933490,91.24225,4311040
14488,ede-n,3,0.00007,3933493,91.24232,4311040
14489,edewit,3,0.00007,3933496,91.24239,4311040
14490,edrickwong,3,0.00007,3933499,91.24246,4311040
14491,eduardolundgren,3,0.00007,3933502,91.24253,4311040
14492,eiais,3,0.00007,3933505,91.24260,4311040
14493,ekapratama93,3,0.00007,3933508,91.24267,4311040
14494,ekristen,3,0.00007,3933511,91.24274,4311040
14495,Elassyo,3,0.00007,3933514,91.24281,4311040
14496,elek,3,0.00007,3933517,91.24288,4311040
14497,EliasICerezo,3,0.00007,3933520,91.24295,4311040
14498,elieser1101,3,0.00007,3933523,91.24302,4311040
14499,elijah-roberts,3,0.00007,3933526,91.24309,4311040
14500,emadolsky,3,0.00007,3933529,91.24316,4311040
14501,EmbeddedAndroid,3,0.00007,3933532,91.24323,4311040
14502,EmilyNamugaanyi,3,0.00007,3933535,91.24330,4311040
14503,endorama,3,0.00007,3933538,91.24337,4311040
14504,envintus,3,0.00007,3933541,91.24344,4311040
14505,Ephemera,3,0.00007,3933544,91.24351,4311040
14506,Eraac,3,0.00007,3933547,91.24357,4311040
14507,erezo9,3,0.00007,3933550,91.24364,4311040
14508,ericelliott,3,0.00007,3933553,91.24371,4311040
14509,ericis,3,0.00007,3933556,91.24378,4311040
14510,ericstoekl,3,0.00007,3933559,91.24385,4311040
14511,ericvale0128,3,0.00007,3933562,91.24392,4311040
14512,erikus,3,0.00007,3933565,91.24399,4311040
14513,erkanzileli,3,0.00007,3933568,91.24406,4311040
14514,Eslamanwar,3,0.00007,3933571,91.24413,4311040
14515,eslam-gomaa,3,0.00007,3933574,91.24420,4311040
14516,EsrefDurna,3,0.00007,3933577,91.24427,4311040
14517,etharendil,3,0.00007,3933580,91.24434,4311040
14518,ethercflow,3,0.00007,3933583,91.24441,4311040
14519,evanlucas,3,0.00007,3933586,91.24448,4311040
14520,evolvah,3,0.00007,3933589,91.24455,4311040
14521,f4tq,3,0.00007,3933592,91.24462,4311040
14522,faascape,3,0.00007,3933595,91.24469,4311040
14523,faceair,3,0.00007,3933598,91.24476,4311040
14524,famousgarkin,3,0.00007,3933601,91.24483,4311040
14525,fangyuanziti,3,0.00007,3933604,91.24490,4311040
14526,fangzhen,3,0.00007,3933607,91.24497,4311040
14527,farrajota,3,0.00007,3933610,91.24504,4311040
14528,fcrisciani,3,0.00007,3933613,91.24511,4311040
14529,federicopires,3,0.00007,3933616,91.24518,4311040
14530,FelixRodriguezJara,3,0.00007,3933619,91.24524,4311040
14531,felixtran39,3,0.00007,3933622,91.24531,4311040
14532,fethiozdol,3,0.00007,3933625,91.24538,4311040
14533,fghaas,3,0.00007,3933628,91.24545,4311040
14534,Fkawala,3,0.00007,3933631,91.24552,4311040
14535,florianflock,3,0.00007,3933634,91.24559,4311040
14536,florianl,3,0.00007,3933637,91.24566,4311040
14537,florianstoeber,3,0.00007,3933640,91.24573,4311040
14538,flybyray,3,0.00007,3933643,91.24580,4311040
14539,fpytloun,3,0.00007,3933646,91.24587,4311040
14540,fragatina,3,0.00007,3933649,91.24594,4311040
14541,frankieleef,3,0.00007,3933652,91.24601,4311040
14542,franklevering,3,0.00007,3933655,91.24608,4311040
14543,FrankYu,3,0.00007,3933658,91.24615,4311040
14544,FredM,3,0.00007,3933661,91.24622,4311040
14545,fredthomsen,3,0.00007,3933664,91.24629,4311040
14546,freeekanayaka,3,0.00007,3933667,91.24636,4311040
14547,frewsxcv,3,0.00007,3933670,91.24643,4311040
14548,fsniper,3,0.00007,3933673,91.24650,4311040
14549,furykerry,3,0.00007,3933676,91.24657,4311040
14550,fuzails,3,0.00007,3933679,91.24664,4311040
14551,gabrfarina,3,0.00007,3933682,91.24671,4311040
14552,gabriel-farache,3,0.00007,3933685,91.24678,4311040
14553,gabrielpjordao,3,0.00007,3933688,91.24685,4311040
14554,Gallardot,3,0.00007,3933691,91.24691,4311040
14555,garganubhav,3,0.00007,3933694,91.24698,4311040
14556,gatoruso,3,0.00007,3933697,91.24705,4311040
14557,gawsoftpl,3,0.00007,3933700,91.24712,4311040
14558,Gazler,3,0.00007,3933703,91.24719,4311040
14559,gdscei,3,0.00007,3933706,91.24726,4311040
14560,geekard,3,0.00007,3933709,91.24733,4311040
14561,genebean,3,0.00007,3933712,91.24740,4311040
14562,genehand,3,0.00007,3933715,91.24747,4311040
14563,geoffhendrey,3,0.00007,3933718,91.24754,4311040
14564,georgegoh,3,0.00007,3933721,91.24761,4311040
14565,ggjjlldd,3,0.00007,3933724,91.24768,4311040
14566,gileshinchcliff,3,0.00007,3933727,91.24775,4311040
14567,gillesdemey,3,0.00007,3933730,91.24782,4311040
14568,gj199575,3,0.00007,3933733,91.24789,4311040
14569,gjtorikian,3,0.00007,3933736,91.24796,4311040
14570,gkumar7,3,0.00007,3933739,91.24803,4311040
14571,glarrain,3,0.00007,3933742,91.24810,4311040
14572,gmacario,3,0.00007,3933745,91.24817,4311040
14573,goku321,3,0.00007,3933748,91.24824,4311040
14574,GolubevV,3,0.00007,3933751,91.24831,4311040
14575,gorkem,3,0.00007,3933754,91.24838,4311040
14576,gorozcoh,3,0.00007,3933757,91.24845,4311040
14577,graingert,3,0.00007,3933760,91.24852,4311040
14578,GraysonNull,3,0.00007,3933763,91.24859,4311040
14579,grillz,3,0.00007,3933766,91.24865,4311040
14580,gtmtech,3,0.00007,3933769,91.24872,4311040
14581,gun082544,3,0.00007,3933772,91.24879,4311040
14582,gunboe,3,0.00007,3933775,91.24886,4311040
14583,guoyunxian,3,0.00007,3933778,91.24893,4311040
14584,guyzyl,3,0.00007,3933781,91.24900,4311040
14585,GWCLBN,3,0.00007,3933784,91.24907,4311040
14586,Haegi,3,0.00007,3933787,91.24914,4311040
14587,haf-tech,3,0.00007,3933790,91.24921,4311040
14588,hagbard5235,3,0.00007,3933793,91.24928,4311040
14589,hairmare,3,0.00007,3933796,91.24935,4311040
14590,hamid-elaosta,3,0.00007,3933799,91.24942,4311040
14591,hamidsafdari,3,0.00007,3933802,91.24949,4311040
14592,han-so1omon,3,0.00007,3933805,91.24956,4311040
14593,HarleyB123,3,0.00007,3933808,91.24963,4311040
14594,harshad16,3,0.00007,3933811,91.24970,4311040
14595,HartS,3,0.00007,3933814,91.24977,4311040
14596,hasanatkazmi,3,0.00007,3933817,91.24984,4311040
14597,hatchan,3,0.00007,3933820,91.24991,4311040
14598,heidsoft,3,0.00007,3933823,91.24998,4311040
14599,hekra01,3,0.00007,3933826,91.25005,4311040
14600,hello2dj,3,0.00007,3933829,91.25012,4311040
14601,henninge,3,0.00007,3933832,91.25019,4311040
14602,henrikhodne,3,0.00007,3933835,91.25026,4311040
14603,herbrandson,3,0.00007,3933838,91.25032,4311040
14604,hgomez,3,0.00007,3933841,91.25039,4311040
14605,hilliao,3,0.00007,3933844,91.25046,4311040
14606,himanshuDevopsGuy,3,0.00007,3933847,91.25053,4311040
14607,Hitesh-Agrawal,3,0.00007,3933850,91.25060,4311040
14608,hiteshghia,3,0.00007,3933853,91.25067,4311040
14609,hitman99,3,0.00007,3933856,91.25074,4311040
14610,hlubek,3,0.00007,3933859,91.25081,4311040
14611,hmizael,3,0.00007,3933862,91.25088,4311040
14612,hongliangl,3,0.00007,3933865,91.25095,4311040
14613,hongshaoyang,3,0.00007,3933868,91.25102,4311040
14614,hopper-signifyd,3,0.00007,3933871,91.25109,4311040
14615,hosungsmsft,3,0.00007,3933874,91.25116,4311040
14616,huangtianhua,3,0.00007,3933877,91.25123,4311040
14617,huegelc,3,0.00007,3933880,91.25130,4311040
14618,hughes20,3,0.00007,3933883,91.25137,4311040
14619,hunterloftis,3,0.00007,3933886,91.25144,4311040
14620,Hunter-Thompson,3,0.00007,3933889,91.25151,4311040
14621,hurdonkey,3,0.00007,3933892,91.25158,4311040
14622,hw-claudio,3,0.00007,3933895,91.25165,4311040
14623,hwk42,3,0.00007,3933898,91.25172,4311040
14624,hypnoce,3,0.00007,3933901,91.25179,4311040
14625,i0n,3,0.00007,3933904,91.25186,4311040
14626,iamkirkbater,3,0.00007,3933907,91.25193,4311040
14627,iam-merlin,3,0.00007,3933910,91.25199,4311040
14628,iamrajiv,3,0.00007,3933913,91.25206,4311040
14629,iamwillbar,3,0.00007,3933916,91.25213,4311040
14630,iblancasa,3,0.00007,3933919,91.25220,4311040
14631,igaskin,3,0.00007,3933922,91.25227,4311040
14632,iggyzap,3,0.00007,3933925,91.25234,4311040
14633,igorpalant,3,0.00007,3933928,91.25241,4311040
14634,iHile,3,0.00007,3933931,91.25248,4311040
14635,iliastsi,3,0.00007,3933934,91.25255,4311040
14636,illagrenan,3,0.00007,3933937,91.25262,4311040
14637,imazik,3,0.00007,3933940,91.25269,4311040
14638,iMelnik,3,0.00007,3933943,91.25276,4311040
14639,indera-shsp,3,0.00007,3933946,91.25283,4311040
14640,indreshmishra,3,0.00007,3933949,91.25290,4311040
14641,ingenthr,3,0.00007,3933952,91.25297,4311040
14642,ingvarm-gr,3,0.00007,3933955,91.25304,4311040
14643,invertigo,3,0.00007,3933958,91.25311,4311040
14644,irabinovitch,3,0.00007,3933961,91.25318,4311040
14645,irasnyd,3,0.00007,3933964,91.25325,4311040
14646,irfn,3,0.00007,3933967,91.25332,4311040
14647,IshwarKanse,3,0.00007,3933970,91.25339,4311040
14648,itayvallach,3,0.00007,3933973,91.25346,4311040
14649,ivant,3,0.00007,3933976,91.25353,4311040
14650,iwinux,3,0.00007,3933979,91.25360,4311040
14651,izzatzr,3,0.00007,3933982,91.25367,4311040
14652,j03wang,3,0.00007,3933985,91.25373,4311040
14653,jackin853,3,0.00007,3933988,91.25380,4311040
14654,jackliusr,3,0.00007,3933991,91.25387,4311040
14655,jad007,3,0.00007,3933994,91.25394,4311040
14656,jainishshah17,3,0.00007,3933997,91.25401,4311040
14657,jakubdyszkiewicz,3,0.00007,3934000,91.25408,4311040
14658,JamesDuncanNz,3,0.00007,3934003,91.25415,4311040
14659,james-knott,3,0.00007,3934006,91.25422,4311040
14660,james-w,3,0.00007,3934009,91.25429,4311040
14661,jannickfahlbusch,3,0.00007,3934012,91.25436,4311040
14662,jaredestroud,3,0.00007,3934015,91.25443,4311040
14663,jaredjenkins,3,0.00007,3934018,91.25450,4311040
14664,jarrettprosser,3,0.00007,3934021,91.25457,4311040
14665,jascott1,3,0.00007,3934024,91.25464,4311040
14666,jasoares,3,0.00007,3934027,91.25471,4311040
14667,jasonchester,3,0.00007,3934030,91.25478,4311040
14668,jasrusable,3,0.00007,3934033,91.25485,4311040
14669,Javatar81,3,0.00007,3934036,91.25492,4311040
14670,JaydipGabani,3,0.00007,3934039,91.25499,4311040
14671,jay-lee-otsk,3,0.00007,3934042,91.25506,4311040
14672,jbialy,3,0.00007,3934045,91.25513,4311040
14673,jbonachera,3,0.00007,3934048,91.25520,4311040
14674,jburnham,3,0.00007,3934051,91.25527,4311040
14675,jduepmeier,3,0.00007,3934054,91.25534,4311040
14676,JeanEpp,3,0.00007,3934057,91.25540,4311040
14677,jedsalazar,3,0.00007,3934060,91.25547,4311040
14678,jeffcai,3,0.00007,3934063,91.25554,4311040
14679,jefflaplante,3,0.00007,3934066,91.25561,4311040
14680,jessica-dl,3,0.00007,3934069,91.25568,4311040
14681,jianh619,3,0.00007,3934072,91.25575,4311040
14682,jimrollenhagen,3,0.00007,3934075,91.25582,4311040
14683,JJediny,3,0.00007,3934078,91.25589,4311040
14684,jjjungkim,3,0.00007,3934081,91.25596,4311040
14685,jkinred,3,0.00007,3934084,91.25603,4311040
14686,jkodroff,3,0.00007,3934087,91.25610,4311040
14687,jkupferer,3,0.00007,3934090,91.25617,4311040
14688,jlzhao27,3,0.00007,3934093,91.25624,4311040
14689,jmferrer,3,0.00007,3934096,91.25631,4311040
14690,jnevelson,3,0.00007,3934099,91.25638,4311040
14691,joelddiaz,3,0.00007,3934102,91.25645,4311040
14692,johnament,3,0.00007,3934105,91.25652,4311040
14693,johnmcollier,3,0.00007,3934108,91.25659,4311040
14694,jokogr,3,0.00007,3934111,91.25666,4311040
14695,jonahbron,3,0.00007,3934114,91.25673,4311040
14696,JonasDeGendt,3,0.00007,3934117,91.25680,4311040
14697,jonaseck2,3,0.00007,3934120,91.25687,4311040
14698,jonchiu,3,0.00007,3934123,91.25694,4311040
14699,jonhoo,3,0.00007,3934126,91.25701,4311040
14700,jordanbreen28,3,0.00007,3934129,91.25707,4311040
14701,jordanlewis,3,0.00007,3934132,91.25714,4311040
14702,jorenvandeweyer,3,0.00007,3934135,91.25721,4311040
14703,JorenVDL,3,0.00007,3934138,91.25728,4311040
14704,josemaia,3,0.00007,3934141,91.25735,4311040
14705,josephpeacock,3,0.00007,3934144,91.25742,4311040
14706,joylili,3,0.00007,3934147,91.25749,4311040
14707,joyme123,3,0.00007,3934150,91.25756,4311040
14708,jozefizso,3,0.00007,3934153,91.25763,4311040
14709,JParkinson1991,3,0.00007,3934156,91.25770,4311040
14710,jpatters,3,0.00007,3934159,91.25777,4311040
14711,jpbelangerupgrade,3,0.00007,3934162,91.25784,4311040
14712,Jpedro19,3,0.00007,3934165,91.25791,4311040
14713,JPZ13,3,0.00007,3934168,91.25798,4311040
14714,jreyeshdez,3,0.00007,3934171,91.25805,4311040
14715,jshearer,3,0.00007,3934174,91.25812,4311040
14716,jsirianni,3,0.00007,3934177,91.25819,4311040
14717,jskrzypek,3,0.00007,3934180,91.25826,4311040
14718,jsnick,3,0.00007,3934183,91.25833,4311040
14719,jsproede,3,0.00007,3934186,91.25840,4311040
14720,jszwedko,3,0.00007,3934189,91.25847,4311040
14721,jtlz2,3,0.00007,3934192,91.25854,4311040
14722,Juanchimienti,3,0.00007,3934195,91.25861,4311040
14723,jughead,3,0.00007,3934198,91.25868,4311040
14724,jujugrrr,3,0.00007,3934201,91.25874,4311040
14725,juliev0,3,0.00007,3934204,91.25881,4311040
14726,julio-lopez,3,0.00007,3934207,91.25888,4311040
14727,jupierce,3,0.00007,3934210,91.25895,4311040
14728,jupp0r,3,0.00007,3934213,91.25902,4311040
14729,justinas-b,3,0.00007,3934216,91.25909,4311040
14730,jvilhuber,3,0.00007,3934219,91.25916,4311040
14731,jyee,3,0.00007,3934222,91.25923,4311040
14732,k8k,3,0.00007,3934225,91.25930,4311040
14733,kaiwalyajoshi,3,0.00007,3934228,91.25937,4311040
14734,kaluzaaa,3,0.00007,3934231,91.25944,4311040
14735,kamikaze,3,0.00007,3934234,91.25951,4311040
14736,kamranhastam,3,0.00007,3934237,91.25958,4311040
14737,kariae,3,0.00007,3934240,91.25965,4311040
14738,KarlHerler,3,0.00007,3934243,91.25972,4311040
14739,Karocyt,3,0.00007,3934246,91.25979,4311040
14740,kartouch,3,0.00007,3934249,91.25986,4311040
14741,KateGo520,3,0.00007,3934252,91.25993,4311040
14742,katiekeel,3,0.00007,3934255,91.26000,4311040
14743,katlol,3,0.00007,3934258,91.26007,4311040
14744,kavehmz,3,0.00007,3934261,91.26014,4311040
14745,kdvolder,3,0.00007,3934264,91.26021,4311040
14746,keaxu-exp,3,0.00007,3934267,91.26028,4311040
14747,keithmcneill,3,0.00007,3934270,91.26035,4311040
14748,keitwb,3,0.00007,3934273,91.26042,4311040
14749,kelvie,3,0.00007,3934276,91.26048,4311040
14750,kenthua,3,0.00007,3934279,91.26055,4311040
14751,kevinawoo,3,0.00007,3934282,91.26062,4311040
14752,kevinll,3,0.00007,3934285,91.26069,4311040
14753,keyolk,3,0.00007,3934288,91.26076,4311040
14754,keyonjie,3,0.00007,3934291,91.26083,4311040
14755,kibra,3,0.00007,3934294,91.26090,4311040
14756,kichristensen,3,0.00007,3934297,91.26097,4311040
14757,Kimamisa,3,0.00007,3934300,91.26104,4311040
14758,kimkihoon0515,3,0.00007,3934303,91.26111,4311040
14759,kiranmeduri,3,0.00007,3934306,91.26118,4311040
14760,Kiran-r,3,0.00007,3934309,91.26125,4311040
14761,kitschysynq,3,0.00007,3934312,91.26132,4311040
14762,kiyose,3,0.00007,3934315,91.26139,4311040
14763,kiyoto,3,0.00007,3934318,91.26146,4311040
14764,kjkurtz,3,0.00007,3934321,91.26153,4311040
14765,kkonradI,3,0.00007,3934324,91.26160,4311040
14766,klatimer,3,0.00007,3934327,91.26167,4311040
14767,kloseliebej,3,0.00007,3934330,91.26174,4311040
14768,kmai,3,0.00007,3934333,91.26181,4311040
14769,knisbet,3,0.00007,3934336,91.26188,4311040
14770,knowshan,3,0.00007,3934339,91.26195,4311040
14771,KnoxAnderson,3,0.00007,3934342,91.26202,4311040
14772,knweiss,3,0.00007,3934345,91.26209,4311040
14773,kolly83,3,0.00007,3934348,91.26215,4311040
14774,krnowak,3,0.00007,3934351,91.26222,4311040
14775,ktarplee,3,0.00007,3934354,91.26229,4311040
14776,ktbartholomew,3,0.00007,3934357,91.26236,4311040
14777,kumare3,3,0.00007,3934360,91.26243,4311040
14778,kunmingg,3,0.00007,3934363,91.26250,4311040
14779,Kuqd,3,0.00007,3934366,91.26257,4311040
14780,kuuji,3,0.00007,3934369,91.26264,4311040
14781,kylos101,3,0.00007,3934372,91.26271,4311040
14782,kyunghoj,3,0.00007,3934375,91.26278,4311040
14783,l0neranger,3,0.00007,3934378,91.26285,4311040
14784,laconictae,3,0.00007,3934381,91.26292,4311040
14785,laidan6000,3,0.00007,3934384,91.26299,4311040
14786,lamroger,3,0.00007,3934387,91.26306,4311040
14787,langyxxl,3,0.00007,3934390,91.26313,4311040
14788,larryzhao,3,0.00007,3934393,91.26320,4311040
14789,larsha,3,0.00007,3934396,91.26327,4311040
14790,laurafitzgerald,3,0.00007,3934399,91.26334,4311040
14791,lawrencejones,3,0.00007,3934402,91.26341,4311040
14792,ldawert-sys11,3,0.00007,3934405,91.26348,4311040
14793,lebenitza,3,0.00007,3934408,91.26355,4311040
14794,leberknecht,3,0.00007,3934411,91.26362,4311040
14795,legionus,3,0.00007,3934414,91.26369,4311040
14796,lemosric,3,0.00007,3934417,91.26376,4311040
14797,lerencao,3,0.00007,3934420,91.26382,4311040
14798,levackt,3,0.00007,3934423,91.26389,4311040
14799,levilovelock,3,0.00007,3934426,91.26396,4311040
14800,LexiNadolski,3,0.00007,3934429,91.26403,4311040
14801,lfaraone,3,0.00007,3934432,91.26410,4311040
14802,lguminski,3,0.00007,3934435,91.26417,4311040
14803,lianghuiyuan,3,0.00007,3934438,91.26424,4311040
14804,lilirui,3,0.00007,3934441,91.26431,4311040
14805,liranr23,3,0.00007,3934444,91.26438,4311040
14806,liujunhui74,3,0.00007,3934447,91.26445,4311040
14807,llaoj,3,0.00007,3934450,91.26452,4311040
14808,locriani,3,0.00007,3934453,91.26459,4311040
14809,loganhz,3,0.00007,3934456,91.26466,4311040
14810,logical42,3,0.00007,3934459,91.26473,4311040
14811,logicbomb421,3,0.00007,3934462,91.26480,4311040
14812,lomori,3,0.00007,3934465,91.26487,4311040
14813,lookfwd,3,0.00007,3934468,91.26494,4311040
14814,lowescott,3,0.00007,3934471,91.26501,4311040
14815,l-qing,3,0.00007,3934474,91.26508,4311040
14816,LucaDev,3,0.00007,3934477,91.26515,4311040
14817,L-U-C-K-Y,3,0.00007,3934480,91.26522,4311040
14818,Luit,3,0.00007,3934483,91.26529,4311040
14819,lukasredynk,3,0.00007,3934486,91.26536,4311040
14820,lukesiler,3,0.00007,3934489,91.26543,4311040
14821,lukonjun,3,0.00007,3934492,91.26550,4311040
14822,lupino3,3,0.00007,3934495,91.26556,4311040
14823,lxin,3,0.00007,3934498,91.26563,4311040
14824,LzyRapx,3,0.00007,3934501,91.26570,4311040
14825,madAndroid,3,0.00007,3934504,91.26577,4311040
14826,magreiner,3,0.00007,3934507,91.26584,4311040
14827,maguro,3,0.00007,3934510,91.26591,4311040
14828,MahaGamal,3,0.00007,3934513,91.26598,4311040
14829,mahaisong,3,0.00007,3934516,91.26605,4311040
14830,malikbenkirane,3,0.00007,3934519,91.26612,4311040
14831,manodupont,3,0.00007,3934522,91.26619,4311040
14832,manojbadam,3,0.00007,3934525,91.26626,4311040
14833,Manojkl,3,0.00007,3934528,91.26633,4311040
14834,maprietom,3,0.00007,3934531,91.26640,4311040
14835,maradwan,3,0.00007,3934534,91.26647,4311040
14836,marcadella,3,0.00007,3934537,91.26654,4311040
14837,marcjoha,3,0.00007,3934540,91.26661,4311040
14838,marcov,3,0.00007,3934543,91.26668,4311040
14839,marcusschiesser,3,0.00007,3934546,91.26675,4311040
14840,marcwickenden,3,0.00007,3934549,91.26682,4311040
14841,marekaf,3,0.00007,3934552,91.26689,4311040
14842,mariusmitrofan,3,0.00007,3934555,91.26696,4311040
14843,MarkAndersonTrocme,3,0.00007,3934558,91.26703,4311040
14844,markgarrigan,3,0.00007,3934561,91.26710,4311040
14845,MarkLux,3,0.00007,3934564,91.26717,4311040
14846,markpaychex,3,0.00007,3934567,91.26723,4311040
14847,markrity,3,0.00007,3934570,91.26730,4311040
14848,Marlinc,3,0.00007,3934573,91.26737,4311040
14849,martialblog,3,0.00007,3934576,91.26744,4311040
14850,martinbeentjes,3,0.00007,3934579,91.26751,4311040
14851,martinknechtel,3,0.00007,3934582,91.26758,4311040
14852,MartinSimango,3,0.00007,3934585,91.26765,4311040
14853,marvin-hansen,3,0.00007,3934588,91.26772,4311040
14854,mathetake,3,0.00007,3934591,91.26779,4311040
14855,matrohon,3,0.00007,3934594,91.26786,4311040
14856,mattdoran,3,0.00007,3934597,91.26793,4311040
14857,matthew-hagemann,3,0.00007,3934600,91.26800,4311040
14858,matthewrj,3,0.00007,3934603,91.26807,4311040
14859,MatthiasHertel,3,0.00007,3934606,91.26814,4311040
14860,MattiasGees,3,0.00007,3934609,91.26821,4311040
14861,mattk42,3,0.00007,3934612,91.26828,4311040
14862,mattnickles,3,0.00007,3934615,91.26835,4311040
14863,mauriciogg,3,0.00007,3934618,91.26842,4311040
14864,maxenglander,3,0.00007,3934621,91.26849,4311040
14865,maximbr,3,0.00007,3934624,91.26856,4311040
14866,maximebedard,3,0.00007,3934627,91.26863,4311040
14867,MayukhSobo,3,0.00007,3934630,91.26870,4311040
14868,mazay,3,0.00007,3934633,91.26877,4311040
14869,mbaragiola,3,0.00007,3934636,91.26884,4311040
14870,mdb,3,0.00007,3934639,91.26890,4311040
14871,mdnix,3,0.00007,3934642,91.26897,4311040
14872,mehdichamouma,3,0.00007,3934645,91.26904,4311040
14873,mekstrem,3,0.00007,3934648,91.26911,4311040
14874,mesutcelik,3,0.00007,3934651,91.26918,4311040
14875,metrue,3,0.00007,3934654,91.26925,4311040
14876,mevam,3,0.00007,3934657,91.26932,4311040
14877,mgilbir,3,0.00007,3934660,91.26939,4311040
14878,mhaddon,3,0.00007,3934663,91.26946,4311040
14879,mhutter,3,0.00007,3934666,91.26953,4311040
14880,mhyousefi,3,0.00007,3934669,91.26960,4311040
14881,micahyoung,3,0.00007,3934672,91.26967,4311040
14882,michelbieleveld,3,0.00007,3934675,91.26974,4311040
14883,miguel250,3,0.00007,3934678,91.26981,4311040
14884,MihaiAnei,3,0.00007,3934681,91.26988,4311040
14885,mihaigalos,3,0.00007,3934684,91.26995,4311040
14886,mikalstill,3,0.00007,3934687,91.27002,4311040
14887,mikalv,3,0.00007,3934690,91.27009,4311040
14888,mike1808,3,0.00007,3934693,91.27016,4311040
14889,mikealt,3,0.00007,3934696,91.27023,4311040
14890,mike-marcacci,3,0.00007,3934699,91.27030,4311040
14891,mike-schiller,3,0.00007,3934702,91.27037,4311040
14892,mikespokefire,3,0.00007,3934705,91.27044,4311040
14893,milanaleksic,3,0.00007,3934708,91.27051,4311040
14894,milesmatthias,3,0.00007,3934711,91.27058,4311040
14895,Ming9,3,0.00007,3934714,91.27064,4311040
14896,minrk,3,0.00007,3934717,91.27071,4311040
14897,MirahImage,3,0.00007,3934720,91.27078,4311040
14898,mirthy,3,0.00007,3934723,91.27085,4311040
14899,mischief,3,0.00007,3934726,91.27092,4311040
14900,M-JobPixel,3,0.00007,3934729,91.27099,4311040
14901,mkabischev,3,0.00007,3934732,91.27106,4311040
14902,mkdolan,3,0.00007,3934735,91.27113,4311040
14903,mkkb473,3,0.00007,3934738,91.27120,4311040
14904,mkleint,3,0.00007,3934741,91.27127,4311040
14905,mlafeldt,3,0.00007,3934744,91.27134,4311040
14906,mlarrousse,3,0.00007,3934747,91.27141,4311040
14907,mlazowik,3,0.00007,3934750,91.27148,4311040
14908,mmckeen,3,0.00007,3934753,91.27155,4311040
14909,mmlac,3,0.00007,3934756,91.27162,4311040
14910,moelsayed,3,0.00007,3934759,91.27169,4311040
14911,MoienTajik,3,0.00007,3934762,91.27176,4311040
14912,moltar,3,0.00007,3934765,91.27183,4311040
14913,monadic,3,0.00007,3934768,91.27190,4311040
14914,monsteredc,3,0.00007,3934771,91.27197,4311040
14915,morenoh149,3,0.00007,3934774,91.27204,4311040
14916,motapratik,3,0.00007,3934777,91.27211,4311040
14917,mouhannadali,3,0.00007,3934780,91.27218,4311040
14918,mousavian,3,0.00007,3934783,91.27225,4311040
14919,mozai,3,0.00007,3934786,91.27231,4311040
14920,mpuncel,3,0.00007,3934789,91.27238,4311040
14921,mpvl,3,0.00007,3934792,91.27245,4311040
14922,mr-c,3,0.00007,3934795,91.27252,4311040
14923,MrCoffey,3,0.00007,3934798,91.27259,4311040
14924,mreferre,3,0.00007,3934801,91.27266,4311040
14925,MrGossett,3,0.00007,3934804,91.27273,4311040
14926,mrmrcoleman,3,0.00007,3934807,91.27280,4311040
14927,MrSaints,3,0.00007,3934810,91.27287,4311040
14928,MrWolfZ,3,0.00007,3934813,91.27294,4311040
14929,mrysavy,3,0.00007,3934816,91.27301,4311040
14930,msmith,3,0.00007,3934819,91.27308,4311040
14931,mthssdrbrg,3,0.00007,3934822,91.27315,4311040
14932,mtricht,3,0.00007,3934825,91.27322,4311040
14933,mubarak-j,3,0.00007,3934828,91.27329,4311040
14934,mukrishn,3,0.00007,3934831,91.27336,4311040
14935,muru,3,0.00007,3934834,91.27343,4311040
14936,mustufa5689,3,0.00007,3934837,91.27350,4311040
14937,mwhudson,3,0.00007,3934840,91.27357,4311040
14938,MXuDong,3,0.00007,3934843,91.27364,4311040
14939,mykidong,3,0.00007,3934846,91.27371,4311040
14940,mylokin,3,0.00007,3934849,91.27378,4311040
14941,nacx,3,0.00007,3934852,91.27385,4311040
14942,Naddiseo,3,0.00007,3934855,91.27392,4311040
14943,nalbury-handy,3,0.00007,3934858,91.27398,4311040
14944,napalm684,3,0.00007,3934861,91.27405,4311040
14945,narenarjun,3,0.00007,3934864,91.27412,4311040
14946,Narsail,3,0.00007,3934867,91.27419,4311040
14947,nateq314,3,0.00007,3934870,91.27426,4311040
14948,natrem,3,0.00007,3934873,91.27433,4311040
14949,naufalafif,3,0.00007,3934876,91.27440,4311040
14950,nbourdeau,3,0.00007,3934879,91.27447,4311040
14951,nealef,3,0.00007,3934882,91.27454,4311040
14952,nee1esh,3,0.00007,3934885,91.27461,4311040
14953,neilgierman,3,0.00007,3934888,91.27468,4311040
14954,nelsonyaccuzzi,3,0.00007,3934891,91.27475,4311040
14955,neocortical,3,0.00007,3934894,91.27482,4311040
14956,nfrush,3,0.00007,3934897,91.27489,4311040
14957,nicholasdille,3,0.00007,3934900,91.27496,4311040
14958,nickcarenza,3,0.00007,3934903,91.27503,4311040
14959,nicklasfrahm,3,0.00007,3934906,91.27510,4311040
14960,NickLavrov,3,0.00007,3934909,91.27517,4311040
14961,nigelcharman,3,0.00007,3934912,91.27524,4311040
14962,NilsWild,3,0.00007,3934915,91.27531,4311040
14963,nirousseau,3,0.00007,3934918,91.27538,4311040
14964,niteshs7,3,0.00007,3934921,91.27545,4311040
14965,nitishmalang,3,0.00007,3934924,91.27552,4311040
14966,nkanish2002,3,0.00007,3934927,91.27559,4311040
14967,nkiesel,3,0.00007,3934930,91.27566,4311040
14968,nlf,3,0.00007,3934933,91.27572,4311040
14969,no2a,3,0.00007,3934936,91.27579,4311040
14970,noahdesu,3,0.00007,3934939,91.27586,4311040
14971,northtyphoon,3,0.00007,3934942,91.27593,4311040
14972,notariuss,3,0.00007,3934945,91.27600,4311040
14973,notcool11,3,0.00007,3934948,91.27607,4311040
14974,notsureifkevin,3,0.00007,3934951,91.27614,4311040
14975,nrvale0,3,0.00007,3934954,91.27621,4311040
14976,nullstyle,3,0.00007,3934957,91.27628,4311040
14977,nzicecool,3,0.00007,3934960,91.27635,4311040
14978,o0-o0,3,0.00007,3934963,91.27642,4311040
14979,oazmon,3,0.00007,3934966,91.27649,4311040
14980,Obirah,3,0.00007,3934969,91.27656,4311040
14981,ocombe,3,0.00007,3934972,91.27663,4311040
14982,ocontant,3,0.00007,3934975,91.27670,4311040
14983,octo,3,0.00007,3934978,91.27677,4311040
14984,ofirmakmal,3,0.00007,3934981,91.27684,4311040
14985,ofirshtrull,3,0.00007,3934984,91.27691,4311040
14986,ogrisel,3,0.00007,3934987,91.27698,4311040
14987,olensmar,3,0.00007,3934990,91.27705,4311040
14988,oliverkane,3,0.00007,3934993,91.27712,4311040
14989,olofwalker,3,0.00007,3934996,91.27719,4311040
14990,Oloremo,3,0.00007,3934999,91.27726,4311040
14991,onlymellb,3,0.00007,3935002,91.27733,4311040
14992,orangain,3,0.00007,3935005,91.27739,4311040
14993,orefalo,3,0.00007,3935008,91.27746,4311040
14994,orionHong,3,0.00007,3935011,91.27753,4311040
14995,OrwillT,3,0.00007,3935014,91.27760,4311040
14996,ovaldi,3,0.00007,3935017,91.27767,4311040
14997,ovanes,3,0.00007,3935020,91.27774,4311040
14998,owainlewis,3,0.00007,3935023,91.27781,4311040
14999,packtpartner,3,0.00007,3935026,91.27788,4311040
15000,Padarn,3,0.00007,3935029,91.27795,4311040
15001,paisleyrob,3,0.00007,3935032,91.27802,4311040
15002,parjong,3,0.00007,3935035,91.27809,4311040
15003,PassionForPie,3,0.00007,3935038,91.27816,4311040
15004,PatrickGeyer,3,0.00007,3935041,91.27823,4311040
15005,PatrickGhosn,3,0.00007,3935044,91.27830,4311040
15006,paulcichonski,3,0.00007,3935047,91.27837,4311040
15007,PaulVanStaden,3,0.00007,3935050,91.27844,4311040
15008,pavdmyt,3,0.00007,3935053,91.27851,4311040
15009,pavel-mikhalchuk,3,0.00007,3935056,91.27858,4311040
15010,pavel-odintsov,3,0.00007,3935059,91.27865,4311040
15011,pborzenkov,3,0.00007,3935062,91.27872,4311040
15012,pdfrod,3,0.00007,3935065,91.27879,4311040
15013,pearj,3,0.00007,3935068,91.27886,4311040
15014,pedro823,3,0.00007,3935071,91.27893,4311040
15015,peimanja,3,0.00007,3935074,91.27900,4311040
15016,peiqi-caicloud,3,0.00007,3935077,91.27906,4311040
15017,pelithne,3,0.00007,3935080,91.27913,4311040
15018,petemill,3,0.00007,3935083,91.27920,4311040
15019,peter-c-larsson,3,0.00007,3935086,91.27927,4311040
15020,petvaa01,3,0.00007,3935089,91.27934,4311040
15021,pgodowski,3,0.00007,3935092,91.27941,4311040
15022,pgoyal01,3,0.00007,3935095,91.27948,4311040
15023,pgvishnuram,3,0.00007,3935098,91.27955,4311040
15024,Phaow,3,0.00007,3935101,91.27962,4311040
15025,philipsparrow,3,0.00007,3935104,91.27969,4311040
15026,philwo,3,0.00007,3935107,91.27976,4311040
15027,phroggyy,3,0.00007,3935110,91.27983,4311040
15028,piano-man,3,0.00007,3935113,91.27990,4311040
15029,pie-r,3,0.00007,3935116,91.27997,4311040
15030,Pitta,3,0.00007,3935119,91.28004,4311040
15031,pittar,3,0.00007,3935122,91.28011,4311040
15032,piu28,3,0.00007,3935125,91.28018,4311040
15033,pivotal-nader-ziada,3,0.00007,3935128,91.28025,4311040
15034,Pixcell,3,0.00007,3935131,91.28032,4311040
15035,piyushmadan,3,0.00007,3935134,91.28039,4311040
15036,pjarominsap,3,0.00007,3935137,91.28046,4311040
15037,pjvds,3,0.00007,3935140,91.28053,4311040
15038,pkhadka56,3,0.00007,3935143,91.28060,4311040
15039,PKizzle,3,0.00007,3935146,91.28067,4311040
15040,plockaby,3,0.00007,3935149,91.28074,4311040
15041,plutov,3,0.00007,3935152,91.28080,4311040
15042,pmalmgren,3,0.00007,3935155,91.28087,4311040
15043,pmcjury,3,0.00007,3935158,91.28094,4311040
15044,pmithil7,3,0.00007,3935161,91.28101,4311040
15045,poiuytrez,3,0.00007,3935164,91.28108,4311040
15046,polaru,3,0.00007,3935167,91.28115,4311040
15047,polothy,3,0.00007,3935170,91.28122,4311040
15048,pphaneuf,3,0.00007,3935173,91.28129,4311040
15049,PradheepShrinivasan,3,0.00007,3935176,91.28136,4311040
15050,premanandc,3,0.00007,3935179,91.28143,4311040
15051,Primigenus,3,0.00007,3935182,91.28150,4311040
15052,princefishthrower,3,0.00007,3935185,91.28157,4311040
15053,protochron,3,0.00007,3935188,91.28164,4311040
15054,psavva,3,0.00007,3935191,91.28171,4311040
15055,pseymournutanix,3,0.00007,3935194,91.28178,4311040
15056,psigen,3,0.00007,3935197,91.28185,4311040
15057,ptran32,3,0.00007,3935200,91.28192,4311040
15058,ptrivedi,3,0.00007,3935203,91.28199,4311040
15059,punitag,3,0.00007,3935206,91.28206,4311040
15060,pyk,3,0.00007,3935209,91.28213,4311040
15061,pyramation,3,0.00007,3935212,91.28220,4311040
15062,qjiang77,3,0.00007,3935215,91.28227,4311040
15063,QuantumFractal,3,0.00007,3935218,91.28234,4311040
15064,quentinleclerc,3,0.00007,3935221,91.28241,4311040
15065,QuingKhaos,3,0.00007,3935224,91.28247,4311040
15066,r0mdau,3,0.00007,3935227,91.28254,4311040
15067,Rachael-Graham,3,0.00007,3935230,91.28261,4311040
15068,rahul-paigavan,3,0.00007,3935233,91.28268,4311040
15069,rakelkar,3,0.00007,3935236,91.28275,4311040
15070,ramgdev,3,0.00007,3935239,91.28282,4311040
15071,raonadeem,3,0.00007,3935242,91.28289,4311040
15072,rashmi43,3,0.00007,3935245,91.28296,4311040
15073,rathko,3,0.00007,3935248,91.28303,4311040
15074,ravipwaghmare,3,0.00007,3935251,91.28310,4311040
15075,raykao,3,0.00007,3935254,91.28317,4311040
15076,razor-x,3,0.00007,3935257,91.28324,4311040
15077,rcernich,3,0.00007,3935260,91.28331,4311040
15078,rchalumeau,3,0.00007,3935263,91.28338,4311040
15079,rcolline,3,0.00007,3935266,91.28345,4311040
15080,rdaniels6813,3,0.00007,3935269,91.28352,4311040
15081,real-cost,3,0.00007,3935272,91.28359,4311040
15082,rearden-steel,3,0.00007,3935275,91.28366,4311040
15083,redpanda,3,0.00007,3935278,91.28373,4311040
15084,redradrat,3,0.00007,3935281,91.28380,4311040
15085,reidlai,3,0.00007,3935284,91.28387,4311040
15086,retnuh,3,0.00007,3935287,91.28394,4311040
15087,ReToCode,3,0.00007,3935290,91.28401,4311040
15088,retrohacker,3,0.00007,3935293,91.28408,4311040
15089,revolunet,3,0.00007,3935296,91.28414,4311040
15090,rfleschenberg,3,0.00007,3935299,91.28421,4311040
15091,rfratto,3,0.00007,3935302,91.28428,4311040
15092,rhoml,3,0.00007,3935305,91.28435,4311040
15093,Richard87,3,0.00007,3935308,91.28442,4311040
15094,Rick-Jongbloed,3,0.00007,3935311,91.28449,4311040
15095,RickvdP,3,0.00007,3935314,91.28456,4311040
15096,riconnon,3,0.00007,3935317,91.28463,4311040
15097,rifaterdemsahin,3,0.00007,3935320,91.28470,4311040
15098,riteshsonawane1372,3,0.00007,3935323,91.28477,4311040
15099,riverron,3,0.00007,3935326,91.28484,4311040
15100,rjhuijsman,3,0.00007,3935329,91.28491,4311040
15101,rjkernick,3,0.00007,3935332,91.28498,4311040
15102,rmendal,3,0.00007,3935335,91.28505,4311040
15103,robcresswell,3,0.00007,3935338,91.28512,4311040
15104,robholland,3,0.00007,3935341,91.28519,4311040
15105,robincher,3,0.00007,3935344,91.28526,4311040
15106,robinjmurphy,3,0.00007,3935347,91.28533,4311040
15107,roblalonde,3,0.00007,3935350,91.28540,4311040
15108,Rock981119,3,0.00007,3935353,91.28547,4311040
15109,roemba,3,0.00007,3935356,91.28554,4311040
15110,rogpeppe,3,0.00007,3935359,91.28561,4311040
15111,rokii,3,0.00007,3935362,91.28568,4311040
15112,Rolice,3,0.00007,3935365,91.28575,4311040
15113,ronakbanka,3,0.00007,3935368,91.28582,4311040
15114,ronniemaor,3,0.00007,3935371,91.28588,4311040
15115,Ropes,3,0.00007,3935374,91.28595,4311040
15116,Roronoa-Z3r0,3,0.00007,3935377,91.28602,4311040
15117,RoryCrispin,3,0.00007,3935380,91.28609,4311040
15118,royxue,3,0.00007,3935383,91.28616,4311040
15119,rpardini,3,0.00007,3935386,91.28623,4311040
15120,rpjday,3,0.00007,3935389,91.28630,4311040
15121,rpocase,3,0.00007,3935392,91.28637,4311040
15122,rpsene,3,0.00007,3935395,91.28644,4311040
15123,rsanders,3,0.00007,3935398,91.28651,4311040
15124,rtyler,3,0.00007,3935401,91.28658,4311040
15125,rubenvp8510,3,0.00007,3935404,91.28665,4311040
15126,Rubix982,3,0.00007,3935407,91.28672,4311040
15127,Ruitjes,3,0.00007,3935410,91.28679,4311040
15128,rul,3,0.00007,3935413,91.28686,4311040
15129,RushinthJohn,3,0.00007,3935416,91.28693,4311040
15130,rvandegrift,3,0.00007,3935419,91.28700,4311040
15131,ryand91,3,0.00007,3935422,91.28707,4311040
15132,s0rc3r3r01,3,0.00007,3935425,91.28714,4311040
15133,s191k,3,0.00007,3935428,91.28721,4311040
15134,sadiqueWiseboxs,3,0.00007,3935431,91.28728,4311040
15135,saeidakbari,3,0.00007,3935434,91.28735,4311040
15136,saforster,3,0.00007,3935437,91.28742,4311040
15137,sagarkal,3,0.00007,3935440,91.28749,4311040
15138,sahilsk,3,0.00007,3935443,91.28755,4311040
15139,SaikiranDaripelli,3,0.00007,3935446,91.28762,4311040
15140,salimkabeer,3,0.00007,3935449,91.28769,4311040
15141,SamDecrock,3,0.00007,3935452,91.28776,4311040
15142,samiam,3,0.00007,3935455,91.28783,4311040
15143,SaMnCo,3,0.00007,3935458,91.28790,4311040
15144,samrocketman,3,0.00007,3935461,91.28797,4311040
15145,samsieber,3,0.00007,3935464,91.28804,4311040
15146,samvantran,3,0.00007,3935467,91.28811,4311040
15147,samvdb,3,0.00007,3935470,91.28818,4311040
15148,santoshsahoo,3,0.00007,3935473,91.28825,4311040
15149,saraedum,3,0.00007,3935476,91.28832,4311040
15150,saranyareddy24,3,0.00007,3935479,91.28839,4311040
15151,SaravanaStorageNetwork,3,0.00007,3935482,91.28846,4311040
15152,saromanov,3,0.00007,3935485,91.28853,4311040
15153,sathyatvrcbe,3,0.00007,3935488,91.28860,4311040
15154,SatwikBhandiwad,3,0.00007,3935491,91.28867,4311040
15155,satyamkale27,3,0.00007,3935494,91.28874,4311040
15156,sauryadas,3,0.00007,3935497,91.28881,4311040
15157,saviogl,3,0.00007,3935500,91.28888,4311040
15158,sayanh,3,0.00007,3935503,91.28895,4311040
15159,sazo,3,0.00007,3935506,91.28902,4311040
15160,sbellem,3,0.00007,3935509,91.28909,4311040
15161,sbwsg,3,0.00007,3935512,91.28916,4311040
15162,scalp42,3,0.00007,3935515,91.28922,4311040
15163,scheler,3,0.00007,3935518,91.28929,4311040
15164,scones,3,0.00007,3935521,91.28936,4311040
15165,scottmf,3,0.00007,3935524,91.28943,4311040
15166,scw00,3,0.00007,3935527,91.28950,4311040
15167,sdaschner,3,0.00007,3935530,91.28957,4311040
15168,SDBrett,3,0.00007,3935533,91.28964,4311040
15169,seglo,3,0.00007,3935536,91.28971,4311040
15170,seguidor777,3,0.00007,3935539,91.28978,4311040
15171,sergei-utinski,3,0.00007,3935542,91.28985,4311040
15172,SergeSpinoza,3,0.00007,3935545,91.28992,4311040
15173,SeriyBg,3,0.00007,3935548,91.28999,4311040
15174,sevenfourk,3,0.00007,3935551,91.29006,4311040
15175,sfunkhouser,3,0.00007,3935554,91.29013,4311040
15176,shanahanjrs,3,0.00007,3935557,91.29020,4311040
15177,sharma-rohit,3,0.00007,3935560,91.29027,4311040
15178,shauns,3,0.00007,3935563,91.29034,4311040
15179,shengnuo,3,0.00007,3935566,91.29041,4311040
15180,shichao-an,3,0.00007,3935569,91.29048,4311040
15181,shift,3,0.00007,3935572,91.29055,4311040
15182,shkrid,3,0.00007,3935575,91.29062,4311040
15183,shmurata,3,0.00007,3935578,91.29069,4311040
15184,sim1,3,0.00007,3935581,91.29076,4311040
15185,simonyangcj,3,0.00007,3935584,91.29083,4311040
15186,sixeyed,3,0.00007,3935587,91.29090,4311040
15187,sjungwirth,3,0.00007,3935590,91.29096,4311040
15188,skaji,3,0.00007,3935593,91.29103,4311040
15189,skhatri,3,0.00007,3935596,91.29110,4311040
15190,skinny,3,0.00007,3935599,91.29117,4311040
15191,SkinyMonkey,3,0.00007,3935602,91.29124,4311040
15192,skmaingi,3,0.00007,3935605,91.29131,4311040
15193,skonzem,3,0.00007,3935608,91.29138,4311040
15194,SkYNewZ,3,0.00007,3935611,91.29145,4311040
15195,sleekweasel,3,0.00007,3935614,91.29152,4311040
15196,smakam,3,0.00007,3935617,91.29159,4311040
15197,smccarthy,3,0.00007,3935620,91.29166,4311040
15198,smerrill,3,0.00007,3935623,91.29173,4311040
15199,smileprem,3,0.00007,3935626,91.29180,4311040
15200,smiller171,3,0.00007,3935629,91.29187,4311040
15201,snehahegde7,3,0.00007,3935632,91.29194,4311040
15202,sofuture,3,0.00007,3935635,91.29201,4311040
15203,sohailanjum97,3,0.00007,3935638,91.29208,4311040
15204,somcsel,3,0.00007,3935641,91.29215,4311040
15205,somtochiama,3,0.00007,3935644,91.29222,4311040
15206,sondabar,3,0.00007,3935647,91.29229,4311040
15207,soninob,3,0.00007,3935650,91.29236,4311040
15208,sotayamashita,3,0.00007,3935653,91.29243,4311040
15209,sotiris84,3,0.00007,3935656,91.29250,4311040
15210,soujatyabhat,3,0.00007,3935659,91.29257,4311040
15211,souleb,3,0.00007,3935662,91.29263,4311040
15212,sownak,3,0.00007,3935665,91.29270,4311040
15213,SpandanKumarSahu,3,0.00007,3935668,91.29277,4311040
15214,spatronis,3,0.00007,3935671,91.29284,4311040
15215,spiegela,3,0.00007,3935674,91.29291,4311040
15216,splattner,3,0.00007,3935677,91.29298,4311040
15217,spoganshev,3,0.00007,3935680,91.29305,4311040
15218,sporokh,3,0.00007,3935683,91.29312,4311040
15219,srikanthvavila,3,0.00007,3935686,91.29319,4311040
15220,ssmall,3,0.00007,3935689,91.29326,4311040
15221,s-spindler,3,0.00007,3935692,91.29333,4311040
15222,st3fus,3,0.00007,3935695,91.29340,4311040
15223,Starnop,3,0.00007,3935698,91.29347,4311040
15224,stefanberger,3,0.00007,3935701,91.29354,4311040
15225,steffakasid,3,0.00007,3935704,91.29361,4311040
15226,stevelacy,3,0.00007,3935707,91.29368,4311040
15227,stewartshea,3,0.00007,3935710,91.29375,4311040
15228,stgarf,3,0.00007,3935713,91.29382,4311040
15229,stkevintan,3,0.00007,3935716,91.29389,4311040
15230,stmaute,3,0.00007,3935719,91.29396,4311040
15231,Stolr,3,0.00007,3935722,91.29403,4311040
15232,strattner,3,0.00007,3935725,91.29410,4311040
15233,SubhakarKotta,3,0.00007,3935728,91.29417,4311040
15234,subhamgcon,3,0.00007,3935731,91.29424,4311040
15235,sunhay,3,0.00007,3935734,91.29430,4311040
15236,superyyrrzz,3,0.00007,3935737,91.29437,4311040
15237,supra08,3,0.00007,3935740,91.29444,4311040
15238,Sushant,3,0.00007,3935743,91.29451,4311040
15239,svanellewee,3,0.00007,3935746,91.29458,4311040
15240,swalkowski,3,0.00007,3935749,91.29465,4311040
15241,swibrow,3,0.00007,3935752,91.29472,4311040
15242,swordbeta,3,0.00007,3935755,91.29479,4311040
15243,sylwit,3,0.00007,3935758,91.29486,4311040
15244,syst3mw0rm,3,0.00007,3935761,91.29493,4311040
15245,szamuboy,3,0.00007,3935764,91.29500,4311040
15246,T0MASD,3,0.00007,3935767,91.29507,4311040
15247,TAGC,3,0.00007,3935770,91.29514,4311040
15248,takac,3,0.00007,3935773,91.29521,4311040
15249,tanin47,3,0.00007,3935776,91.29528,4311040
15250,tanmaniac,3,0.00007,3935779,91.29535,4311040
15251,tanordheim,3,0.00007,3935782,91.29542,4311040
15252,tanzeeb,3,0.00007,3935785,91.29549,4311040
15253,tareksamni,3,0.00007,3935788,91.29556,4311040
15254,taylormgeorge91,3,0.00007,3935791,91.29563,4311040
15255,taylorwaggoner,3,0.00007,3935794,91.29570,4311040
15256,tbe,3,0.00007,3935797,91.29577,4311040
15257,tbielawa,3,0.00007,3935800,91.29584,4311040
15258,techcet,3,0.00007,3935803,91.29591,4311040
15259,teivah,3,0.00007,3935806,91.29597,4311040
15260,tesharp,3,0.00007,3935809,91.29604,4311040
15261,tgeci,3,0.00007,3935812,91.29611,4311040
15262,tgross,3,0.00007,3935815,91.29618,4311040
15263,thallgren,3,0.00007,3935818,91.29625,4311040
15264,thebithead,3,0.00007,3935821,91.29632,4311040
15265,thecrazyrussian,3,0.00007,3935824,91.29639,4311040
15266,thefotios,3,0.00007,3935827,91.29646,4311040
15267,TheFoxAtWork,3,0.00007,3935830,91.29653,4311040
15268,theofpa,3,0.00007,3935833,91.29660,4311040
15269,thomasstxyz,3,0.00007,3935836,91.29667,4311040
15270,thschue,3,0.00007,3935839,91.29674,4311040
15271,TieWei,3,0.00007,3935842,91.29681,4311040
15272,tigerinus,3,0.00007,3935845,91.29688,4311040
15273,timcrall,3,0.00007,3935848,91.29695,4311040
15274,timwebster9,3,0.00007,3935851,91.29702,4311040
15275,tjdett,3,0.00007,3935854,91.29709,4311040
15276,tobert,3,0.00007,3935857,91.29716,4311040
15277,TobiasGoerke,3,0.00007,3935860,91.29723,4311040
15278,tommylindgren-plejd,3,0.00007,3935863,91.29730,4311040
15279,tomoyat1,3,0.00007,3935866,91.29737,4311040
15280,tOnI0,3,0.00007,3935869,91.29744,4311040
15281,tonistiigi,3,0.00007,3935872,91.29751,4311040
15282,tonnyeremin,3,0.00007,3935875,91.29758,4311040
15283,tonybaloney,3,0.00007,3935878,91.29765,4311040
15284,tovin07,3,0.00007,3935881,91.29771,4311040
15285,towens,3,0.00007,3935884,91.29778,4311040
15286,TrevorRobertsJr,3,0.00007,3935887,91.29785,4311040
15287,trthomps,3,0.00007,3935890,91.29792,4311040
15288,tsabirgaliev,3,0.00007,3935893,91.29799,4311040
15289,tscolari,3,0.00007,3935896,91.29806,4311040
15290,tscswcn,3,0.00007,3935899,91.29813,4311040
15291,ttlv,3,0.00007,3935902,91.29820,4311040
15292,tusharnt,3,0.00007,3935905,91.29827,4311040
15293,twKrash,3,0.00007,3935908,91.29834,4311040
15294,tysonnorris,3,0.00007,3935911,91.29841,4311040
15295,umairidris,3,0.00007,3935914,91.29848,4311040
15296,unisisdev,3,0.00007,3935917,91.29855,4311040
15297,unnati914,3,0.00007,3935920,91.29862,4311040
15298,unullmass,3,0.00007,3935923,91.29869,4311040
15299,urban-1,3,0.00007,3935926,91.29876,4311040
15300,usamaahmadkhan,3,0.00007,3935929,91.29883,4311040
15301,UsamaMehboob,3,0.00007,3935932,91.29890,4311040
15302,v1v,3,0.00007,3935935,91.29897,4311040
15303,vadorovsky,3,0.00007,3935938,91.29904,4311040
15304,vakker,3,0.00007,3935941,91.29911,4311040
15305,valerianpereira,3,0.00007,3935944,91.29918,4311040
15306,van-adam,3,0.00007,3935947,91.29925,4311040
15307,vania-pooh,3,0.00007,3935950,91.29932,4311040
15308,vanugrah,3,0.00007,3935953,91.29938,4311040
15309,vbellur,3,0.00007,3935956,91.29945,4311040
15310,vburenin,3,0.00007,3935959,91.29952,4311040
15311,veggiemonk,3,0.00007,3935962,91.29959,4311040
15312,velkhatib,3,0.00007,3935965,91.29966,4311040
15313,vfarcic,3,0.00007,3935968,91.29973,4311040
15314,vglafirov,3,0.00007,3935971,91.29980,4311040
15315,vhp1360,3,0.00007,3935974,91.29987,4311040
15316,vhsantos,3,0.00007,3935977,91.29994,4311040
15317,via-jordan-sokolic,3,0.00007,3935980,91.30001,4311040
15318,vicenteherrera,3,0.00007,3935983,91.30008,4311040
15319,victorboissiere,3,0.00007,3935986,91.30015,4311040
15320,victorgama,3,0.00007,3935989,91.30022,4311040
15321,victorgs,3,0.00007,3935992,91.30029,4311040
15322,viirya,3,0.00007,3935995,91.30036,4311040
15323,vijay-dcrust,3,0.00007,3935998,91.30043,4311040
15324,vincentfree,3,0.00007,3936001,91.30050,4311040
15325,VinodAnandan,3,0.00007,3936004,91.30057,4311040
15326,vishal-yadav,3,0.00007,3936007,91.30064,4311040
15327,Vishvsalvi,3,0.00007,3936010,91.30071,4311040
15328,vitaliytv,3,0.00007,3936013,91.30078,4311040
15329,viveksatasiya,3,0.00007,3936016,91.30085,4311040
15330,vkruoso,3,0.00007,3936019,91.30092,4311040
15331,VladyslavKurmaz,3,0.00007,3936022,91.30099,4311040
15332,VMTrooper,3,0.00007,3936025,91.30105,4311040
15333,Vogtinator,3,0.00007,3936028,91.30112,4311040
15334,voidengineer,3,0.00007,3936031,91.30119,4311040
15335,volatilemolotov,3,0.00007,3936034,91.30126,4311040
15336,volker-raschek,3,0.00007,3936037,91.30133,4311040
15337,vosmith,3,0.00007,3936040,91.30140,4311040
15338,vtuson,3,0.00007,3936043,91.30147,4311040
15339,w4-jaesup,3,0.00007,3936046,91.30154,4311040
15340,wanghong230,3,0.00007,3936049,91.30161,4311040
15341,wangkirin,3,0.00007,3936052,91.30168,4311040
15342,wangsha,3,0.00007,3936055,91.30175,4311040
15343,wangxing1517,3,0.00007,3936058,91.30182,4311040
15344,wangyang0616,3,0.00007,3936061,91.30189,4311040
15345,wangyuqing4,3,0.00007,3936064,91.30196,4311040
15346,waret,3,0.00007,3936067,91.30203,4311040
15347,wdalmut,3,0.00007,3936070,91.30210,4311040
15348,weters,3,0.00007,3936073,91.30217,4311040
15349,wgui1,3,0.00007,3936076,91.30224,4311040
15350,whirlwin,3,0.00007,3936079,91.30231,4311040
15351,whiskeysierra,3,0.00007,3936082,91.30238,4311040
15352,whitneygriffith,3,0.00007,3936085,91.30245,4311040
15353,wiggzz,3,0.00007,3936088,91.30252,4311040
15354,will-beta,3,0.00007,3936091,91.30259,4311040
15355,williamaronli,3,0.00007,3936094,91.30266,4311040
15356,williambrode,3,0.00007,3936097,91.30273,4311040
15357,William-LP,3,0.00007,3936100,91.30279,4311040
15358,william-tran,3,0.00007,3936103,91.30286,4311040
15359,william-wang,3,0.00007,3936106,91.30293,4311040
15360,wtrocki,3,0.00007,3936109,91.30300,4311040
15361,wurbanski,3,0.00007,3936112,91.30307,4311040
15362,wyllys66,3,0.00007,3936115,91.30314,4311040
15363,WyriHaximus,3,0.00007,3936118,91.30321,4311040
15364,xaka,3,0.00007,3936121,91.30328,4311040
15365,xetys,3,0.00007,3936124,91.30335,4311040
15366,xguerin,3,0.00007,3936127,91.30342,4311040
15367,xhebox,3,0.00007,3936130,91.30349,4311040
15368,XinruZhang,3,0.00007,3936133,91.30356,4311040
15369,xiuxiu,3,0.00007,3936136,91.30363,4311040
15370,xlanor,3,0.00007,3936139,91.30370,4311040
15371,xlw712,3,0.00007,3936142,91.30377,4311040
15372,xorjain,3,0.00007,3936145,91.30384,4311040
15373,xperimental,3,0.00007,3936148,91.30391,4311040
15374,xubofei1983,3,0.00007,3936151,91.30398,4311040
15375,yangxiangyu,3,0.00007,3936154,91.30405,4311040
15376,yankeexe,3,0.00007,3936157,91.30412,4311040
15377,yanyixing,3,0.00007,3936160,91.30419,4311040
15378,yellowiscool,3,0.00007,3936163,91.30426,4311040
15379,yiakwy,3,0.00007,3936166,91.30433,4311040
15380,yinsihaws,3,0.00007,3936169,91.30440,4311040
15381,ykhrustalev,3,0.00007,3936172,91.30446,4311040
15382,ymgyt,3,0.00007,3936175,91.30453,4311040
15383,yob,3,0.00007,3936178,91.30460,4311040
15384,yonahd,3,0.00007,3936181,91.30467,4311040
15385,yoshuawuyts,3,0.00007,3936184,91.30474,4311040
15386,yoshz,3,0.00007,3936187,91.30481,4311040
15387,yrong,3,0.00007,3936190,91.30488,4311040
15388,yrosaguiar,3,0.00007,3936193,91.30495,4311040
15389,y-spreen,3,0.00007,3936196,91.30502,4311040
15390,yufan022,3,0.00007,3936199,91.30509,4311040
15391,yuhaohaoyu,3,0.00007,3936202,91.30516,4311040
15392,yusuoh,3,0.00007,3936205,91.30523,4311040
15393,zeevallin,3,0.00007,3936208,91.30530,4311040
15394,zeisss,3,0.00007,3936211,91.30537,4311040
15395,zencircle,3,0.00007,3936214,91.30544,4311040
15396,zephinzer,3,0.00007,3936217,91.30551,4311040
15397,zh1314,3,0.00007,3936220,91.30558,4311040
15398,zhangchaolei,3,0.00007,3936223,91.30565,4311040
15399,zhangyangyu,3,0.00007,3936226,91.30572,4311040
15400,zhlsunshine,3,0.00007,3936229,91.30579,4311040
15401,zhonglin6666,3,0.00007,3936232,91.30586,4311040
15402,zhucebuliaolongchuan,3,0.00007,3936235,91.30593,4311040
15403,zhujl1991,3,0.00007,3936238,91.30600,4311040
15404,Zikoel,3,0.00007,3936241,91.30607,4311040
15405,zkanda,3,0.00007,3936244,91.30613,4311040
15406,zknill,3,0.00007,3936247,91.30620,4311040
15407,zodiac12k,3,0.00007,3936250,91.30627,4311040
15408,zoltan-fedor,3,0.00007,3936253,91.30634,4311040
15409,zonArt,3,0.00007,3936256,91.30641,4311040
15410,zregvart,3,0.00007,3936259,91.30648,4311040
15411,zsolt-keseru-epam,3,0.00007,3936262,91.30655,4311040
15412,zyxue,3,0.00007,3936265,91.30662,4311040
15413,01deyishu,2,0.00005,3936267,91.30667,4311040
15414,0ff,2,0.00005,3936269,91.30671,4311040
15415,0x4139,2,0.00005,3936271,91.30676,4311040
15416,0x77dev,2,0.00005,3936273,91.30681,4311040
15417,12beseuahmad,2,0.00005,3936275,91.30685,4311040
15418,1337andre,2,0.00005,3936277,91.30690,4311040
15419,1N50MN14,2,0.00005,3936279,91.30695,4311040
15420,3j0s,2,0.00005,3936281,91.30699,4311040
15421,4383,2,0.00005,3936283,91.30704,4311040
15422,502155589,2,0.00005,3936285,91.30709,4311040
15423,54853315,2,0.00005,3936287,91.30713,4311040
15424,aaabramov,2,0.00005,3936289,91.30718,4311040
15425,aapjeisbaas,2,0.00005,3936291,91.30723,4311040
15426,aardappel,2,0.00005,3936293,91.30727,4311040
15427,AaronLinOops,2,0.00005,3936295,91.30732,4311040
15428,aarontams,2,0.00005,3936297,91.30736,4311040
15429,Aarthisk,2,0.00005,3936299,91.30741,4311040
15430,aastha01chauhan,2,0.00005,3936301,91.30746,4311040
15431,AbangSD,2,0.00005,3936303,91.30750,4311040
15432,abbi-gaurav,2,0.00005,3936305,91.30755,4311040
15433,abdelsource,2,0.00005,3936307,91.30760,4311040
15434,abdulsalama,2,0.00005,3936309,91.30764,4311040
15435,aberfeldy,2,0.00005,3936311,91.30769,4311040
15436,abexamir,2,0.00005,3936313,91.30774,4311040
15437,abhaytaras7,2,0.00005,3936315,91.30778,4311040
15438,abhinavmpandey08,2,0.00005,3936317,91.30783,4311040
15439,abhirajputnikku7,2,0.00005,3936319,91.30787,4311040
15440,AbimbolaE,2,0.00005,3936321,91.30792,4311040
15441,abiosoft,2,0.00005,3936323,91.30797,4311040
15442,accelazh,2,0.00005,3936325,91.30801,4311040
15443,acomagu,2,0.00005,3936327,91.30806,4311040
15444,acuteaura,2,0.00005,3936329,91.30811,4311040
15445,adamdepollo,2,0.00005,3936331,91.30815,4311040
15446,adamjohnson01,2,0.00005,3936333,91.30820,4311040
15447,adamrushuk,2,0.00005,3936335,91.30825,4311040
15448,adamtester,2,0.00005,3936337,91.30829,4311040
15449,adarshaj,2,0.00005,3936339,91.30834,4311040
15450,adawolfs,2,0.00005,3936341,91.30838,4311040
15451,addozhang,2,0.00005,3936343,91.30843,4311040
15452,adeleglise,2,0.00005,3936345,91.30848,4311040
15453,adhishmeena,2,0.00005,3936347,91.30852,4311040
15454,adisuissa,2,0.00005,3936349,91.30857,4311040
15455,adityakumar48,2,0.00005,3936351,91.30862,4311040
15456,admiyo,2,0.00005,3936353,91.30866,4311040
15457,adreznec,2,0.00005,3936355,91.30871,4311040
15458,adrianlop,2,0.00005,3936357,91.30876,4311040
15459,adrianosela,2,0.00005,3936359,91.30880,4311040
15460,Aenima4six2,2,0.00005,3936361,91.30885,4311040
15461,aerofoil-kite,2,0.00005,3936363,91.30890,4311040
15462,aFlyBird0,2,0.00005,3936365,91.30894,4311040
15463,afrazkhan,2,0.00005,3936367,91.30899,4311040
15464,afshinm,2,0.00005,3936369,91.30903,4311040
15465,AgentK20,2,0.00005,3936371,91.30908,4311040
15466,agill17,2,0.00005,3936373,91.30913,4311040
15467,agmsb,2,0.00005,3936375,91.30917,4311040
15468,agup006,2,0.00005,3936377,91.30922,4311040
15469,agustinvinao,2,0.00005,3936379,91.30927,4311040
15470,ahardin-rh,2,0.00005,3936381,91.30931,4311040
15471,ahmadidev,2,0.00005,3936383,91.30936,4311040
15472,ahmetgeymen,2,0.00005,3936385,91.30941,4311040
15473,ahsan-storm,2,0.00005,3936387,91.30945,4311040
15474,aikomastboom,2,0.00005,3936389,91.30950,4311040
15475,aioue,2,0.00005,3936391,91.30954,4311040
15476,aisrael,2,0.00005,3936393,91.30959,4311040
15477,ajwock,2,0.00005,3936395,91.30964,4311040
15478,akashgangil,2,0.00005,3936397,91.30968,4311040
15479,AkashKrDutta,2,0.00005,3936399,91.30973,4311040
15480,akavel,2,0.00005,3936401,91.30978,4311040
15481,akfmdl,2,0.00005,3936403,91.30982,4311040
15482,akhilputhiry,2,0.00005,3936405,91.30987,4311040
15483,akirillov,2,0.00005,3936407,91.30992,4311040
15484,akosma,2,0.00005,3936409,91.30996,4311040
15485,akshatcoder-hash,2,0.00005,3936411,91.31001,4311040
15486,akshayjnambiar,2,0.00005,3936413,91.31006,4311040
15487,akstron,2,0.00005,3936415,91.31010,4311040
15488,alain-baxter,2,0.00005,3936417,91.31015,4311040
15489,alanhdu,2,0.00005,3936419,91.31019,4311040
15490,alanwill,2,0.00005,3936421,91.31024,4311040
15491,alberthuang24,2,0.00005,3936423,91.31029,4311040
15492,alebsack,2,0.00005,3936425,91.31033,4311040
15493,alechp,2,0.00005,3936427,91.31038,4311040
15494,alegmal,2,0.00005,3936429,91.31043,4311040
15495,AleiHanami,2,0.00005,3936431,91.31047,4311040
15496,aleksandr-vin,2,0.00005,3936433,91.31052,4311040
15497,aleksey005,2,0.00005,3936435,91.31057,4311040
15498,aleon1220,2,0.00005,3936437,91.31061,4311040
15499,alexander-yu,2,0.00005,3936439,91.31066,4311040
15500,alexandraj777,2,0.00005,3936441,91.31070,4311040
15501,AlexeyPetroff,2,0.00005,3936443,91.31075,4311040
15502,AlexisDuf,2,0.00005,3936445,91.31080,4311040
15503,alexissavin,2,0.00005,3936447,91.31084,4311040
15504,alex-klimov,2,0.00005,3936449,91.31089,4311040
15505,alex-souslik-hs,2,0.00005,3936451,91.31094,4311040
15506,alfianabdi,2,0.00005,3936453,91.31098,4311040
15507,alfredopalhares,2,0.00005,3936455,91.31103,4311040
15508,aljaxus,2,0.00005,3936457,91.31108,4311040
15509,alokhom,2,0.00005,3936459,91.31112,4311040
15510,alon-argus,2,0.00005,3936461,91.31117,4311040
15511,alpozcan,2,0.00005,3936463,91.31121,4311040
15512,alq666,2,0.00005,3936465,91.31126,4311040
15513,alsuren,2,0.00005,3936467,91.31131,4311040
15514,amado-saladino,2,0.00005,3936469,91.31135,4311040
15515,AMeng,2,0.00005,3936471,91.31140,4311040
15516,AmFlint,2,0.00005,3936473,91.31145,4311040
15517,amitkrout,2,0.00005,3936475,91.31149,4311040
15518,amitkumar2013,2,0.00005,3936477,91.31154,4311040
15519,am-MongoDB,2,0.00005,3936479,91.31159,4311040
15520,amrragab8080,2,0.00005,3936481,91.31163,4311040
15521,anagio,2,0.00005,3936483,91.31168,4311040
15522,Ananasr,2,0.00005,3936485,91.31173,4311040
15523,anandgbhat,2,0.00005,3936487,91.31177,4311040
15524,anderson4u2,2,0.00005,3936489,91.31182,4311040
15525,andras-gerendas,2,0.00005,3936491,91.31186,4311040
15526,andrealmar,2,0.00005,3936493,91.31191,4311040
15527,andreamaruccia,2,0.00005,3936495,91.31196,4311040
15528,andrebriggs,2,0.00005,3936497,91.31200,4311040
15529,andrecastro,2,0.00005,3936499,91.31205,4311040
15530,andrewjjenkins,2,0.00005,3936501,91.31210,4311040
15531,andrewmed,2,0.00005,3936503,91.31214,4311040
15532,AndrewNeudegg,2,0.00005,3936505,91.31219,4311040
15533,andrewrothman,2,0.00005,3936507,91.31224,4311040
15534,andrewschmidt-a,2,0.00005,3936509,91.31228,4311040
15535,andrewseidl,2,0.00005,3936511,91.31233,4311040
15536,andriisoldatenko,2,0.00005,3936513,91.31237,4311040
15537,andrsp,2,0.00005,3936515,91.31242,4311040
15538,andskli,2,0.00005,3936517,91.31247,4311040
15539,andyli,2,0.00005,3936519,91.31251,4311040
15540,andysnowden,2,0.00005,3936521,91.31256,4311040
15541,Aneurysm9,2,0.00005,3936523,91.31261,4311040
15542,angellk,2,0.00005,3936525,91.31265,4311040
15543,angularsen,2,0.00005,3936527,91.31270,4311040
15544,anilarora,2,0.00005,3936529,91.31275,4311040
15545,anilkumar56,2,0.00005,3936531,91.31279,4311040
15546,ankitjain28may,2,0.00005,3936533,91.31284,4311040
15547,ankushchadha,2,0.00005,3936535,91.31289,4311040
15548,annerajb,2,0.00005,3936537,91.31293,4311040
15549,anonymoustux,2,0.00005,3936539,91.31298,4311040
15550,anthonyliriano,2,0.00005,3936541,91.31302,4311040
15551,antoinecarton,2,0.00005,3936543,91.31307,4311040
15552,antoinerg,2,0.00005,3936545,91.31312,4311040
15553,antonmatsiuk,2,0.00005,3936547,91.31316,4311040
15554,anton-yurchenko,2,0.00005,3936549,91.31321,4311040
15555,anuprout,2,0.00005,3936551,91.31326,4311040
15556,apettinen,2,0.00005,3936553,91.31330,4311040
15557,apoland,2,0.00005,3936555,91.31335,4311040
15558,arbeit,2,0.00005,3936557,91.31340,4311040
15559,arekkas,2,0.00005,3936559,91.31344,4311040
15560,aressem,2,0.00005,3936561,91.31349,4311040
15561,arielweinberger,2,0.00005,3936563,91.31353,4311040
15562,ArloL,2,0.00005,3936565,91.31358,4311040
15563,arnoldbechtoldt,2,0.00005,3936567,91.31363,4311040
15564,arpitjindal97,2,0.00005,3936569,91.31367,4311040
15565,ArtemChekunov,2,0.00005,3936571,91.31372,4311040
15566,arthurvanduynhoven,2,0.00005,3936573,91.31377,4311040
15567,arthurzenika,2,0.00005,3936575,91.31381,4311040
15568,artkoshelev,2,0.00005,3936577,91.31386,4311040
15569,arunk-s,2,0.00005,3936579,91.31391,4311040
15570,arunramachandran15,2,0.00005,3936581,91.31395,4311040
15571,ArWeder,2,0.00005,3936583,91.31400,4311040
15572,arya,2,0.00005,3936585,91.31404,4311040
15573,asaintsever,2,0.00005,3936587,91.31409,4311040
15574,ashak,2,0.00005,3936589,91.31414,4311040
15575,ashconnell,2,0.00005,3936591,91.31418,4311040
15576,asomya,2,0.00005,3936593,91.31423,4311040
15577,assafad,2,0.00005,3936595,91.31428,4311040
15578,atotto,2,0.00005,3936597,91.31432,4311040
15579,atsikham,2,0.00005,3936599,91.31437,4311040
15580,aurcioli-handy,2,0.00005,3936601,91.31442,4311040
15581,aussielunix,2,0.00005,3936603,91.31446,4311040
15582,austinbv,2,0.00005,3936605,91.31451,4311040
15583,AustinSmart,2,0.00005,3936607,91.31456,4311040
15584,averri,2,0.00005,3936609,91.31460,4311040
15585,AvikantSrivastava,2,0.00005,3936611,91.31465,4311040
15586,awltux,2,0.00005,3936613,91.31469,4311040
15587,axelborja,2,0.00005,3936615,91.31474,4311040
15588,ayaranga,2,0.00005,3936617,91.31479,4311040
15589,aywrite,2,0.00005,3936619,91.31483,4311040
15590,babilen,2,0.00005,3936621,91.31488,4311040
15591,BabisK,2,0.00005,3936623,91.31493,4311040
15592,bdlb77,2,0.00005,3936625,91.31497,4311040
15593,beldougie,2,0.00005,3936627,91.31502,4311040
15594,benchen216,2,0.00005,3936629,91.31507,4311040
15595,benesch,2,0.00005,3936631,91.31511,4311040
15596,benhemp,2,0.00005,3936633,91.31516,4311040
15597,benjamin658,2,0.00005,3936635,91.31520,4311040
15598,BenjaminHerbert,2,0.00005,3936637,91.31525,4311040
15599,bensigelman,2,0.00005,3936639,91.31530,4311040
15600,benvitale,2,0.00005,3936641,91.31534,4311040
15601,benzvan,2,0.00005,3936643,91.31539,4311040
15602,bergeron,2,0.00005,3936645,91.31544,4311040
15603,berndtj,2,0.00005,3936647,91.31548,4311040
15604,BernhardLenz,2,0.00005,3936649,91.31553,4311040
15605,bflorat,2,0.00005,3936651,91.31558,4311040
15606,bh90210,2,0.00005,3936653,91.31562,4311040
15607,BhairaviSanskriti,2,0.00005,3936655,91.31567,4311040
15608,Bhashit,2,0.00005,3936657,91.31572,4311040
15609,BHSDuncan,2,0.00005,3936659,91.31576,4311040
15610,biblesyme,2,0.00005,3936661,91.31581,4311040
15611,BillyMorgan,2,0.00005,3936663,91.31585,4311040
15612,billyoung,2,0.00005,3936665,91.31590,4311040
15613,bimtauer,2,0.00005,3936667,91.31595,4311040
15614,bingoarun,2,0.00005,3936669,91.31599,4311040
15615,Bioblaze,2,0.00005,3936671,91.31604,4311040
15616,bitfactory-henno-schooljan,2,0.00005,3936673,91.31609,4311040
15617,bjaworski3,2,0.00005,3936675,91.31613,4311040
15618,bkrannich,2,0.00005,3936677,91.31618,4311040
15619,BlackTurtle123,2,0.00005,3936679,91.31623,4311040
15620,blafry,2,0.00005,3936681,91.31627,4311040
15621,blaise-sumo,2,0.00005,3936683,91.31632,4311040
15622,blaketastic2,2,0.00005,3936685,91.31636,4311040
15623,blalor,2,0.00005,3936687,91.31641,4311040
15624,blkperl,2,0.00005,3936689,91.31646,4311040
15625,Blokje5,2,0.00005,3936691,91.31650,4311040
15626,bloudman,2,0.00005,3936693,91.31655,4311040
15627,b-m-f,2,0.00005,3936695,91.31660,4311040
15628,bmhatfield,2,0.00005,3936697,91.31664,4311040
15629,bmorton,2,0.00005,3936699,91.31669,4311040
15630,bobbywatson3,2,0.00005,3936701,91.31674,4311040
15631,bobdoah,2,0.00005,3936703,91.31678,4311040
15632,bobjiang82,2,0.00005,3936705,91.31683,4311040
15633,boonware,2,0.00005,3936707,91.31687,4311040
15634,Box-Cube,2,0.00005,3936709,91.31692,4311040
15635,bpaquet,2,0.00005,3936711,91.31697,4311040
15636,bracki,2,0.00005,3936713,91.31701,4311040
15637,brandon-dacrib,2,0.00005,3936715,91.31706,4311040
15638,brandonkal,2,0.00005,3936717,91.31711,4311040
15639,brantb,2,0.00005,3936719,91.31715,4311040
15640,brantburnett,2,0.00005,3936721,91.31720,4311040
15641,bratao,2,0.00005,3936723,91.31725,4311040
15642,brauner,2,0.00005,3936725,91.31729,4311040
15643,brawer,2,0.00005,3936727,91.31734,4311040
15644,brennancheung,2,0.00005,3936729,91.31739,4311040
15645,brenwhyte,2,0.00005,3936731,91.31743,4311040
15646,brezerk,2,0.00005,3936733,91.31748,4311040
15647,brianduff,2,0.00005,3936735,91.31752,4311040
15648,brimworks,2,0.00005,3936737,91.31757,4311040
15649,brissenden,2,0.00005,3936739,91.31762,4311040
15650,BRONSOLO,2,0.00005,3936741,91.31766,4311040
15651,brunoluiz,2,0.00005,3936743,91.31771,4311040
15652,BrunoQuaresma,2,0.00005,3936745,91.31776,4311040
15653,bryanbecker,2,0.00005,3936747,91.31780,4311040
15654,bryaneburr,2,0.00005,3936749,91.31785,4311040
15655,bryanrideshark,2,0.00005,3936751,91.31790,4311040
15656,brycekahle,2,0.00005,3936753,91.31794,4311040
15657,bsideup,2,0.00005,3936755,91.31799,4311040
15658,bskim45,2,0.00005,3936757,91.31803,4311040
15659,buchgr,2,0.00005,3936759,91.31808,4311040
15660,bxker,2,0.00005,3936761,91.31813,4311040
15661,byazrail,2,0.00005,3936763,91.31817,4311040
15662,bymafmaf,2,0.00005,3936765,91.31822,4311040
15663,byronmccollum,2,0.00005,3936767,91.31827,4311040
15664,byteknacker,2,0.00005,3936769,91.31831,4311040
15665,C123R,2,0.00005,3936771,91.31836,4311040
15666,calerogers,2,0.00005,3936773,91.31841,4311040
15667,cameronkerrnz,2,0.00005,3936775,91.31845,4311040
15668,canadiannomad,2,0.00005,3936777,91.31850,4311040
15669,caniggiagoal,2,0.00005,3936779,91.31854,4311040
15670,carletes,2,0.00005,3936781,91.31859,4311040
15671,carolove,2,0.00005,3936783,91.31864,4311040
15672,ca-scribner,2,0.00005,3936785,91.31868,4311040
15673,cassianoleal,2,0.00005,3936787,91.31873,4311040
15674,CathPag,2,0.00005,3936789,91.31878,4311040
15675,caueasantos,2,0.00005,3936791,91.31882,4311040
15676,cazorla19,2,0.00005,3936793,91.31887,4311040
15677,cbanek,2,0.00005,3936795,91.31892,4311040
15678,cbrand,2,0.00005,3936797,91.31896,4311040
15679,cch0,2,0.00005,3936799,91.31901,4311040
15680,ccs018,2,0.00005,3936801,91.31906,4311040
15681,cdjohnson,2,0.00005,3936803,91.31910,4311040
15682,cepefernando,2,0.00005,3936805,91.31915,4311040
15683,cfarrend,2,0.00005,3936807,91.31919,4311040
15684,cfiderer,2,0.00005,3936809,91.31924,4311040
15685,chakravarthy392,2,0.00005,3936811,91.31929,4311040
15686,charlesa101,2,0.00005,3936813,91.31933,4311040
15687,charlesguo404,2,0.00005,3936815,91.31938,4311040
15688,charlieegan3,2,0.00005,3936817,91.31943,4311040
15689,charlieoleary,2,0.00005,3936819,91.31947,4311040
15690,ChaseMor,2,0.00005,3936821,91.31952,4311040
15691,chaunceyt,2,0.00005,3936823,91.31957,4311040
15692,ChenjunZou,2,0.00005,3936825,91.31961,4311040
15693,chhsia0,2,0.00005,3936827,91.31966,4311040
15694,chicagozer,2,0.00005,3936829,91.31970,4311040
15695,chicofranchico,2,0.00005,3936831,91.31975,4311040
15696,chillaxd,2,0.00005,3936833,91.31980,4311040
15697,chirino,2,0.00005,3936835,91.31984,4311040
15698,chobostar,2,0.00005,3936837,91.31989,4311040
15699,cholick,2,0.00005,3936839,91.31994,4311040
15700,chrisingenhaag,2,0.00005,3936841,91.31998,4311040
15701,chrisleck-old-personal,2,0.00005,3936843,91.32003,4311040
15702,chris-mccoy,2,0.00005,3936845,91.32008,4311040
15703,chrismytton,2,0.00005,3936847,91.32012,4311040
15704,chrisnew,2,0.00005,3936849,91.32017,4311040
15705,chris-sanders,2,0.00005,3936851,91.32022,4311040
15706,chris-smith-zocdoc,2,0.00005,3936853,91.32026,4311040
15707,christian1607,2,0.00005,3936855,91.32031,4311040
15708,christopher-avila,2,0.00005,3936857,91.32035,4311040
15709,christopherL91,2,0.00005,3936859,91.32040,4311040
15710,chris-vest,2,0.00005,3936861,91.32045,4311040
15711,chuegel,2,0.00005,3936863,91.32049,4311040
15712,cihangirbesiktas,2,0.00005,3936865,91.32054,4311040
15713,ciokan,2,0.00005,3936867,91.32059,4311040
15714,ciroque,2,0.00005,3936869,91.32063,4311040
15715,ckeragala,2,0.00005,3936871,91.32068,4311040
15716,ckocyigit,2,0.00005,3936873,91.32073,4311040
15717,Clasyc,2,0.00005,3936875,91.32077,4311040
15718,clsacramento,2,0.00005,3936877,91.32082,4311040
15719,cmontemuino,2,0.00005,3936879,91.32086,4311040
15720,cmosetick,2,0.00005,3936881,91.32091,4311040
15721,cmrust,2,0.00005,3936883,91.32096,4311040
15722,cnf,2,0.00005,3936885,91.32100,4311040
15723,coadler,2,0.00005,3936887,91.32105,4311040
15724,CodeGlitcher,2,0.00005,3936889,91.32110,4311040
15725,codemonkey77,2,0.00005,3936891,91.32114,4311040
15726,codemug,2,0.00005,3936893,91.32119,4311040
15727,codergr,2,0.00005,3936895,91.32124,4311040
15728,codificat,2,0.00005,3936897,91.32128,4311040
15729,CodingSinger,2,0.00005,3936899,91.32133,4311040
15730,cognoz,2,0.00005,3936901,91.32137,4311040
15731,cog-qlik,2,0.00005,3936903,91.32142,4311040
15732,coliff,2,0.00005,3936905,91.32147,4311040
15733,complex64,2,0.00005,3936907,91.32151,4311040
15734,conorcurlett,2,0.00005,3936909,91.32156,4311040
15735,CooperLi,2,0.00005,3936911,91.32161,4311040
15736,corinnekrych,2,0.00005,3936913,91.32165,4311040
15737,cortopy,2,0.00005,3936915,91.32170,4311040
15738,costa,2,0.00005,3936917,91.32175,4311040
15739,craicoverflow,2,0.00005,3936919,91.32179,4311040
15740,crcsmnky,2,0.00005,3936921,91.32184,4311040
15741,cricket007,2,0.00005,3936923,91.32189,4311040
15742,cromega,2,0.00005,3936925,91.32193,4311040
15743,Cryson,2,0.00005,3936927,91.32198,4311040
15744,crystaldust,2,0.00005,3936929,91.32202,4311040
15745,cschockaert,2,0.00005,3936931,91.32207,4311040
15746,csschwe,2,0.00005,3936933,91.32212,4311040
15747,ctriv,2,0.00005,3936935,91.32216,4311040
15748,CTrox,2,0.00005,3936937,91.32221,4311040
15749,CuBiC3D,2,0.00005,3936939,91.32226,4311040
15750,curantes,2,0.00005,3936941,91.32230,4311040
15751,curlup,2,0.00005,3936943,91.32235,4311040
15752,cyclingwithelephants,2,0.00005,3936945,91.32240,4311040
15753,CypherpunkSamurai,2,0.00005,3936947,91.32244,4311040
15754,cyxinda,2,0.00005,3936949,91.32249,4311040
15755,dalekurt,2,0.00005,3936951,91.32253,4311040
15756,damienwebdev,2,0.00005,3936953,91.32258,4311040
15757,danicat,2,0.00005,3936955,91.32263,4311040
15758,danieldn,2,0.00005,3936957,91.32267,4311040
15759,danielduduta,2,0.00005,3936959,91.32272,4311040
15760,danielpeach,2,0.00005,3936961,91.32277,4311040
15761,danieltharp,2,0.00005,3936963,91.32281,4311040
15762,danihodovic,2,0.00005,3936965,91.32286,4311040
15763,dankirkpatrick,2,0.00005,3936967,91.32291,4311040
15764,DanSmith70,2,0.00005,3936969,91.32295,4311040
15765,DanStough,2,0.00005,3936971,91.32300,4311040
15766,darend,2,0.00005,3936973,91.32305,4311040
15767,dariusj18,2,0.00005,3936975,91.32309,4311040
15768,darrenstahlmsft,2,0.00005,3936977,91.32314,4311040
15769,datuanmac,2,0.00005,3936979,91.32318,4311040
15770,Dav1dde,2,0.00005,3936981,91.32323,4311040
15771,davelosert,2,0.00005,3936983,91.32328,4311040
15772,davetropeano,2,0.00005,3936985,91.32332,4311040
15773,david50407,2,0.00005,3936987,91.32337,4311040
15774,davidcollom,2,0.00005,3936989,91.32342,4311040
15775,davidesalerno,2,0.00005,3936991,91.32346,4311040
15776,david-l-riley,2,0.00005,3936993,91.32351,4311040
15777,davsclaus,2,0.00005,3936995,91.32356,4311040
15778,dboshardy,2,0.00005,3936997,91.32360,4311040
15779,dchickabasapa,2,0.00005,3936999,91.32365,4311040
15780,ddl-risong-na,2,0.00005,3937001,91.32369,4311040
15781,deas,2,0.00005,3937003,91.32374,4311040
15782,deed02392,2,0.00005,3937005,91.32379,4311040
15783,deepgorthi,2,0.00005,3937007,91.32383,4311040
15784,dehypnosis,2,0.00005,3937009,91.32388,4311040
15785,delta440,2,0.00005,3937011,91.32393,4311040
15786,demshin,2,0.00005,3937013,91.32397,4311040
15787,depauna,2,0.00005,3937015,91.32402,4311040
15788,derekbassett,2,0.00005,3937017,91.32407,4311040
15789,Dexyon,2,0.00005,3937019,91.32411,4311040
15790,dfawley,2,0.00005,3937021,91.32416,4311040
15791,dfjones,2,0.00005,3937023,91.32420,4311040
15792,dgerd,2,0.00005,3937025,91.32425,4311040
15793,dheerajjoshim,2,0.00005,3937027,91.32430,4311040
15794,dhilipsiva,2,0.00005,3937029,91.32434,4311040
15795,dhiraj0911,2,0.00005,3937031,91.32439,4311040
15796,dictcp,2,0.00005,3937033,91.32444,4311040
15797,diegomarangoni,2,0.00005,3937035,91.32448,4311040
15798,dieterguendisch,2,0.00005,3937037,91.32453,4311040
15799,diffoperator,2,0.00005,3937039,91.32458,4311040
15800,diist,2,0.00005,3937041,91.32462,4311040
15801,dilekuzulmez,2,0.00005,3937043,91.32467,4311040
15802,Dimss,2,0.00005,3937045,91.32472,4311040
15803,dingdayu,2,0.00005,3937047,91.32476,4311040
15804,dipak-pawar,2,0.00005,3937049,91.32481,4311040
15805,diptadas,2,0.00005,3937051,91.32485,4311040
15806,dirtycajunrice,2,0.00005,3937053,91.32490,4311040
15807,discoposse,2,0.00005,3937055,91.32495,4311040
15808,Disturbing,2,0.00005,3937057,91.32499,4311040
15809,divanikus,2,0.00005,3937059,91.32504,4311040
15810,divyam3897,2,0.00005,3937061,91.32509,4311040
15811,Djelibeybi,2,0.00005,3937063,91.32513,4311040
15812,dj-hedgehog,2,0.00005,3937065,91.32518,4311040
15813,djMax,2,0.00005,3937067,91.32523,4311040
15814,djwhatle,2,0.00005,3937069,91.32527,4311040
15815,dlbewley,2,0.00005,3937071,91.32532,4311040
15816,dmichel1,2,0.00005,3937073,91.32536,4311040
15817,dmitrii-didenko,2,0.00005,3937075,91.32541,4311040
15818,dmsimard,2,0.00005,3937077,91.32546,4311040
15819,dmueller2001,2,0.00005,3937079,91.32550,4311040
15820,dnivra26,2,0.00005,3937081,91.32555,4311040
15821,dogonthehorizon,2,0.00005,3937083,91.32560,4311040
15822,dolfolife,2,0.00005,3937085,91.32564,4311040
15823,donaldliu,2,0.00005,3937087,91.32569,4311040
15824,dong-liuliu,2,0.00005,3937089,91.32574,4311040
15825,donovanmuller,2,0.00005,3937091,91.32578,4311040
15826,dontlaugh,2,0.00005,3937093,91.32583,4311040
15827,dozer75,2,0.00005,3937095,91.32587,4311040
15828,dpiessens,2,0.00005,3937097,91.32592,4311040
15829,dpinchukov-ueni,2,0.00005,3937099,91.32597,4311040
15830,dpolicastro,2,0.00005,3937101,91.32601,4311040
15831,DPS0340,2,0.00005,3937103,91.32606,4311040
15832,dragan,2,0.00005,3937105,91.32611,4311040
15833,dragosrosculete,2,0.00005,3937107,91.32615,4311040
15834,dreadbird,2,0.00005,3937109,91.32620,4311040
15835,DreamRivulet,2,0.00005,3937111,91.32625,4311040
15836,dseapy,2,0.00005,3937113,91.32629,4311040
15837,dshackith,2,0.00005,3937115,91.32634,4311040
15838,dshmatov,2,0.00005,3937117,91.32639,4311040
15839,dstockton,2,0.00005,3937119,91.32643,4311040
15840,duanhaowei,2,0.00005,3937121,91.32648,4311040
15841,dubek,2,0.00005,3937123,91.32652,4311040
15842,duderino,2,0.00005,3937125,91.32657,4311040
15843,d-ulyanov,2,0.00005,3937127,91.32662,4311040
15844,duncaan,2,0.00005,3937129,91.32666,4311040
15845,durana,2,0.00005,3937131,91.32671,4311040
15846,duxing,2,0.00005,3937133,91.32676,4311040
15847,d-uzlov,2,0.00005,3937135,91.32680,4311040
15848,dvbdard,2,0.00005,3937137,91.32685,4311040
15849,dweomer,2,0.00005,3937139,91.32690,4311040
15850,Dysproz,2,0.00005,3937141,91.32694,4311040
15851,ealebed,2,0.00005,3937143,91.32699,4311040
15852,eamonnmcmanus,2,0.00005,3937145,91.32703,4311040
15853,ebullient,2,0.00005,3937147,91.32708,4311040
15854,ecourreges-orange,2,0.00005,3937149,91.32713,4311040
15855,ed0t,2,0.00005,3937151,91.32717,4311040
15856,eddiewang,2,0.00005,3937153,91.32722,4311040
15857,edeNFed,2,0.00005,3937155,91.32727,4311040
15858,EdgeJ,2,0.00005,3937157,91.32731,4311040
15859,eduardobcastro,2,0.00005,3937159,91.32736,4311040
15860,eduherminio,2,0.00005,3937161,91.32741,4311040
15861,edwardgeorge,2,0.00005,3937163,91.32745,4311040
15862,Edwardro22,2,0.00005,3937165,91.32750,4311040
15863,eedorenko,2,0.00005,3937167,91.32755,4311040
15864,eestewart,2,0.00005,3937169,91.32759,4311040
15865,EgorSysoev,2,0.00005,3937171,91.32764,4311040
15866,eharney,2,0.00005,3937173,91.32768,4311040
15867,eigokor,2,0.00005,3937175,91.32773,4311040
15868,ekkoful,2,0.00005,3937177,91.32778,4311040
15869,eldios,2,0.00005,3937179,91.32782,4311040
15870,electrical,2,0.00005,3937181,91.32787,4311040
15871,eLobato,2,0.00005,3937183,91.32792,4311040
15872,elsony,2,0.00005,3937185,91.32796,4311040
15873,elsteelbrain,2,0.00005,3937187,91.32801,4311040
15874,emalihin,2,0.00005,3937189,91.32806,4311040
15875,emenendez,2,0.00005,3937191,91.32810,4311040
15876,emmahsax,2,0.00005,3937193,91.32815,4311040
15877,eneamarcantoni99,2,0.00005,3937195,91.32819,4311040
15878,enis,2,0.00005,3937197,91.32824,4311040
15879,enozero,2,0.00005,3937199,91.32829,4311040
15880,enp0s3,2,0.00005,3937201,91.32833,4311040
15881,enrichman,2,0.00005,3937203,91.32838,4311040
15882,epixa,2,0.00005,3937205,91.32843,4311040
15883,erebe,2,0.00005,3937207,91.32847,4311040
15884,erhhung,2,0.00005,3937209,91.32852,4311040
15885,eric-isakson,2,0.00005,3937211,91.32857,4311040
15886,eripa,2,0.00005,3937213,91.32861,4311040
15887,erjohnso,2,0.00005,3937215,91.32866,4311040
15888,ernie,2,0.00005,3937217,91.32870,4311040
15889,errows,2,0.00005,3937219,91.32875,4311040
15890,esnible,2,0.00005,3937221,91.32880,4311040
15891,etheleon,2,0.00005,3937223,91.32884,4311040
15892,etungsten,2,0.00005,3937225,91.32889,4311040
15893,eugenenuke,2,0.00005,3937227,91.32894,4311040
15894,EugenMayer,2,0.00005,3937229,91.32898,4311040
15895,evan2645,2,0.00005,3937231,91.32903,4311040
15896,evgmoskalenko,2,0.00005,3937233,91.32908,4311040
15897,exiaohao,2,0.00005,3937235,91.32912,4311040
15898,eyalcha,2,0.00005,3937237,91.32917,4311040
15899,eyeezzi,2,0.00005,3937239,91.32922,4311040
15900,ezalejski,2,0.00005,3937241,91.32926,4311040
15901,ezimanyi,2,0.00005,3937243,91.32931,4311040
15902,ezraroi,2,0.00005,3937245,91.32935,4311040
15903,fabricev,2,0.00005,3937247,91.32940,4311040
15904,fantayeneh,2,0.00005,3937249,91.32945,4311040
15905,fastlorenzo,2,0.00005,3937251,91.32949,4311040
15906,fatz,2,0.00005,3937253,91.32954,4311040
15907,faun,2,0.00005,3937255,91.32959,4311040
15908,fbongiovanni29,2,0.00005,3937257,91.32963,4311040
15909,fcddk,2,0.00005,3937259,91.32968,4311040
15910,fduthilleul,2,0.00005,3937261,91.32973,4311040
15911,felippe-mendonca,2,0.00005,3937263,91.32977,4311040
15912,fen4o-work,2,0.00005,3937265,91.32982,4311040
15913,Ferat-Imrak,2,0.00005,3937267,91.32986,4311040
15914,ferdi-bedag,2,0.00005,3937269,91.32991,4311040
15915,ferrarimarco,2,0.00005,3937271,91.32996,4311040
15916,ffilz,2,0.00005,3937273,91.33000,4311040
15917,fgeorgatos,2,0.00005,3937275,91.33005,4311040
15918,fhuaddeterminas,2,0.00005,3937277,91.33010,4311040
15919,filippomc,2,0.00005,3937279,91.33014,4311040
15920,film42,2,0.00005,3937281,91.33019,4311040
15921,Firemango,2,0.00005,3937283,91.33024,4311040
15922,flacatus,2,0.00005,3937285,91.33028,4311040
15923,Fleshgrinder,2,0.00005,3937287,91.33033,4311040
15924,flipsed,2,0.00005,3937289,91.33038,4311040
15925,flyhard,2,0.00005,3937291,91.33042,4311040
15926,flypenguin,2,0.00005,3937293,91.33047,4311040
15927,fmmatthewzeemann,2,0.00005,3937295,91.33051,4311040
15928,fmotrifork,2,0.00005,3937297,91.33056,4311040
15929,fmui,2,0.00005,3937299,91.33061,4311040
15930,fordhamae,2,0.00005,3937301,91.33065,4311040
15931,fouadsemaan,2,0.00005,3937303,91.33070,4311040
15932,FourFifthsCode,2,0.00005,3937305,91.33075,4311040
15933,FranBarrera,2,0.00005,3937307,91.33079,4311040
15934,francesco-beccaria,2,0.00005,3937309,91.33084,4311040
15935,frauniki,2,0.00005,3937311,91.33089,4311040
15936,frdeng,2,0.00005,3937313,91.33093,4311040
15937,FreedomBen,2,0.00005,3937315,91.33098,4311040
15938,Fresa,2,0.00005,3937317,91.33102,4311040
15939,frimik,2,0.00005,3937319,91.33107,4311040
15940,fstab,2,0.00005,3937321,91.33112,4311040
15941,fvdnabee,2,0.00005,3937323,91.33116,4311040
15942,fyang-pivotal,2,0.00005,3937325,91.33121,4311040
15943,gaborbernat,2,0.00005,3937327,91.33126,4311040
15944,gabrie30,2,0.00005,3937329,91.33130,4311040
15945,gabrielbatir,2,0.00005,3937331,91.33135,4311040
15946,GabrielCiordas,2,0.00005,3937333,91.33140,4311040
15947,gabyx,2,0.00005,3937335,91.33144,4311040
15948,gaddamas,2,0.00005,3937337,91.33149,4311040
15949,gamunu,2,0.00005,3937339,91.33153,4311040
15950,gandelman-a,2,0.00005,3937341,91.33158,4311040
15951,ganniterix,2,0.00005,3937343,91.33163,4311040
15952,gaodan-fang,2,0.00005,3937345,91.33167,4311040
15953,gardlt,2,0.00005,3937347,91.33172,4311040
15954,garfield009,2,0.00005,3937349,91.33177,4311040
15955,garrardkitchen,2,0.00005,3937351,91.33181,4311040
15956,garreeoke,2,0.00005,3937353,91.33186,4311040
15957,garyo,2,0.00005,3937355,91.33191,4311040
15958,garystafford,2,0.00005,3937357,91.33195,4311040
15959,gauravgahlot,2,0.00005,3937359,91.33200,4311040
15960,gaurav-nelson,2,0.00005,3937361,91.33205,4311040
15961,gdhgdhgdh,2,0.00005,3937363,91.33209,4311040
15962,geass,2,0.00005,3937365,91.33214,4311040
15963,gebi,2,0.00005,3937367,91.33218,4311040
15964,gedgar,2,0.00005,3937369,91.33223,4311040
15965,geekdave,2,0.00005,3937371,91.33228,4311040
15966,geofflamrock,2,0.00005,3937373,91.33232,4311040
15967,geota,2,0.00005,3937375,91.33237,4311040
15968,GerardoGR,2,0.00005,3937377,91.33242,4311040
15969,gershwinlabs,2,0.00005,3937379,91.33246,4311040
15970,ggarnier,2,0.00005,3937381,91.33251,4311040
15971,ggermis,2,0.00005,3937383,91.33256,4311040
15972,ghasemloo,2,0.00005,3937385,91.33260,4311040
15973,Ghost---Shadow,2,0.00005,3937387,91.33265,4311040
15974,gibson042,2,0.00005,3937389,91.33269,4311040
15975,gigawhat,2,0.00005,3937391,91.33274,4311040
15976,gijzelaerr,2,0.00005,3937393,91.33279,4311040
15977,giovannicandido,2,0.00005,3937395,91.33283,4311040
15978,gitoverflow,2,0.00005,3937397,91.33288,4311040
15979,gjacquet,2,0.00005,3937399,91.33293,4311040
15980,gkumarchilakala,2,0.00005,3937401,91.33297,4311040
15981,gkze,2,0.00005,3937403,91.33302,4311040
15982,glefloch,2,0.00005,3937405,91.33307,4311040
15983,GLVSKiriti,2,0.00005,3937407,91.33311,4311040
15984,gonzochic,2,0.00005,3937409,91.33316,4311040
15985,gowrav27,2,0.00005,3937411,91.33320,4311040
15986,gr4701,2,0.00005,3937413,91.33325,4311040
15987,gracewehner,2,0.00005,3937415,91.33330,4311040
15988,grantstephens,2,0.00005,3937417,91.33334,4311040
15989,grealish,2,0.00005,3937419,91.33339,4311040
15990,greenaar,2,0.00005,3937421,91.33344,4311040
15991,gregbacchus,2,0.00005,3937423,91.33348,4311040
15992,gregdurham,2,0.00005,3937425,91.33353,4311040
15993,gregorygtseng,2,0.00005,3937427,91.33358,4311040
15994,grischa,2,0.00005,3937429,91.33362,4311040
15995,grobbie,2,0.00005,3937431,91.33367,4311040
15996,grzechukol,2,0.00005,3937433,91.33372,4311040
15997,gueux,2,0.00005,3937435,91.33376,4311040
15998,guice,2,0.00005,3937437,91.33381,4311040
15999,guillaumBrisard,2,0.00005,3937439,91.33385,4311040
16000,guillaumefenollar,2,0.00005,3937441,91.33390,4311040
16001,gunyarakun,2,0.00005,3937443,91.33395,4311040
16002,gzur,2,0.00005,3937445,91.33399,4311040
16003,h7kanna,2,0.00005,3937447,91.33404,4311040
16004,haani-niyaz,2,0.00005,3937449,91.33409,4311040
16005,hackabletype,2,0.00005,3937451,91.33413,4311040
16006,handlers,2,0.00005,3937453,91.33418,4311040
16007,hanyuancheung,2,0.00005,3937455,91.33423,4311040
16008,harshthakur9030,2,0.00005,3937457,91.33427,4311040
16009,harshul4274,2,0.00005,3937459,91.33432,4311040
16010,hbobenicio,2,0.00005,3937461,91.33436,4311040
16011,HeavyWombat,2,0.00005,3937463,91.33441,4311040
16012,hellokangning,2,0.00005,3937465,91.33446,4311040
16013,helsaawy,2,0.00005,3937467,91.33450,4311040
16014,henrysecond1,2,0.00005,3937469,91.33455,4311040
16015,heroic,2,0.00005,3937471,91.33460,4311040
16016,hichihara,2,0.00005,3937473,91.33464,4311040
16017,hichtakk,2,0.00005,3937475,91.33469,4311040
16018,hkroger,2,0.00005,3937477,91.33474,4311040
16019,hnykda,2,0.00005,3937479,91.33478,4311040
16020,hokkai7go,2,0.00005,3937481,91.33483,4311040
16021,holdenk,2,0.00005,3937483,91.33488,4311040
16022,hongkongkiwi,2,0.00005,3937485,91.33492,4311040
16023,houwengang,2,0.00005,3937487,91.33497,4311040
16024,hq6,2,0.00005,3937489,91.33501,4311040
16025,hrobertson,2,0.00005,3937491,91.33506,4311040
16026,hsluoyz,2,0.00005,3937493,91.33511,4311040
16027,huangxinxin-szu,2,0.00005,3937495,91.33515,4311040
16028,hudymi,2,0.00005,3937497,91.33520,4311040
16029,hugomcfonseca,2,0.00005,3937499,91.33525,4311040
16030,huide9,2,0.00005,3937501,91.33529,4311040
16031,HumairAK,2,0.00005,3937503,91.33534,4311040
16032,hwchiu,2,0.00005,3937505,91.33539,4311040
16033,iainbowman,2,0.00005,3937507,91.33543,4311040
16034,iamgd67,2,0.00005,3937509,91.33548,4311040
16035,iamrare,2,0.00005,3937511,91.33552,4311040
16036,ianberinger,2,0.00005,3937513,91.33557,4311040
16037,iancoffey,2,0.00005,3937515,91.33562,4311040
16038,ianlancetaylor,2,0.00005,3937517,91.33566,4311040
16039,ianonavy,2,0.00005,3937519,91.33571,4311040
16040,ianvernon,2,0.00005,3937521,91.33576,4311040
16041,ianzhang366,2,0.00005,3937523,91.33580,4311040
16042,ib-ak,2,0.00005,3937525,91.33585,4311040
16043,idouba,2,0.00005,3937527,91.33590,4311040
16044,iffyio,2,0.00005,3937529,91.33594,4311040
16045,igorcezar,2,0.00005,3937531,91.33599,4311040
16046,igsong,2,0.00005,3937533,91.33603,4311040
16047,ihciah,2,0.00005,3937535,91.33608,4311040
16048,illeatmyhat,2,0.00005,3937537,91.33613,4311040
16049,IlyaBiryukov,2,0.00005,3937539,91.33617,4311040
16050,ilyash,2,0.00005,3937541,91.33622,4311040
16051,imcitius,2,0.00005,3937543,91.33627,4311040
16052,iMoses,2,0.00005,3937545,91.33631,4311040
16053,initcron,2,0.00005,3937547,91.33636,4311040
16054,innobead,2,0.00005,3937549,91.33641,4311040
16055,inuyasha82,2,0.00005,3937551,91.33645,4311040
16056,invent360,2,0.00005,3937553,91.33650,4311040
16057,IoannisMatzaris,2,0.00005,3937555,91.33655,4311040
16058,ionutz89,2,0.00005,3937557,91.33659,4311040
16059,ipbabble,2,0.00005,3937559,91.33664,4311040
16060,ipince,2,0.00005,3937561,91.33668,4311040
16061,irfanhabib,2,0.00005,3937563,91.33673,4311040
16062,irisdingbj,2,0.00005,3937565,91.33678,4311040
16063,ishankhare07,2,0.00005,3937567,91.33682,4311040
16064,ish-xyz,2,0.00005,3937569,91.33687,4311040
16065,itsCheithanya,2,0.00005,3937571,91.33692,4311040
16066,itsmesuniljacob,2,0.00005,3937573,91.33696,4311040
16067,ivanayov,2,0.00005,3937575,91.33701,4311040
16068,ivangfr,2,0.00005,3937577,91.33706,4311040
16069,ivankovnatsky,2,0.00005,3937579,91.33710,4311040
16070,ivar-lazzaro,2,0.00005,3937581,91.33715,4311040
16071,iwita,2,0.00005,3937583,91.33719,4311040
16072,izderadicka,2,0.00005,3937585,91.33724,4311040
16073,izgeri,2,0.00005,3937587,91.33729,4311040
16074,izharaazmi,2,0.00005,3937589,91.33733,4311040
16075,jabbors,2,0.00005,3937591,91.33738,4311040
16076,jabhishek87,2,0.00005,3937593,91.33743,4311040
16077,jacexh,2,0.00005,3937595,91.33747,4311040
16078,JackPott,2,0.00005,3937597,91.33752,4311040
16079,JacksChoco,2,0.00005,3937599,91.33757,4311040
16080,jacob-delgado,2,0.00005,3937601,91.33761,4311040
16081,Jagrutiti,2,0.00005,3937603,91.33766,4311040
16082,jaharkes,2,0.00005,3937605,91.33771,4311040
16083,jamesdube,2,0.00005,3937607,91.33775,4311040
16084,jamesla,2,0.00005,3937609,91.33780,4311040
16085,jamesward,2,0.00005,3937611,91.33784,4311040
16086,jamiecoleman92,2,0.00005,3937613,91.33789,4311040
16087,jamietanna,2,0.00005,3937615,91.33794,4311040
16088,janavenkat,2,0.00005,3937617,91.33798,4311040
16089,jangaraj,2,0.00005,3937619,91.33803,4311040
16090,JanZerebecki,2,0.00005,3937621,91.33808,4311040
16091,JarleB,2,0.00005,3937623,91.33812,4311040
16092,jarvisuser90,2,0.00005,3937625,91.33817,4311040
16093,jasonjlock,2,0.00005,3937627,91.33822,4311040
16094,jasonkeene,2,0.00005,3937629,91.33826,4311040
16095,jasonmoo,2,0.00005,3937631,91.33831,4311040
16096,jasonwzm,2,0.00005,3937633,91.33835,4311040
16097,javafuns,2,0.00005,3937635,91.33840,4311040
16098,JavascriptMick,2,0.00005,3937637,91.33845,4311040
16099,javiku,2,0.00005,3937639,91.33849,4311040
16100,jayanth-sai-v,2,0.00005,3937641,91.33854,4311040
16101,jba,2,0.00005,3937643,91.33859,4311040
16102,jbanety,2,0.00005,3937645,91.33863,4311040
16103,jbielick,2,0.00005,3937647,91.33868,4311040
16104,JcJinChen,2,0.00005,3937649,91.33873,4311040
16105,jc-sanchez,2,0.00005,3937651,91.33877,4311040
16106,jcscottiii,2,0.00005,3937653,91.33882,4311040
16107,jdconley,2,0.00005,3937655,91.33886,4311040
16108,jdfalk,2,0.00005,3937657,91.33891,4311040
16109,jdmulloy,2,0.00005,3937659,91.33896,4311040
16110,jeblair,2,0.00005,3937661,91.33900,4311040
16111,jeffrichie,2,0.00005,3937663,91.33905,4311040
16112,Jeff-Tian,2,0.00005,3937665,91.33910,4311040
16113,jengo,2,0.00005,3937667,91.33914,4311040
16114,jennbriden,2,0.00005,3937669,91.33919,4311040
16115,jensfr,2,0.00005,3937671,91.33924,4311040
16116,jerbob92,2,0.00005,3937673,91.33928,4311040
16117,JeremJR,2,0.00005,3937675,91.33933,4311040
16118,Jeremy-boo,2,0.00005,3937677,91.33938,4311040
16119,jeremych1000,2,0.00005,3937679,91.33942,4311040
16120,JeremyMarshall,2,0.00005,3937681,91.33947,4311040
16121,jerrylam,2,0.00005,3937683,91.33951,4311040
16122,Jeskz0rd,2,0.00005,3937685,91.33956,4311040
16123,jesseduffield,2,0.00005,3937687,91.33961,4311040
16124,JetMuffin,2,0.00005,3937689,91.33965,4311040
16125,jeyaramashok,2,0.00005,3937691,91.33970,4311040
16126,jfillo,2,0.00005,3937693,91.33975,4311040
16127,jfmatth,2,0.00005,3937695,91.33979,4311040
16128,jgilfoil,2,0.00005,3937697,91.33984,4311040
16129,jhagege,2,0.00005,3937699,91.33989,4311040
16130,jhanschoo,2,0.00005,3937701,91.33993,4311040
16131,jhendrixMSFT,2,0.00005,3937703,91.33998,4311040
16132,jhenriquez,2,0.00005,3937705,91.34002,4311040
16133,jhuntoo,2,0.00005,3937707,91.34007,4311040
16134,jinghzhu,2,0.00005,3937709,91.34012,4311040
16135,jinja2,2,0.00005,3937711,91.34016,4311040
16136,jiridanek,2,0.00005,3937713,91.34021,4311040
16137,jitendra319,2,0.00005,3937715,91.34026,4311040
16138,jjshanks,2,0.00005,3937717,91.34030,4311040
16139,jlcrow,2,0.00005,3937719,91.34035,4311040
16140,jleach,2,0.00005,3937721,91.34040,4311040
16141,jmichalek132,2,0.00005,3937723,91.34044,4311040
16142,jmsking,2,0.00005,3937725,91.34049,4311040
16143,jmulcahyTSC,2,0.00005,3937727,91.34053,4311040
16144,jnpr-pranav,2,0.00005,3937729,91.34058,4311040
16145,joegraviton,2,0.00005,3937731,91.34063,4311040
16146,JoeJasinski,2,0.00005,3937733,91.34067,4311040
16147,joeltraber,2,0.00005,3937735,91.34072,4311040
16148,joeyimbasciano,2,0.00005,3937737,91.34077,4311040
16149,joeylin,2,0.00005,3937739,91.34081,4311040
16150,johandry,2,0.00005,3937741,91.34086,4311040
16151,JohanRyberg,2,0.00005,3937743,91.34091,4311040
16152,johnbazan,2,0.00005,3937745,91.34095,4311040
16153,johndistasio,2,0.00005,3937747,91.34100,4311040
16154,johnl,2,0.00005,3937749,91.34105,4311040
16155,JoHuang,2,0.00005,3937751,91.34109,4311040
16156,jomenxiao,2,0.00005,3937753,91.34114,4311040
16157,jonasdkhansen,2,0.00005,3937755,91.34118,4311040
16158,jonatasbaldin,2,0.00005,3937757,91.34123,4311040
16159,Jonathan34,2,0.00005,3937759,91.34128,4311040
16160,jonathan-boudreau-work,2,0.00005,3937761,91.34132,4311040
16161,jonathanperret,2,0.00005,3937763,91.34137,4311040
16162,JooyoungJeong,2,0.00005,3937765,91.34142,4311040
16163,joshdover,2,0.00005,3937767,91.34146,4311040
16164,joshlemer,2,0.00005,3937769,91.34151,4311040
16165,joshskains,2,0.00005,3937771,91.34156,4311040
16166,joshwand,2,0.00005,3937773,91.34160,4311040
16167,jpadams,2,0.00005,3937775,91.34165,4311040
16168,jpeddicord,2,0.00005,3937777,91.34169,4311040
16169,jphuynh,2,0.00005,3937779,91.34174,4311040
16170,jrsdav,2,0.00005,3937781,91.34179,4311040
16171,jSherz,2,0.00005,3937783,91.34183,4311040
16172,jsiebens,2,0.00005,3937785,91.34188,4311040
16173,jskeet,2,0.00005,3937787,91.34193,4311040
16174,jstewart612,2,0.00005,3937789,91.34197,4311040
16175,jtborek,2,0.00005,3937791,91.34202,4311040
16176,jtfogarty,2,0.00005,3937793,91.34207,4311040
16177,JthenG9,2,0.00005,3937795,91.34211,4311040
16178,jtlayton,2,0.00005,3937797,91.34216,4311040
16179,JuHyung-Son,2,0.00005,3937799,91.34221,4311040
16180,juimonen,2,0.00005,3937801,91.34225,4311040
16181,juliaaano,2,0.00005,3937803,91.34230,4311040
16182,julianguinard,2,0.00005,3937805,91.34234,4311040
16183,julianKatz,2,0.00005,3937807,91.34239,4311040
16184,juliengk,2,0.00005,3937809,91.34244,4311040
16185,jungrae-prestolabs,2,0.00005,3937811,91.34248,4311040
16186,justbert,2,0.00005,3937813,91.34253,4311040
16187,Justin2997,2,0.00005,3937815,91.34258,4311040
16188,justincely,2,0.00005,3937817,91.34262,4311040
16189,justintime,2,0.00005,3937819,91.34267,4311040
16190,juvlarN,2,0.00005,3937821,91.34272,4311040
16191,JWilh,2,0.00005,3937823,91.34276,4311040
16192,jwineinger,2,0.00005,3937825,91.34281,4311040
16193,jxlwqq,2,0.00005,3937827,91.34285,4311040
16194,k1eran,2,0.00005,3937829,91.34290,4311040
16195,kagedani,2,0.00005,3937831,91.34295,4311040
16196,kai687,2,0.00005,3937833,91.34299,4311040
16197,kaihoffman,2,0.00005,3937835,91.34304,4311040
16198,kalamba,2,0.00005,3937837,91.34309,4311040
16199,kalyan-vurugonda,2,0.00005,3937839,91.34313,4311040
16200,kaniini,2,0.00005,3937841,91.34318,4311040
16201,karelz,2,0.00005,3937843,91.34323,4311040
16202,karencfv,2,0.00005,3937845,91.34327,4311040
16203,karenin-overseas,2,0.00005,3937847,91.34332,4311040
16204,karlroberts,2,0.00005,3937849,91.34336,4311040
16205,kartiklunkad26,2,0.00005,3937851,91.34341,4311040
16206,kasturinarra,2,0.00005,3937853,91.34346,4311040
16207,katlimruiz,2,0.00005,3937855,91.34350,4311040
16208,kavichu,2,0.00005,3937857,91.34355,4311040
16209,kazhang,2,0.00005,3937859,91.34360,4311040
16210,kazk,2,0.00005,3937861,91.34364,4311040
16211,kchitrapu,2,0.00005,3937863,91.34369,4311040
16212,kenahoo,2,0.00005,3937865,91.34374,4311040
16213,ken-ajiro,2,0.00005,3937867,91.34378,4311040
16214,kensimon,2,0.00005,3937869,91.34383,4311040
16215,kenske,2,0.00005,3937871,91.34388,4311040
16216,kenXengineering,2,0.00005,3937873,91.34392,4311040
16217,kergon,2,0.00005,3937875,91.34397,4311040
16218,kevchu3,2,0.00005,3937877,91.34401,4311040
16219,kevinpauli,2,0.00005,3937879,91.34406,4311040
16220,kgamanji,2,0.00005,3937881,91.34411,4311040
16221,kgusarov,2,0.00005,3937883,91.34415,4311040
16222,kHRISl33t,2,0.00005,3937885,91.34420,4311040
16223,kiemlicz,2,0.00005,3937887,91.34425,4311040
16224,kirek007,2,0.00005,3937889,91.34429,4311040
16225,Klaas-,2,0.00005,3937891,91.34434,4311040
16226,klaus1982,2,0.00005,3937893,91.34439,4311040
16227,kmf,2,0.00005,3937895,91.34443,4311040
16228,koct9i,2,0.00005,3937897,91.34448,4311040
16229,kokizzu,2,0.00005,3937899,91.34452,4311040
16230,komuw,2,0.00005,3937901,91.34457,4311040
16231,kondaurovDev,2,0.00005,3937903,91.34462,4311040
16232,konstantin-dzreev,2,0.00005,3937905,91.34466,4311040
16233,kooba,2,0.00005,3937907,91.34471,4311040
16234,koraykutanoglu,2,0.00005,3937909,91.34476,4311040
16235,kostyay,2,0.00005,3937911,91.34480,4311040
16236,kotalakshman,2,0.00005,3937913,91.34485,4311040
16237,kouk,2,0.00005,3937915,91.34490,4311040
16238,koyadume,2,0.00005,3937917,91.34494,4311040
16239,kpouget,2,0.00005,3937919,91.34499,4311040
16240,kremers,2,0.00005,3937921,91.34504,4311040
16241,kshamajain99,2,0.00005,3937923,91.34508,4311040
16242,ktdreyer,2,0.00005,3937925,91.34513,4311040
16243,kuisathaverat,2,0.00005,3937927,91.34517,4311040
16244,kujenga,2,0.00005,3937929,91.34522,4311040
16245,kurbar,2,0.00005,3937931,91.34527,4311040
16246,kvmw,2,0.00005,3937933,91.34531,4311040
16247,kvpt,2,0.00005,3937935,91.34536,4311040
16248,kvudata,2,0.00005,3937937,91.34541,4311040
16249,kwent,2,0.00005,3937939,91.34545,4311040
16250,kwlzn,2,0.00005,3937941,91.34550,4311040
16251,Kwonho,2,0.00005,3937943,91.34555,4311040
16252,l13t,2,0.00005,3937945,91.34559,4311040
16253,Lanyujiex,2,0.00005,3937947,91.34564,4311040
16254,larsrnielsen,2,0.00005,3937949,91.34568,4311040
16255,larssb,2,0.00005,3937951,91.34573,4311040
16256,latchmihay,2,0.00005,3937953,91.34578,4311040
16257,laurieodgers,2,0.00005,3937955,91.34582,4311040
16258,lbb,2,0.00005,3937957,91.34587,4311040
16259,lbroudoux,2,0.00005,3937959,91.34592,4311040
16260,lcc3108,2,0.00005,3937961,91.34596,4311040
16261,lcy19870112,2,0.00005,3937963,91.34601,4311040
16262,le0nard01,2,0.00005,3937965,91.34606,4311040
16263,leeplay,2,0.00005,3937967,91.34610,4311040
16264,leeren,2,0.00005,3937969,91.34615,4311040
16265,legendarykamal,2,0.00005,3937971,91.34619,4311040
16266,lehors,2,0.00005,3937973,91.34624,4311040
16267,leonklingele,2,0.00005,3937975,91.34629,4311040
16268,Lerentis,2,0.00005,3937977,91.34633,4311040
16269,leth,2,0.00005,3937979,91.34638,4311040
16270,lewisbenge,2,0.00005,3937981,91.34643,4311040
16271,lgmorand,2,0.00005,3937983,91.34647,4311040
16272,lgorence,2,0.00005,3937985,91.34652,4311040
16273,li-adrienloiseau,2,0.00005,3937987,91.34657,4311040
16274,LiamClarkeNZ,2,0.00005,3937989,91.34661,4311040
16275,liaoj82,2,0.00005,3937991,91.34666,4311040
16276,liarco,2,0.00005,3937993,91.34671,4311040
16277,librant,2,0.00005,3937995,91.34675,4311040
16278,liljenstolpe,2,0.00005,3937997,91.34680,4311040
16279,limberger,2,0.00005,3937999,91.34684,4311040
16280,limscoder,2,0.00005,3938001,91.34689,4311040
16281,limx59,2,0.00005,3938003,91.34694,4311040
16282,linehrr,2,0.00005,3938005,91.34698,4311040
16283,lionelnicolas,2,0.00005,3938007,91.34703,4311040
16284,liquidsaul,2,0.00005,3938009,91.34708,4311040
16285,littletiger123,2,0.00005,3938011,91.34712,4311040
16286,LiuShuaiyi,2,0.00005,3938013,91.34717,4311040
16287,liverbirdkte,2,0.00005,3938015,91.34722,4311040
16288,liyongxian,2,0.00005,3938017,91.34726,4311040
16289,lizthegrey,2,0.00005,3938019,91.34731,4311040
16290,lobeck,2,0.00005,3938021,91.34735,4311040
16291,log2,2,0.00005,3938023,91.34740,4311040
16292,logikone,2,0.00005,3938025,91.34745,4311040
16293,lolodi,2,0.00005,3938027,91.34749,4311040
16294,lopezator,2,0.00005,3938029,91.34754,4311040
16295,lorenzo-biava,2,0.00005,3938031,91.34759,4311040
16296,loshz,2,0.00005,3938033,91.34763,4311040
16297,louiznk,2,0.00005,3938035,91.34768,4311040
16298,lrgar,2,0.00005,3938037,91.34773,4311040
16299,LS80,2,0.00005,3938039,91.34777,4311040
16300,lsambolino,2,0.00005,3938041,91.34782,4311040
16301,ltiao,2,0.00005,3938043,91.34787,4311040
16302,lucasponce,2,0.00005,3938045,91.34791,4311040
16303,lucasvasconcelos,2,0.00005,3938047,91.34796,4311040
16304,lucasvmiguel,2,0.00005,3938049,91.34800,4311040
16305,luigizhou,2,0.00005,3938051,91.34805,4311040
16306,lukepatrick,2,0.00005,3938053,91.34810,4311040
16307,lunderhage,2,0.00005,3938055,91.34814,4311040
16308,lwj5,2,0.00005,3938057,91.34819,4311040
16309,lzbj,2,0.00005,3938059,91.34824,4311040
16310,mabis,2,0.00005,3938061,91.34828,4311040
16311,mac9416,2,0.00005,3938063,91.34833,4311040
16312,macmiranda,2,0.00005,3938065,91.34838,4311040
16313,macrokernel,2,0.00005,3938067,91.34842,4311040
16314,Madaditya,2,0.00005,3938069,91.34847,4311040
16315,madhosoi,2,0.00005,3938071,91.34851,4311040
16316,maflaven,2,0.00005,3938073,91.34856,4311040
16317,magicalbob,2,0.00005,3938075,91.34861,4311040
16318,magrossm,2,0.00005,3938077,91.34865,4311040
16319,magthe,2,0.00005,3938079,91.34870,4311040
16320,mailtoraja18,2,0.00005,3938081,91.34875,4311040
16321,mamercad,2,0.00005,3938083,91.34879,4311040
16322,mameshini,2,0.00005,3938085,91.34884,4311040
16323,Mangirdaz,2,0.00005,3938087,91.34889,4311040
16324,MaoJianwei,2,0.00005,3938089,91.34893,4311040
16325,mapatel7,2,0.00005,3938091,91.34898,4311040
16326,marcbachmann,2,0.00005,3938093,91.34902,4311040
16327,MarcBruins,2,0.00005,3938095,91.34907,4311040
16328,marceloamaral,2,0.00005,3938097,91.34912,4311040
16329,marco2704,2,0.00005,3938099,91.34916,4311040
16330,marctrem,2,0.00005,3938101,91.34921,4311040
16331,mariuskiessling,2,0.00005,3938103,91.34926,4311040
16332,MariusVolkhart,2,0.00005,3938105,91.34930,4311040
16333,MarkArranz,2,0.00005,3938107,91.34935,4311040
16334,mark-grimes,2,0.00005,3938109,91.34940,4311040
16335,MarkSymsCtx,2,0.00005,3938111,91.34944,4311040
16336,martell,2,0.00005,3938113,91.34949,4311040
16337,martijnvdp,2,0.00005,3938115,91.34954,4311040
16338,martinbaillie,2,0.00005,3938117,91.34958,4311040
16339,MartinRoss-IBM,2,0.00005,3938119,91.34963,4311040
16340,martinyunify,2,0.00005,3938121,91.34967,4311040
16341,marziman,2,0.00005,3938123,91.34972,4311040
16342,masstomato,2,0.00005,3938125,91.34977,4311040
16343,matejc,2,0.00005,3938127,91.34981,4311040
16344,mateusz-ciesielski,2,0.00005,3938129,91.34986,4311040
16345,mateusz-lubanski-sinch,2,0.00005,3938131,91.34991,4311040
16346,math3vz,2,0.00005,3938133,91.34995,4311040
16347,mathieux51,2,0.00005,3938135,91.35000,4311040
16348,matskiv,2,0.00005,3938137,91.35005,4311040
16349,mattatcha,2,0.00005,3938139,91.35009,4311040
16350,MatteoMori,2,0.00005,3938141,91.35014,4311040
16351,mattes,2,0.00005,3938143,91.35018,4311040
16352,matthen,2,0.00005,3938145,91.35023,4311040
16353,MatthewDavidCampbell,2,0.00005,3938147,91.35028,4311040
16354,matthewhartstonge,2,0.00005,3938149,91.35032,4311040
16355,matthope,2,0.00005,3938151,91.35037,4311040
16356,mattoberle,2,0.00005,3938153,91.35042,4311040
16357,mattrobenolt,2,0.00005,3938155,91.35046,4311040
16358,matty234,2,0.00005,3938157,91.35051,4311040
16359,mattyw,2,0.00005,3938159,91.35056,4311040
16360,maxaudron,2,0.00005,3938161,91.35060,4311040
16361,maxekman,2,0.00005,3938163,91.35065,4311040
16362,MaxMommersteeg,2,0.00005,3938165,91.35069,4311040
16363,max-radin,2,0.00005,3938167,91.35074,4311040
16364,MaxWinterstein,2,0.00005,3938169,91.35079,4311040
16365,mayankjuneja,2,0.00005,3938171,91.35083,4311040
16366,maya-r,2,0.00005,3938173,91.35088,4311040
16367,mbentley,2,0.00005,3938175,91.35093,4311040
16368,mbessolov,2,0.00005,3938177,91.35097,4311040
16369,mbonica1990,2,0.00005,3938179,91.35102,4311040
16370,mboret,2,0.00005,3938181,91.35107,4311040
16371,mbovo,2,0.00005,3938183,91.35111,4311040
16372,mcdargh,2,0.00005,3938185,91.35116,4311040
16373,mcumings,2,0.00005,3938187,91.35121,4311040
16374,mehta-ankit,2,0.00005,3938189,91.35125,4311040
16375,mehyedes,2,0.00005,3938191,91.35130,4311040
16376,meier-christoph,2,0.00005,3938193,91.35134,4311040
16377,methodmissing,2,0.00005,3938195,91.35139,4311040
16378,metlos,2,0.00005,3938197,91.35144,4311040
16379,metrictwo,2,0.00005,3938199,91.35148,4311040
16380,mfrinnstrom,2,0.00005,3938201,91.35153,4311040
16381,mgedmin,2,0.00005,3938203,91.35158,4311040
16382,mghlaiel,2,0.00005,3938205,91.35162,4311040
16383,mgseelan,2,0.00005,3938207,91.35167,4311040
16384,mguillem,2,0.00005,3938209,91.35172,4311040
16385,MichaelChirico,2,0.00005,3938211,91.35176,4311040
16386,michaelsauter,2,0.00005,3938213,91.35181,4311040
16387,michidk,2,0.00005,3938215,91.35185,4311040
16388,migmartri,2,0.00005,3938217,91.35190,4311040
16389,mikegcoleman,2,0.00005,3938219,91.35195,4311040
16390,mikejk8s,2,0.00005,3938221,91.35199,4311040
16391,mikeraimondi,2,0.00005,3938223,91.35204,4311040
16392,mikereinhold,2,0.00005,3938225,91.35209,4311040
16393,mikery,2,0.00005,3938227,91.35213,4311040
16394,mikesir87,2,0.00005,3938229,91.35218,4311040
16395,mikudeko,2,0.00005,3938231,91.35223,4311040
16396,mildewey,2,0.00005,3938233,91.35227,4311040
16397,milosgajdos83,2,0.00005,3938235,91.35232,4311040
16398,mindreframer,2,0.00005,3938237,91.35237,4311040
16399,minhtrietbkit,2,0.00005,3938239,91.35241,4311040
16400,miquella,2,0.00005,3938241,91.35246,4311040
16401,mirobertod,2,0.00005,3938243,91.35250,4311040
16402,mishak87,2,0.00005,3938245,91.35255,4311040
16403,mitchdraft,2,0.00005,3938247,91.35260,4311040
16404,mitchnielsen,2,0.00005,3938249,91.35264,4311040
16405,MithunMJ,2,0.00005,3938251,91.35269,4311040
16406,mjibson,2,0.00005,3938253,91.35274,4311040
16407,mjpitz,2,0.00005,3938255,91.35278,4311040
16408,mkielar,2,0.00005,3938257,91.35283,4311040
16409,mkr1481,2,0.00005,3938259,91.35288,4311040
16410,mkramb,2,0.00005,3938261,91.35292,4311040
16411,mlebrun,2,0.00005,3938263,91.35297,4311040
16412,mlieberman85,2,0.00005,3938265,91.35301,4311040
16413,mmaymann,2,0.00005,3938267,91.35306,4311040
16414,mmkkff,2,0.00005,3938269,91.35311,4311040
16415,MnifR,2,0.00005,3938271,91.35315,4311040
16416,moeryomenko,2,0.00005,3938273,91.35320,4311040
16417,mogaal,2,0.00005,3938275,91.35325,4311040
16418,MohamedShaj,2,0.00005,3938277,91.35329,4311040
16419,mohansitaram,2,0.00005,3938279,91.35334,4311040
16420,mohitsoni,2,0.00005,3938281,91.35339,4311040
16421,moio,2,0.00005,3938283,91.35343,4311040
16422,mojtabacazi,2,0.00005,3938285,91.35348,4311040
16423,MoonShining,2,0.00005,3938287,91.35352,4311040
16424,moorthy156,2,0.00005,3938289,91.35357,4311040
16425,morgante,2,0.00005,3938291,91.35362,4311040
16426,moskyb,2,0.00005,3938293,91.35366,4311040
16427,mostaphaRoudsari,2,0.00005,3938295,91.35371,4311040
16428,MrAlias,2,0.00005,3938297,91.35376,4311040
16429,mrdfuse,2,0.00005,3938299,91.35380,4311040
16430,MrDienns,2,0.00005,3938301,91.35385,4311040
16431,mrf,2,0.00005,3938303,91.35390,4311040
16432,mrk-andreev,2,0.00005,3938305,91.35394,4311040
16433,mrkurt,2,0.00005,3938307,91.35399,4311040
16434,mrliptontea,2,0.00005,3938309,91.35404,4311040
16435,mrow4a,2,0.00005,3938311,91.35408,4311040
16436,mrtyler,2,0.00005,3938313,91.35413,4311040
16437,msenmurugan,2,0.00005,3938315,91.35417,4311040
16438,mshaikh786,2,0.00005,3938317,91.35422,4311040
16439,msingle,2,0.00005,3938319,91.35427,4311040
16440,mszacillo,2,0.00005,3938321,91.35431,4311040
16441,mthird,2,0.00005,3938323,91.35436,4311040
16442,mukundha,2,0.00005,3938325,91.35441,4311040
16443,multikatt,2,0.00005,3938327,91.35445,4311040
16444,murali-krishna,2,0.00005,3938329,91.35450,4311040
16445,muralov,2,0.00005,3938331,91.35455,4311040
16446,muteor,2,0.00005,3938333,91.35459,4311040
16447,mvanholsteijn,2,0.00005,3938335,91.35464,4311040
16448,mwoodson,2,0.00005,3938337,91.35468,4311040
16449,mycryptonite,2,0.00005,3938339,91.35473,4311040
16450,mykter,2,0.00005,3938341,91.35478,4311040
16451,MylesBorins,2,0.00005,3938343,91.35482,4311040
16452,Naatan,2,0.00005,3938345,91.35487,4311040
16453,nadilas,2,0.00005,3938347,91.35492,4311040
16454,naelyn,2,0.00005,3938349,91.35496,4311040
16455,naikajah,2,0.00005,3938351,91.35501,4311040
16456,namsoila,2,0.00005,3938353,91.35506,4311040
16457,naphta,2,0.00005,3938355,91.35510,4311040
16458,nareddyt,2,0.00005,3938357,91.35515,4311040
16459,narharim,2,0.00005,3938359,91.35520,4311040
16460,NaxAlpha,2,0.00005,3938361,91.35524,4311040
16461,ncabatoff,2,0.00005,3938363,91.35529,4311040
16462,neelanjan00,2,0.00005,3938365,91.35533,4311040
16463,NeilHanlon,2,0.00005,3938367,91.35538,4311040
16464,neilkuan,2,0.00005,3938369,91.35543,4311040
16465,nekottyo,2,0.00005,3938371,91.35547,4311040
16466,nekto0n,2,0.00005,3938373,91.35552,4311040
16467,neosab,2,0.00005,3938375,91.35557,4311040
16468,Nethminiromina,2,0.00005,3938377,91.35561,4311040
16469,neufeldtech,2,0.00005,3938379,91.35566,4311040
16470,Neuroglia,2,0.00005,3938381,91.35571,4311040
16471,neurostream,2,0.00005,3938383,91.35575,4311040
16472,neweyes,2,0.00005,3938385,91.35580,4311040
16473,newswangerd,2,0.00005,3938387,91.35584,4311040
16474,nfacha,2,0.00005,3938389,91.35589,4311040
16475,ngocson2vn,2,0.00005,3938391,91.35594,4311040
16476,ngrigoriev,2,0.00005,3938393,91.35598,4311040
16477,nhuray,2,0.00005,3938395,91.35603,4311040
16478,nicholaswyoung,2,0.00005,3938397,91.35608,4311040
16479,nickgryg,2,0.00005,3938399,91.35612,4311040
16480,nicklhy,2,0.00005,3938401,91.35617,4311040
16481,nicksantamaria,2,0.00005,3938403,91.35622,4311040
16482,nicodeur,2,0.00005,3938405,91.35626,4311040
16483,nicorikken,2,0.00005,3938407,91.35631,4311040
16484,niels-s,2,0.00005,3938409,91.35635,4311040
16485,nightguide,2,0.00005,3938411,91.35640,4311040
16486,nigimaster,2,0.00005,3938413,91.35645,4311040
16487,nineinfra,2,0.00005,3938415,91.35649,4311040
16488,nitinpatil1992,2,0.00005,3938417,91.35654,4311040
16489,Niyakiy,2,0.00005,3938419,91.35659,4311040
16490,NM4,2,0.00005,3938421,91.35663,4311040
16491,norrs,2,0.00005,3938423,91.35668,4311040
16492,NoUseFreak,2,0.00005,3938425,91.35673,4311040
16493,novakg,2,0.00005,3938427,91.35677,4311040
16494,nupejosh,2,0.00005,3938429,91.35682,4311040
16495,nyrahul,2,0.00005,3938431,91.35687,4311040
16496,o6uoq,2,0.00005,3938433,91.35691,4311040
16497,obrienrobert,2,0.00005,3938435,91.35696,4311040
16498,ocervell,2,0.00005,3938437,91.35700,4311040
16499,odra,2,0.00005,3938439,91.35705,4311040
16500,ofer-tvil,2,0.00005,3938441,91.35710,4311040
16501,ofpiyush,2,0.00005,3938443,91.35714,4311040
16502,ohadmuch,2,0.00005,3938445,91.35719,4311040
16503,OlegPS,2,0.00005,3938447,91.35724,4311040
16504,olevski,2,0.00005,3938449,91.35728,4311040
16505,oliverhausler,2,0.00005,3938451,91.35733,4311040
16506,OmarLatrach,2,0.00005,3938453,91.35738,4311040
16507,omesser,2,0.00005,3938455,91.35742,4311040
16508,ominiet,2,0.00005,3938457,91.35747,4311040
16509,onegreyonewhite,2,0.00005,3938459,91.35751,4311040
16510,oo00spy00oo,2,0.00005,3938461,91.35756,4311040
16511,ophelan,2,0.00005,3938463,91.35761,4311040
16512,orelmisan,2,0.00005,3938465,91.35765,4311040
16513,orifito,2,0.00005,3938467,91.35770,4311040
16514,orrc,2,0.00005,3938469,91.35775,4311040
16515,Oskoss,2,0.00005,3938471,91.35779,4311040
16516,overdrive3000,2,0.00005,3938473,91.35784,4311040
16517,ovidiubuligan,2,0.00005,3938475,91.35789,4311040
16518,oze4,2,0.00005,3938477,91.35793,4311040
16519,pablo-ruth,2,0.00005,3938479,91.35798,4311040
16520,paha,2,0.00005,3938481,91.35802,4311040
16521,Paic,2,0.00005,3938483,91.35807,4311040
16522,panbanda,2,0.00005,3938485,91.35812,4311040
16523,panuhorsmalahti,2,0.00005,3938487,91.35816,4311040
16524,parisk,2,0.00005,3938489,91.35821,4311040
16525,pascal-sochacki,2,0.00005,3938491,91.35826,4311040
16526,pascal-vs,2,0.00005,3938493,91.35830,4311040
16527,patelrit,2,0.00005,3938495,91.35835,4311040
16528,patflynn,2,0.00005,3938497,91.35840,4311040
16529,patrickjahns,2,0.00005,3938499,91.35844,4311040
16530,paulcostinean,2,0.00005,3938501,91.35849,4311040
16531,paulmey,2,0.00005,3938503,91.35854,4311040
16532,paulreimer,2,0.00005,3938505,91.35858,4311040
16533,pcolazurdo,2,0.00005,3938507,91.35863,4311040
16534,pellared,2,0.00005,3938509,91.35867,4311040
16535,perk,2,0.00005,3938511,91.35872,4311040
16536,petenorth,2,0.00005,3938513,91.35877,4311040
16537,peterbosalliandercom,2,0.00005,3938515,91.35881,4311040
16538,peterfication,2,0.00005,3938517,91.35886,4311040
16539,petermbenjamin,2,0.00005,3938519,91.35891,4311040
16540,peters95,2,0.00005,3938521,91.35895,4311040
16541,petrkotas,2,0.00005,3938523,91.35900,4311040
16542,peturgq,2,0.00005,3938525,91.35905,4311040
16543,phajduk,2,0.00005,3938527,91.35909,4311040
16544,phantomjinx,2,0.00005,3938529,91.35914,4311040
16545,philipcwhite,2,0.00005,3938531,91.35918,4311040
16546,PhilipMay,2,0.00005,3938533,91.35923,4311040
16547,phin1x,2,0.00005,3938535,91.35928,4311040
16548,phiroict,2,0.00005,3938537,91.35932,4311040
16549,piastry,2,0.00005,3938539,91.35937,4311040
16550,pierrecregut,2,0.00005,3938541,91.35942,4311040
16551,pierredup,2,0.00005,3938543,91.35946,4311040
16552,PiotrKlimczak,2,0.00005,3938545,91.35951,4311040
16553,piperchester,2,0.00005,3938547,91.35956,4311040
16554,piyush1146115,2,0.00005,3938549,91.35960,4311040
16555,pk-hugo,2,0.00005,3938551,91.35965,4311040
16556,plaes,2,0.00005,3938553,91.35970,4311040
16557,plkokanov,2,0.00005,3938555,91.35974,4311040
16558,plucury,2,0.00005,3938557,91.35979,4311040
16559,Pluggi,2,0.00005,3938559,91.35983,4311040
16560,pmccarthy,2,0.00005,3938561,91.35988,4311040
16561,pmorch,2,0.00005,3938563,91.35993,4311040
16562,polinchw,2,0.00005,3938565,91.35997,4311040
16563,Poorunga,2,0.00005,3938567,91.36002,4311040
16564,ppmathis,2,0.00005,3938569,91.36007,4311040
16565,pra85,2,0.00005,3938571,91.36011,4311040
16566,prabushyam,2,0.00005,3938573,91.36016,4311040
16567,pragmaticivan,2,0.00005,3938575,91.36021,4311040
16568,prashant182,2,0.00005,3938577,91.36025,4311040
16569,prashantchari,2,0.00005,3938579,91.36030,4311040
16570,precompiler,2,0.00005,3938581,91.36034,4311040
16571,programmerq,2,0.00005,3938583,91.36039,4311040
16572,proligde,2,0.00005,3938585,91.36044,4311040
16573,przemeklal,2,0.00005,3938587,91.36048,4311040
16574,psibi,2,0.00005,3938589,91.36053,4311040
16575,pwaller,2,0.00005,3938591,91.36058,4311040
16576,pyle,2,0.00005,3938593,91.36062,4311040
16577,PyoJunCode,2,0.00005,3938595,91.36067,4311040
16578,qar,2,0.00005,3938597,91.36072,4311040
16579,qcastel,2,0.00005,3938599,91.36076,4311040
16580,QiuMike,2,0.00005,3938601,91.36081,4311040
16581,Qix-,2,0.00005,3938603,91.36085,4311040
16582,quentinmit,2,0.00005,3938605,91.36090,4311040
16583,quickstar,2,0.00005,3938607,91.36095,4311040
16584,qurname2,2,0.00005,3938609,91.36099,4311040
16585,quyenhoang96,2,0.00005,3938611,91.36104,4311040
16586,r0mant,2,0.00005,3938613,91.36109,4311040
16587,radekg,2,0.00005,3938615,91.36113,4311040
16588,raelix,2,0.00005,3938617,91.36118,4311040
16589,RafalMaleska,2,0.00005,3938619,91.36123,4311040
16590,rafmonteiro,2,0.00005,3938621,91.36127,4311040
16591,RahulKansana1,2,0.00005,3938623,91.36132,4311040
16592,ran-huang,2,0.00005,3938625,91.36137,4311040
16593,raphaelpoumarede,2,0.00005,3938627,91.36141,4311040
16594,RappC,2,0.00005,3938629,91.36146,4311040
16595,raspberrypython,2,0.00005,3938631,91.36150,4311040
16596,raunyoliveira-hotmart,2,0.00005,3938633,91.36155,4311040
16597,ravibagri5,2,0.00005,3938635,91.36160,4311040
16598,rberrelleza,2,0.00005,3938637,91.36164,4311040
16599,rchenzheng,2,0.00005,3938639,91.36169,4311040
16600,rcleere,2,0.00005,3938641,91.36174,4311040
16601,rdallman,2,0.00005,3938643,91.36178,4311040
16602,rdeusser,2,0.00005,3938645,91.36183,4311040
16603,rdimitrov,2,0.00005,3938647,91.36188,4311040
16604,RealAnna,2,0.00005,3938649,91.36192,4311040
16605,Reasno,2,0.00005,3938651,91.36197,4311040
16606,REBELinBLUE,2,0.00005,3938653,91.36201,4311040
16607,Regevd,2,0.00005,3938655,91.36206,4311040
16608,resker,2,0.00005,3938657,91.36211,4311040
16609,RetWolf,2,0.00005,3938659,91.36215,4311040
16610,reuvenharrison,2,0.00005,3938661,91.36220,4311040
16611,rgeraskin,2,0.00005,3938663,91.36225,4311040
16612,rhysjtevans,2,0.00005,3938665,91.36229,4311040
16613,rib,2,0.00005,3938667,91.36234,4311040
16614,ricadelic,2,0.00005,3938669,91.36239,4311040
16615,ricarhincapie,2,0.00005,3938671,91.36243,4311040
16616,richardfung,2,0.00005,3938673,91.36248,4311040
16617,richtera,2,0.00005,3938675,91.36253,4311040
16618,RichWellum,2,0.00005,3938677,91.36257,4311040
16619,rinormaloku,2,0.00005,3938679,91.36262,4311040
16620,riywo,2,0.00005,3938681,91.36266,4311040
16621,rjamet,2,0.00005,3938683,91.36271,4311040
16622,rlangfordBV,2,0.00005,3938685,91.36276,4311040
16623,rltvty,2,0.00005,3938687,91.36280,4311040
16624,rmannibucau,2,0.00005,3938689,91.36285,4311040
16625,rm-you,2,0.00005,3938691,91.36290,4311040
16626,Rob4001,2,0.00005,3938693,91.36294,4311040
16627,robey,2,0.00005,3938695,91.36299,4311040
16628,rockholla,2,0.00005,3938697,91.36304,4311040
16629,roelofjansen,2,0.00005,3938699,91.36308,4311040
16630,rohansahai,2,0.00005,3938701,91.36313,4311040
16631,rokej,2,0.00005,3938703,91.36317,4311040
16632,ronenschafferibm,2,0.00005,3938705,91.36322,4311040
16633,ronnin,2,0.00005,3938707,91.36327,4311040
16634,rosskevin,2,0.00005,3938709,91.36331,4311040
16635,rotemtam,2,0.00005,3938711,91.36336,4311040
16636,rudyzhou2,2,0.00005,3938713,91.36341,4311040
16637,ruidiama,2,0.00005,3938715,91.36345,4311040
16638,rumpl,2,0.00005,3938717,91.36350,4311040
16639,rvlane,2,0.00005,3938719,91.36355,4311040
16640,ryancurrah,2,0.00005,3938721,91.36359,4311040
16641,RyanHartje,2,0.00005,3938723,91.36364,4311040
16642,RyanW8,2,0.00005,3938725,91.36368,4311040
16643,ryshi,2,0.00005,3938727,91.36373,4311040
16644,s04,2,0.00005,3938729,91.36378,4311040
16645,S1yuan,2,0.00005,3938731,91.36382,4311040
16646,sabbey37,2,0.00005,3938733,91.36387,4311040
16647,sabbour,2,0.00005,3938735,91.36392,4311040
16648,sabinaaledort,2,0.00005,3938737,91.36396,4311040
16649,SachinVarghese,2,0.00005,3938739,91.36401,4311040
16650,sadovnikov,2,0.00005,3938741,91.36406,4311040
16651,sagarkrsd,2,0.00005,3938743,91.36410,4311040
16652,sah4ez,2,0.00005,3938745,91.36415,4311040
16653,sahil-sawhney,2,0.00005,3938747,91.36420,4311040
16654,saikatharryc,2,0.00005,3938749,91.36424,4311040
16655,sajayantony,2,0.00005,3938751,91.36429,4311040
16656,sajuptpm,2,0.00005,3938753,91.36433,4311040
16657,salimuddin87,2,0.00005,3938755,91.36438,4311040
16658,samdoran,2,0.00005,3938757,91.36443,4311040
16659,samnissen,2,0.00005,3938759,91.36447,4311040
16660,samueldg,2,0.00005,3938761,91.36452,4311040
16661,samuel-phan,2,0.00005,3938763,91.36457,4311040
16662,samzong,2,0.00005,3938765,91.36461,4311040
16663,san360,2,0.00005,3938767,91.36466,4311040
16664,sandrobonazzola,2,0.00005,3938769,91.36471,4311040
16665,sanjimoh,2,0.00005,3938771,91.36475,4311040
16666,SantiagoTorres,2,0.00005,3938773,91.36480,4311040
16667,sarahbx,2,0.00005,3938775,91.36484,4311040
16668,sasso,2,0.00005,3938777,91.36489,4311040
16669,saswatamcode,2,0.00005,3938779,91.36494,4311040
16670,saxicek,2,0.00005,3938781,91.36498,4311040
16671,sbernheim,2,0.00005,3938783,91.36503,4311040
16672,schancel,2,0.00005,3938785,91.36508,4311040
16673,scheng1,2,0.00005,3938787,91.36512,4311040
16674,schmich,2,0.00005,3938789,91.36517,4311040
16675,schroeder-paul,2,0.00005,3938791,91.36522,4311040
16676,scjudd,2,0.00005,3938793,91.36526,4311040
16677,scott-grimes,2,0.00005,3938795,91.36531,4311040
16678,scottillogical,2,0.00005,3938797,91.36535,4311040
16679,scumola,2,0.00005,3938799,91.36540,4311040
16680,sd2k,2,0.00005,3938801,91.36545,4311040
16681,seanhoughton,2,0.00005,3938803,91.36549,4311040
16682,SeanKnight,2,0.00005,3938805,91.36554,4311040
16683,sebinsua,2,0.00005,3938807,91.36559,4311040
16684,semekh,2,0.00005,3938809,91.36563,4311040
16685,senk,2,0.00005,3938811,91.36568,4311040
16686,seongenie,2,0.00005,3938813,91.36573,4311040
16687,sergejjevsejev-home24,2,0.00005,3938815,91.36577,4311040
16688,sergiitk,2,0.00005,3938817,91.36582,4311040
16689,Seyun,2,0.00005,3938819,91.36587,4311040
16690,sfrique,2,0.00005,3938821,91.36591,4311040
16691,sgalsaleh,2,0.00005,3938823,91.36596,4311040
16692,sgentile,2,0.00005,3938825,91.36600,4311040
16693,shabbir-taulia,2,0.00005,3938827,91.36605,4311040
16694,shal,2,0.00005,3938829,91.36610,4311040
16695,shalom-cyera,2,0.00005,3938831,91.36614,4311040
16696,shamalco,2,0.00005,3938833,91.36619,4311040
16697,shandyDev,2,0.00005,3938835,91.36624,4311040
16698,shaneog,2,0.00005,3938837,91.36628,4311040
16699,shanesveller,2,0.00005,3938839,91.36633,4311040
16700,shanhuhai5739,2,0.00005,3938841,91.36638,4311040
16701,shanna,2,0.00005,3938843,91.36642,4311040
16702,Shashankft9,2,0.00005,3938845,91.36647,4311040
16703,shaunofneuron,2,0.00005,3938847,91.36651,4311040
16704,shikhi7,2,0.00005,3938849,91.36656,4311040
16705,shivpathak,2,0.00005,3938851,91.36661,4311040
16706,shmargum,2,0.00005,3938853,91.36665,4311040
16707,Shoothzj,2,0.00005,3938855,91.36670,4311040
16708,shosti,2,0.00005,3938857,91.36675,4311040
16709,ShotaKitazawa,2,0.00005,3938859,91.36679,4311040
16710,shovanmaity,2,0.00005,3938861,91.36684,4311040
16711,showermat,2,0.00005,3938863,91.36689,4311040
16712,shravan-achar,2,0.00005,3938865,91.36693,4311040
16713,shreyas-s-rao,2,0.00005,3938867,91.36698,4311040
16714,shubhamitc,2,0.00005,3938869,91.36703,4311040
16715,ShubhamRasal,2,0.00005,3938871,91.36707,4311040
16716,shu-frank-csdn,2,0.00005,3938873,91.36712,4311040
16717,siddharthab,2,0.00005,3938875,91.36716,4311040
16718,sids-b,2,0.00005,3938877,91.36721,4311040
16719,silentknight2001,2,0.00005,3938879,91.36726,4311040
16720,simplypost,2,0.00005,3938881,91.36730,4311040
16721,simplyzee,2,0.00005,3938883,91.36735,4311040
16722,simu,2,0.00005,3938885,91.36740,4311040
16723,skurfuerst,2,0.00005,3938887,91.36744,4311040
16724,slallema,2,0.00005,3938889,91.36749,4311040
16725,slang800,2,0.00005,3938891,91.36754,4311040
16726,slonka,2,0.00005,3938893,91.36758,4311040
16727,smallteeths,2,0.00005,3938895,91.36763,4311040
16728,smfrench,2,0.00005,3938897,91.36767,4311040
16729,snir911,2,0.00005,3938899,91.36772,4311040
16730,snirkop89,2,0.00005,3938901,91.36777,4311040
16731,snocorp,2,0.00005,3938903,91.36781,4311040
16732,snstaberah,2,0.00005,3938905,91.36786,4311040
16733,SomalianIvan,2,0.00005,3938907,91.36791,4311040
16734,sonicaj,2,0.00005,3938909,91.36795,4311040
16735,sourikghosh,2,0.00005,3938911,91.36800,4311040
16736,Sovietaced,2,0.00005,3938913,91.36805,4311040
16737,sp185503,2,0.00005,3938915,91.36809,4311040
16738,spencergibb,2,0.00005,3938917,91.36814,4311040
16739,spencer-nicol,2,0.00005,3938919,91.36818,4311040
16740,Spenhouet,2,0.00005,3938921,91.36823,4311040
16741,spf13,2,0.00005,3938923,91.36828,4311040
16742,spingel,2,0.00005,3938925,91.36832,4311040
16743,Splaktar,2,0.00005,3938927,91.36837,4311040
16744,spohnan,2,0.00005,3938929,91.36842,4311040
16745,sp-ronny-lopez,2,0.00005,3938931,91.36846,4311040
16746,spuder,2,0.00005,3938933,91.36851,4311040
16747,sqs,2,0.00005,3938935,91.36856,4311040
16748,squarelover,2,0.00005,3938937,91.36860,4311040
16749,squee1945,2,0.00005,3938939,91.36865,4311040
16750,Sreemanti-Ghosh,2,0.00005,3938941,91.36870,4311040
16751,srgvg,2,0.00005,3938943,91.36874,4311040
16752,sridhargaddam,2,0.00005,3938945,91.36879,4311040
16753,SrishT,2,0.00005,3938947,91.36883,4311040
16754,srl295,2,0.00005,3938949,91.36888,4311040
16755,srntqn,2,0.00005,3938951,91.36893,4311040
16756,srvaroa,2,0.00005,3938953,91.36897,4311040
16757,srv-twry,2,0.00005,3938955,91.36902,4311040
16758,ssbostan,2,0.00005,3938957,91.36907,4311040
16759,ssoroka,2,0.00005,3938959,91.36911,4311040
16760,sspeiche,2,0.00005,3938961,91.36916,4311040
16761,SSshahan,2,0.00005,3938963,91.36921,4311040
16762,staceypotter,2,0.00005,3938965,91.36925,4311040
16763,stanssh,2,0.00005,3938967,91.36930,4311040
16764,startnow65,2,0.00005,3938969,91.36934,4311040
16765,steevi,2,0.00005,3938971,91.36939,4311040
16766,StefanEnberg,2,0.00005,3938973,91.36944,4311040
16767,StefanScherer,2,0.00005,3938975,91.36948,4311040
16768,stepanv,2,0.00005,3938977,91.36953,4311040
16769,stephenmoloney,2,0.00005,3938979,91.36958,4311040
16770,SteveMattar,2,0.00005,3938981,91.36962,4311040
16771,stevenfollis,2,0.00005,3938983,91.36967,4311040
16772,steven-zou,2,0.00005,3938985,91.36972,4311040
16773,stoader,2,0.00005,3938987,91.36976,4311040
16774,strantalis,2,0.00005,3938989,91.36981,4311040
16775,strawgate,2,0.00005,3938991,91.36986,4311040
16776,Striar-Yunis,2,0.00005,3938993,91.36990,4311040
16777,strin,2,0.00005,3938995,91.36995,4311040
16778,stvdilln,2,0.00005,3938997,91.36999,4311040
16779,sudomann,2,0.00005,3938999,91.37004,4311040
16780,sudswasavi,2,0.00005,3939001,91.37009,4311040
16781,suhuruli,2,0.00005,3939003,91.37013,4311040
16782,SuleimanWA,2,0.00005,3939005,91.37018,4311040
16783,sumeetoc,2,0.00005,3939007,91.37023,4311040
16784,superawesome,2,0.00005,3939009,91.37027,4311040
16785,sushilkm,2,0.00005,3939011,91.37032,4311040
16786,svelleweetakealot,2,0.00005,3939013,91.37037,4311040
16787,svrnm,2,0.00005,3939015,91.37041,4311040
16788,swq499809608,2,0.00005,3939017,91.37046,4311040
16789,sww,2,0.00005,3939019,91.37050,4311040
16790,SychevIgor,2,0.00005,3939021,91.37055,4311040
16791,Sytten,2,0.00005,3939023,91.37060,4311040
16792,t0ffel,2,0.00005,3939025,91.37064,4311040
16793,t-8ch,2,0.00005,3939027,91.37069,4311040
16794,TaEduard,2,0.00005,3939029,91.37074,4311040
16795,takeshi-yoshimura,2,0.00005,3939031,91.37078,4311040
16796,TakiTake,2,0.00005,3939033,91.37083,4311040
16797,TamikoT,2,0.00005,3939035,91.37088,4311040
16798,tamilhce,2,0.00005,3939037,91.37092,4311040
16799,tanapoln,2,0.00005,3939039,91.37097,4311040
16800,TanmayaA,2,0.00005,3939041,91.37101,4311040
16801,taojwmware,2,0.00005,3939043,91.37106,4311040
16802,Tapppi,2,0.00005,3939045,91.37111,4311040
16803,tarioch,2,0.00005,3939047,91.37115,4311040
16804,TauqeerAhmad104,2,0.00005,3939049,91.37120,4311040
16805,tavispaquette,2,0.00005,3939051,91.37125,4311040
16806,tdg5,2,0.00005,3939053,91.37129,4311040
16807,teaglebuilt,2,0.00005,3939055,91.37134,4311040
16808,techgeek03,2,0.00005,3939057,91.37139,4311040
16809,techthumb,2,0.00005,3939059,91.37143,4311040
16810,tedsuo,2,0.00005,3939061,91.37148,4311040
16811,tegk,2,0.00005,3939063,91.37153,4311040
16812,tgjonestx,2,0.00005,3939065,91.37157,4311040
16813,tgruenert,2,0.00005,3939067,91.37162,4311040
16814,thamaraiselvam,2,0.00005,3939069,91.37166,4311040
16815,thangchung,2,0.00005,3939071,91.37171,4311040
16816,theadzik,2,0.00005,3939073,91.37176,4311040
16817,TheAggressive,2,0.00005,3939075,91.37180,4311040
16818,thebeefcake,2,0.00005,3939077,91.37185,4311040
16819,thebigredgeek,2,0.00005,3939079,91.37190,4311040
16820,theganyo,2,0.00005,3939081,91.37194,4311040
16821,theo01,2,0.00005,3939083,91.37199,4311040
16822,TheoBrigitte,2,0.00005,3939085,91.37204,4311040
16823,theomessin,2,0.00005,3939087,91.37208,4311040
16824,theonlydoo,2,0.00005,3939089,91.37213,4311040
16825,thetechnick,2,0.00005,3939091,91.37217,4311040
16826,thetillhoff,2,0.00005,3939093,91.37222,4311040
16827,thirstydeveloper,2,0.00005,3939095,91.37227,4311040
16828,thomaspeitz,2,0.00005,3939097,91.37231,4311040
16829,thorfour,2,0.00005,3939099,91.37236,4311040
16830,thpang,2,0.00005,3939101,91.37241,4311040
16831,thundergolfer,2,0.00005,3939103,91.37245,4311040
16832,tiagocborg,2,0.00005,3939105,91.37250,4311040
16833,timani,2,0.00005,3939107,91.37255,4311040
16834,timbrd,2,0.00005,3939109,91.37259,4311040
16835,tim-ebert,2,0.00005,3939111,91.37264,4311040
16836,Timothy-Dement,2,0.00005,3939113,91.37269,4311040
16837,timpalpant,2,0.00005,3939115,91.37273,4311040
16838,timurista,2,0.00005,3939117,91.37278,4311040
16839,timurkhafizov,2,0.00005,3939119,91.37282,4311040
16840,tlitovsk,2,0.00005,3939121,91.37287,4311040
16841,tlkh,2,0.00005,3939123,91.37292,4311040
16842,TLmaK0,2,0.00005,3939125,91.37296,4311040
16843,tlwu2013,2,0.00005,3939127,91.37301,4311040
16844,tmarcu,2,0.00005,3939129,91.37306,4311040
16845,tmszdmsk,2,0.00005,3939131,91.37310,4311040
16846,todaygood,2,0.00005,3939133,91.37315,4311040
16847,toddysm,2,0.00005,3939135,91.37320,4311040
16848,tolusha,2,0.00005,3939137,91.37324,4311040
16849,tomasfreund,2,0.00005,3939139,91.37329,4311040
16850,tomaspritrsky,2,0.00005,3939141,91.37333,4311040
16851,tomgron,2,0.00005,3939143,91.37338,4311040
16852,tomhuang12,2,0.00005,3939145,91.37343,4311040
16853,tommyhobin,2,0.00005,3939147,91.37347,4311040
16854,tomp736,2,0.00005,3939149,91.37352,4311040
16855,tonit,2,0.00005,3939151,91.37357,4311040
16856,tonobo,2,0.00005,3939153,91.37361,4311040
16857,tonyfahrion,2,0.00005,3939155,91.37366,4311040
16858,TonyNoble,2,0.00005,3939157,91.37371,4311040
16859,torbjornvatn,2,0.00005,3939159,91.37375,4311040
16860,tosmi,2,0.00005,3939161,91.37380,4311040
16861,totahuanocotl,2,0.00005,3939163,91.37384,4311040
16862,Towmeykaw,2,0.00005,3939165,91.37389,4311040
16863,tpiperatgod,2,0.00005,3939167,91.37394,4311040
16864,tpot,2,0.00005,3939169,91.37398,4311040
16865,tpryan,2,0.00005,3939171,91.37403,4311040
16866,tragiclifestories,2,0.00005,3939173,91.37408,4311040
16867,Trefex,2,0.00005,3939175,91.37412,4311040
16868,trevorlinton,2,0.00005,3939177,91.37417,4311040
16869,tripledes,2,0.00005,3939179,91.37422,4311040
16870,TristanCacqueray,2,0.00005,3939181,91.37426,4311040
16871,Troyhy,2,0.00005,3939183,91.37431,4311040
16872,trumant,2,0.00005,3939185,91.37436,4311040
16873,trynity,2,0.00005,3939187,91.37440,4311040
16874,tux-o-matic,2,0.00005,3939189,91.37445,4311040
16875,twang2218,2,0.00005,3939191,91.37449,4311040
16876,tylern91,2,0.00005,3939193,91.37454,4311040
16877,tylerslaton,2,0.00005,3939195,91.37459,4311040
16878,uc-msft,2,0.00005,3939197,91.37463,4311040
16879,UlTriX,2,0.00005,3939199,91.37468,4311040
16880,umutsahin,2,0.00005,3939201,91.37473,4311040
16881,UrmsOne,2,0.00005,3939203,91.37477,4311040
16882,uvgroovy,2,0.00005,3939205,91.37482,4311040
16883,UXabre,2,0.00005,3939207,91.37487,4311040
16884,vaidik,2,0.00005,3939209,91.37491,4311040
16885,vaikas,2,0.00005,3939211,91.37496,4311040
16886,vainikkaj,2,0.00005,3939213,91.37500,4311040
16887,vaisov,2,0.00005,3939215,91.37505,4311040
16888,ValdasK,2,0.00005,3939217,91.37510,4311040
16889,valerytschopp,2,0.00005,3939219,91.37514,4311040
16890,varungbt,2,0.00005,3939221,91.37519,4311040
16891,vasusheoran,2,0.00005,3939223,91.37524,4311040
16892,vavrusa,2,0.00005,3939225,91.37528,4311040
16893,vcabbage,2,0.00005,3939227,91.37533,4311040
16894,vfiset,2,0.00005,3939229,91.37538,4311040
16895,vh,2,0.00005,3939231,91.37542,4311040
16896,vhristev,2,0.00005,3939233,91.37547,4311040
16897,Vibzy19,2,0.00005,3939235,91.37551,4311040
16898,vickykushwaha,2,0.00005,3939237,91.37556,4311040
16899,vi-credo,2,0.00005,3939239,91.37561,4311040
16900,vidbina,2,0.00005,3939241,91.37565,4311040
16901,Vignesh-Sakkarai,2,0.00005,3939243,91.37570,4311040
16902,vincent-du2020,2,0.00005,3939245,91.37575,4311040
16903,VinothChinnadurai,2,0.00005,3939247,91.37579,4311040
16904,viovanov,2,0.00005,3939249,91.37584,4311040
16905,vise890,2,0.00005,3939251,91.37589,4311040
16906,vishal-chdhry,2,0.00005,3939253,91.37593,4311040
16907,vishnuhd,2,0.00005,3939255,91.37598,4311040
16908,VitalCh,2,0.00005,3939257,91.37603,4311040
16909,vitorarins,2,0.00005,3939259,91.37607,4311040
16910,vjanelle,2,0.00005,3939261,91.37612,4311040
16911,vjjmiras,2,0.00005,3939263,91.37616,4311040
16912,vjrantal,2,0.00005,3939265,91.37621,4311040
16913,vjunior1981,2,0.00005,3939267,91.37626,4311040
16914,vkorbes,2,0.00005,3939269,91.37630,4311040
16915,vmwiz,2,0.00005,3939271,91.37635,4311040
16916,voldemortensen,2,0.00005,3939273,91.37640,4311040
16917,volkert-fastned,2,0.00005,3939275,91.37644,4311040
16918,VoVAllen,2,0.00005,3939277,91.37649,4311040
16919,vramakrishnan,2,0.00005,3939279,91.37654,4311040
16920,vsliouniaev,2,0.00005,3939281,91.37658,4311040
16921,vturecek,2,0.00005,3939283,91.37663,4311040
16922,vuldin,2,0.00005,3939285,91.37667,4311040
16923,w3irdrobot,2,0.00005,3939287,91.37672,4311040
16924,walidshaari,2,0.00005,3939289,91.37677,4311040
16925,wangcanfengxs,2,0.00005,3939291,91.37681,4311040
16926,weixiao619,2,0.00005,3939293,91.37686,4311040
16927,wenxuwan,2,0.00005,3939295,91.37691,4311040
16928,whitlaaa,2,0.00005,3939297,91.37695,4311040
16929,WillBeebe,2,0.00005,3939299,91.37700,4311040
16930,willejs,2,0.00005,3939301,91.37705,4311040
16931,WillerWasTaken,2,0.00005,3939303,91.37709,4311040
16932,williamcodes,2,0.00005,3939305,91.37714,4311040
16933,williamh,2,0.00005,3939307,91.37719,4311040
16934,wingerted,2,0.00005,3939309,91.37723,4311040
16935,wisererik,2,0.00005,3939311,91.37728,4311040
16936,wsargent,2,0.00005,3939313,91.37732,4311040
16937,wshihadeh,2,0.00005,3939315,91.37737,4311040
16938,wstewartii,2,0.00005,3939317,91.37742,4311040
16939,wuman,2,0.00005,3939319,91.37746,4311040
16940,wwformat,2,0.00005,3939321,91.37751,4311040
16941,xadhatter,2,0.00005,3939323,91.37756,4311040
16942,xaque208,2,0.00005,3939325,91.37760,4311040
16943,xemul,2,0.00005,3939327,91.37765,4311040
16944,Xenopathic,2,0.00005,3939329,91.37770,4311040
16945,xeviknal,2,0.00005,3939331,91.37774,4311040
16946,xiaoqge,2,0.00005,3939333,91.37779,4311040
16947,xiemaisi,2,0.00005,3939335,91.37783,4311040
16948,xizhao,2,0.00005,3939337,91.37788,4311040
16949,xogeny,2,0.00005,3939339,91.37793,4311040
16950,xp-1000,2,0.00005,3939341,91.37797,4311040
16951,xqianwang,2,0.00005,3939343,91.37802,4311040
16952,xt99,2,0.00005,3939345,91.37807,4311040
16953,yakhyadabo,2,0.00005,3939347,91.37811,4311040
16954,yakult1995,2,0.00005,3939349,91.37816,4311040
16955,yamaszone,2,0.00005,3939351,91.37821,4311040
16956,yangminzhu,2,0.00005,3939353,91.37825,4311040
16957,Yannig,2,0.00005,3939355,91.37830,4311040
16958,yasharne,2,0.00005,3939357,91.37834,4311040
16959,yashdesai93,2,0.00005,3939359,91.37839,4311040
16960,YathendraPrasad,2,0.00005,3939361,91.37844,4311040
16961,yati1998,2,0.00005,3939363,91.37848,4311040
16962,Ydcool,2,0.00005,3939365,91.37853,4311040
16963,yenicapotediaz,2,0.00005,3939367,91.37858,4311040
16964,yichengliu58,2,0.00005,3939369,91.37862,4311040
16965,Yiwei-Chen-Bose,2,0.00005,3939371,91.37867,4311040
16966,ykulazhenkov,2,0.00005,3939373,91.37872,4311040
16967,ylogx,2,0.00005,3939375,91.37876,4311040
16968,ymasiuk,2,0.00005,3939377,91.37881,4311040
16969,Yogu,2,0.00005,3939379,91.37886,4311040
16970,yriveiro,2,0.00005,3939381,91.37890,4311040
16971,yt3liu,2,0.00005,3939383,91.37895,4311040
16972,yuandaocloud,2,0.00005,3939385,91.37899,4311040
16973,yuchen9459,2,0.00005,3939387,91.37904,4311040
16974,yuchunyu97,2,0.00005,3939389,91.37909,4311040
16975,yudupi,2,0.00005,3939391,91.37913,4311040
16976,yurigene,2,0.00005,3939393,91.37918,4311040
16977,yuxiaoba,2,0.00005,3939395,91.37923,4311040
16978,YuxinZhou,2,0.00005,3939397,91.37927,4311040
16979,yywandb,2,0.00005,3939399,91.37932,4311040
16980,z0r0,2,0.00005,3939401,91.37937,4311040
16981,zaafar,2,0.00005,3939403,91.37941,4311040
16982,zaharidichev,2,0.00005,3939405,91.37946,4311040
16983,ZaMaZaN4iK,2,0.00005,3939407,91.37950,4311040
16984,zawachte-c,2,0.00005,3939409,91.37955,4311040
16985,zenyui,2,0.00005,3939411,91.37960,4311040
16986,zerogjoe,2,0.00005,3939413,91.37964,4311040
16987,zg,2,0.00005,3939415,91.37969,4311040
16988,zhangrongguo,2,0.00005,3939417,91.37974,4311040
16989,ZhengzheYang,2,0.00005,3939419,91.37978,4311040
16990,ZhiminXiang,2,0.00005,3939421,91.37983,4311040
16991,zhouqiang-cl,2,0.00005,3939423,91.37988,4311040
16992,zhranklin,2,0.00005,3939425,91.37992,4311040
16993,zhuxiaolong-g,2,0.00005,3939427,91.37997,4311040
16994,zhwill,2,0.00005,3939429,91.38002,4311040
16995,zigmax,2,0.00005,3939431,91.38006,4311040
16996,zizhuo-yan,2,0.00005,3939433,91.38011,4311040
16997,zlweicoder,2,0.00005,3939435,91.38015,4311040
16998,zmarouf,2,0.00005,3939437,91.38020,4311040
16999,ZMI-JayGorrell,2,0.00005,3939439,91.38025,4311040
17000,zoonman,2,0.00005,3939441,91.38029,4311040
17001,zosocanuck,2,0.00005,3939443,91.38034,4311040
17002,zousheng,2,0.00005,3939445,91.38039,4311040
17003,zrobisho,2,0.00005,3939447,91.38043,4311040
17004,zulh-civo,2,0.00005,3939449,91.38048,4311040
17005,zzzhy,2,0.00005,3939451,91.38053,4311040
17006,00r2,1,0.00002,3939452,91.38055,4311040
17007,0anton,1,0.00002,3939453,91.38057,4311040
17008,0snug0,1,0.00002,3939454,91.38059,4311040
17009,0x636363,1,0.00002,3939455,91.38062,4311040
17010,0xFr0zen,1,0.00002,3939456,91.38064,4311040
17011,0xmichalis,1,0.00002,3939457,91.38066,4311040
17012,0YHR0,1,0.00002,3939458,91.38069,4311040
17013,15077693d,1,0.00002,3939459,91.38071,4311040
17014,1996Shubh,1,0.00002,3939460,91.38073,4311040
17015,2327,1,0.00002,3939461,91.38076,4311040
17016,24king,1,0.00002,3939462,91.38078,4311040
17017,3293172751,1,0.00002,3939463,91.38080,4311040
17018,4nte,1,0.00002,3939464,91.38083,4311040
17019,64bit,1,0.00002,3939465,91.38085,4311040
17020,7felf,1,0.00002,3939466,91.38087,4311040
17021,7fELF,1,0.00002,3939467,91.38090,4311040
17022,814HiManny,1,0.00002,3939468,91.38092,4311040
17023,85danf,1,0.00002,3939469,91.38094,4311040
17024,88plug,1,0.00002,3939470,91.38097,4311040
17025,aa250816,1,0.00002,3939471,91.38099,4311040
17026,A-And,1,0.00002,3939472,91.38101,4311040
17027,aaron7,1,0.00002,3939473,91.38104,4311040
17028,aarongorka,1,0.00002,3939474,91.38106,4311040
17029,aaronLariat,1,0.00002,3939475,91.38108,4311040
17030,AaronLeeIV,1,0.00002,3939476,91.38111,4311040
17031,AaronME14,1,0.00002,3939477,91.38113,4311040
17032,Aaron-ML,1,0.00002,3939478,91.38115,4311040
17033,aaronrryan,1,0.00002,3939479,91.38117,4311040
17034,aaronteague,1,0.00002,3939480,91.38120,4311040
17035,AathithRajendran,1,0.00002,3939481,91.38122,4311040
17036,aayush1205,1,0.00002,3939482,91.38124,4311040
17037,abasitt,1,0.00002,3939483,91.38127,4311040
17038,AbbetWang,1,0.00002,3939484,91.38129,4311040
17039,abcfy2,1,0.00002,3939485,91.38131,4311040
17040,abdelhajji,1,0.00002,3939486,91.38134,4311040
17041,AbdulR3hman,1,0.00002,3939487,91.38136,4311040
17042,abedwardsw,1,0.00002,3939488,91.38138,4311040
17043,abenokraitis,1,0.00002,3939489,91.38141,4311040
17044,abergmann,1,0.00002,3939490,91.38143,4311040
17045,abh139,1,0.00002,3939491,91.38145,4311040
17046,Abhi149209,1,0.00002,3939492,91.38148,4311040
17047,abhi-g,1,0.00002,3939493,91.38150,4311040
17048,abhijeetnijampurkar,1,0.00002,3939494,91.38152,4311040
17049,abhijitherekar,1,0.00002,3939495,91.38155,4311040
17050,abhinavdas,1,0.00002,3939496,91.38157,4311040
17051,abhinavg97,1,0.00002,3939497,91.38159,4311040
17052,abhinavkorpal,1,0.00002,3939498,91.38162,4311040
17053,Abhishek-569,1,0.00002,3939499,91.38164,4311040
17054,Abhishek627,1,0.00002,3939500,91.38166,4311040
17055,abhya944,1,0.00002,3939501,91.38169,4311040
17056,aborilov,1,0.00002,3939502,91.38171,4311040
17057,aboyett,1,0.00002,3939503,91.38173,4311040
17058,abraaojs,1,0.00002,3939504,91.38175,4311040
17059,abrahamfathman,1,0.00002,3939505,91.38178,4311040
17060,Abrishges,1,0.00002,3939506,91.38180,4311040
17061,acald-creator,1,0.00002,3939507,91.38182,4311040
17062,acastle,1,0.00002,3939508,91.38185,4311040
17063,acmenezes,1,0.00002,3939509,91.38187,4311040
17064,acookin,1,0.00002,3939510,91.38189,4311040
17065,acumartini,1,0.00002,3939511,91.38192,4311040
17066,adalga,1,0.00002,3939512,91.38194,4311040
17067,adalrsjr1,1,0.00002,3939513,91.38196,4311040
17068,adambabik,1,0.00002,3939514,91.38199,4311040
17069,adamkdean,1,0.00002,3939515,91.38201,4311040
17070,adamparco,1,0.00002,3939516,91.38203,4311040
17071,adamrbennett,1,0.00002,3939517,91.38206,4311040
17072,adamwojt,1,0.00002,3939518,91.38208,4311040
17073,adellape,1,0.00002,3939519,91.38210,4311040
17074,adelowo,1,0.00002,3939520,91.38213,4311040
17075,adeturner,1,0.00002,3939521,91.38215,4311040
17076,adfernandes,1,0.00002,3939522,91.38217,4311040
17077,adi0509,1,0.00002,3939523,91.38220,4311040
17078,adi658,1,0.00002,3939524,91.38222,4311040
17079,adrianblakey,1,0.00002,3939525,91.38224,4311040
17080,adriangonz,1,0.00002,3939526,91.38227,4311040
17081,adrianRiobo,1,0.00002,3939527,91.38229,4311040
17082,adriantorrie,1,0.00002,3939528,91.38231,4311040
17083,AdrienKuhn,1,0.00002,3939529,91.38233,4311040
17084,adunham-stripe,1,0.00002,3939530,91.38236,4311040
17085,aeciopires,1,0.00002,3939531,91.38238,4311040
17086,aeijdenberg,1,0.00002,3939532,91.38240,4311040
17087,aertoria,1,0.00002,3939533,91.38243,4311040
17088,aexvir,1,0.00002,3939534,91.38245,4311040
17089,afausti,1,0.00002,3939535,91.38247,4311040
17090,afcollins,1,0.00002,3939536,91.38250,4311040
17091,afking,1,0.00002,3939537,91.38252,4311040
17092,AFriemann,1,0.00002,3939538,91.38254,4311040
17093,agershman,1,0.00002,3939539,91.38257,4311040
17094,agorgl,1,0.00002,3939540,91.38259,4311040
17095,agrawroh,1,0.00002,3939541,91.38261,4311040
17096,agtogna-nc,1,0.00002,3939542,91.38264,4311040
17097,agusti-t,1,0.00002,3939543,91.38266,4311040
17098,ahanafy,1,0.00002,3939544,91.38268,4311040
17099,ahawker,1,0.00002,3939545,91.38271,4311040
17100,ahayschi,1,0.00002,3939546,91.38273,4311040
17101,ahgraber,1,0.00002,3939547,91.38275,4311040
17102,ahoka,1,0.00002,3939548,91.38278,4311040
17103,ahuret,1,0.00002,3939549,91.38280,4311040
17104,ahurtaud,1,0.00002,3939550,91.38282,4311040
17105,aidansteele,1,0.00002,3939551,91.38284,4311040
17106,aijamalnk,1,0.00002,3939552,91.38287,4311040
17107,aijanai,1,0.00002,3939553,91.38289,4311040
17108,Aiqbal1234,1,0.00002,3939554,91.38291,4311040
17109,Airren,1,0.00002,3939555,91.38294,4311040
17110,Ajay191191,1,0.00002,3939556,91.38296,4311040
17111,ajhall,1,0.00002,3939557,91.38298,4311040
17112,ajitchahal,1,0.00002,3939558,91.38301,4311040
17113,AjithPanneerselvam,1,0.00002,3939559,91.38303,4311040
17114,ajit-hybris,1,0.00002,3939560,91.38305,4311040
17115,ajonkisz,1,0.00002,3939561,91.38308,4311040
17116,Akashdesarda,1,0.00002,3939562,91.38310,4311040
17117,Akay7,1,0.00002,3939563,91.38312,4311040
17118,akhy,1,0.00002,3939564,91.38315,4311040
17119,aklinkert,1,0.00002,3939565,91.38317,4311040
17120,akomic,1,0.00002,3939566,91.38319,4311040
17121,akranga,1,0.00002,3939567,91.38322,4311040
17122,akshaychitneni,1,0.00002,3939568,91.38324,4311040
17123,akshay-sri123,1,0.00002,3939569,91.38326,4311040
17124,aladdin-atypon,1,0.00002,3939570,91.38329,4311040
17125,alan-copeland-keysight,1,0.00002,3939571,91.38331,4311040
17126,alastairs,1,0.00002,3939572,91.38333,4311040
17127,aldenjenkins,1,0.00002,3939573,91.38336,4311040
17128,alebabai,1,0.00002,3939574,91.38338,4311040
17129,alecharp,1,0.00002,3939575,91.38340,4311040
17130,alecholmez,1,0.00002,3939576,91.38342,4311040
17131,alekdu,1,0.00002,3939577,91.38345,4311040
17132,AleksaC,1,0.00002,3939578,91.38347,4311040
17133,aleksandrov,1,0.00002,3939579,91.38349,4311040
17134,alex,1,0.00002,3939580,91.38352,4311040
17135,alexander-alvarez,1,0.00002,3939581,91.38354,4311040
17136,alexander-knezevic-luetke-gcx,1,0.00002,3939582,91.38356,4311040
17137,AlexandreBrach,1,0.00002,3939583,91.38359,4311040
17138,alexclear,1,0.00002,3939584,91.38361,4311040
17139,alexdresko,1,0.00002,3939585,91.38363,4311040
17140,alexespejoch,1,0.00002,3939586,91.38366,4311040
17141,alexeykazakov,1,0.00002,3939587,91.38368,4311040
17142,alexfouche,1,0.00002,3939588,91.38370,4311040
17143,AlexGilleran,1,0.00002,3939589,91.38373,4311040
17144,alexisgaziello,1,0.00002,3939590,91.38375,4311040
17145,alexjuchina,1,0.00002,3939591,91.38377,4311040
17146,alexstojda,1,0.00002,3939592,91.38380,4311040
17147,alexvanboxel,1,0.00002,3939593,91.38382,4311040
17148,alexykot,1,0.00002,3939594,91.38384,4311040
17149,alfanse,1,0.00002,3939595,91.38387,4311040
17150,alika,1,0.00002,3939596,91.38389,4311040
17151,AliMohammadiSoumee,1,0.00002,3939597,91.38391,4311040
17152,aliok,1,0.00002,3939598,91.38394,4311040
17153,alireza-esmaeeli,1,0.00002,3939599,91.38396,4311040
17154,aliyousafzai183,1,0.00002,3939600,91.38398,4311040
17155,AlKapkone,1,0.00002,3939601,91.38400,4311040
17156,allanchua101,1,0.00002,3939602,91.38403,4311040
17157,allex32,1,0.00002,3939603,91.38405,4311040
17158,almerico,1,0.00002,3939604,91.38407,4311040
17159,alock,1,0.00002,3939605,91.38410,4311040
17160,AloisReitbauer,1,0.00002,3939606,91.38412,4311040
17161,alokmaurya88,1,0.00002,3939607,91.38414,4311040
17162,alphaX86,1,0.00002,3939608,91.38417,4311040
17163,alpiquero,1,0.00002,3939609,91.38419,4311040
17164,althati,1,0.00002,3939610,91.38421,4311040
17165,altonf4,1,0.00002,3939611,91.38424,4311040
17166,alvinlin123,1,0.00002,3939612,91.38426,4311040
17167,alyyousuf7,1,0.00002,3939613,91.38428,4311040
17168,AmaanC,1,0.00002,3939614,91.38431,4311040
17169,amahesh98,1,0.00002,3939615,91.38433,4311040
17170,AmandaHassoun,1,0.00002,3939616,91.38435,4311040
17171,amarkezic,1,0.00002,3939617,91.38438,4311040
17172,amaya382,1,0.00002,3939618,91.38440,4311040
17173,AmbroiseCouissin,1,0.00002,3939619,91.38442,4311040
17174,Amet13,1,0.00002,3939620,91.38445,4311040
17175,aminebizid,1,0.00002,3939621,91.38447,4311040
17176,Aminechakr,1,0.00002,3939622,91.38449,4311040
17177,aminmr,1,0.00002,3939623,91.38452,4311040
17178,amitcmore,1,0.00002,3939624,91.38454,4311040
17179,amit-handa,1,0.00002,3939625,91.38456,4311040
17180,amit-handda,1,0.00002,3939626,91.38458,4311040
17181,amitk-vmware,1,0.00002,3939627,91.38461,4311040
17182,AmitMatsil,1,0.00002,3939628,91.38463,4311040
17183,amitmawkin,1,0.00002,3939629,91.38465,4311040
17184,AmjadHussainSyed,1,0.00002,3939630,91.38468,4311040
17185,amsaha,1,0.00002,3939631,91.38470,4311040
17186,An0nymous0,1,0.00002,3939632,91.38472,4311040
17187,anadon,1,0.00002,3939633,91.38475,4311040
17188,AnaisUrlichs,1,0.00002,3939634,91.38477,4311040
17189,anastasiagrinman,1,0.00002,3939635,91.38479,4311040
17190,AnatoliiStepaniuk,1,0.00002,3939636,91.38482,4311040
17191,andbaraks,1,0.00002,3939637,91.38484,4311040
17192,andbuitra,1,0.00002,3939638,91.38486,4311040
17193,anderfsilva,1,0.00002,3939639,91.38489,4311040
17194,anderm3,1,0.00002,3939640,91.38491,4311040
17195,anders-olofsson,1,0.00002,3939641,91.38493,4311040
17196,andizzle,1,0.00002,3939642,91.38496,4311040
17197,andrascz,1,0.00002,3939643,91.38498,4311040
17198,AndreKapraty,1,0.00002,3939644,91.38500,4311040
17199,andreswebs,1,0.00002,3939645,91.38503,4311040
17200,andrew-bolin,1,0.00002,3939646,91.38505,4311040
17201,andrewdunai,1,0.00002,3939647,91.38507,4311040
17202,andrewgeller,1,0.00002,3939648,91.38510,4311040
17203,AndrewGrachov,1,0.00002,3939649,91.38512,4311040
17204,andrewhertog,1,0.00002,3939650,91.38514,4311040
17205,andrewkavalry,1,0.00002,3939651,91.38516,4311040
17206,AndrewOYLK,1,0.00002,3939652,91.38519,4311040
17207,andrewpollock,1,0.00002,3939653,91.38521,4311040
17208,andrew-waters,1,0.00002,3939654,91.38523,4311040
17209,andrey-moor,1,0.00002,3939655,91.38526,4311040
17210,andriy-bulynko,1,0.00002,3939656,91.38528,4311040
17211,andyyin,1,0.00002,3939657,91.38530,4311040
17212,ANeumann82,1,0.00002,3939658,91.38533,4311040
17213,Angelmmiguel,1,0.00002,3939659,91.38535,4311040
17214,AngelOnFira,1,0.00002,3939660,91.38537,4311040
17215,anikin-aa,1,0.00002,3939661,91.38540,4311040
17216,Anil-kattoju,1,0.00002,3939662,91.38542,4311040
17217,anirtek,1,0.00002,3939663,91.38544,4311040
17218,anirudhr95,1,0.00002,3939664,91.38547,4311040
17219,Anishmourya,1,0.00002,3939665,91.38549,4311040
17220,anjannath,1,0.00002,3939666,91.38551,4311040
17221,ankitforcode,1,0.00002,3939667,91.38554,4311040
17222,ankitnayan,1,0.00002,3939668,91.38556,4311040
17223,ankurcha,1,0.00002,3939669,91.38558,4311040
17224,ankurpshah,1,0.00002,3939670,91.38561,4311040
17225,ankushganatra,1,0.00002,3939671,91.38563,4311040
17226,annymsMthd,1,0.00002,3939672,91.38565,4311040
17227,anoop2503,1,0.00002,3939673,91.38567,4311040
17228,anoop2811,1,0.00002,3939674,91.38570,4311040
17229,ansh-lehri,1,0.00002,3939675,91.38572,4311040
17230,Ant59,1,0.00002,3939676,91.38574,4311040
17231,anta5010,1,0.00002,3939677,91.38577,4311040
17232,AnthonyRuffinoDH,1,0.00002,3939678,91.38579,4311040
17233,antje,1,0.00002,3939679,91.38581,4311040
17234,AntoineToussaint,1,0.00002,3939680,91.38584,4311040
17235,antonblock,1,0.00002,3939681,91.38586,4311040
17236,anton-fedorov,1,0.00002,3939682,91.38588,4311040
17237,AntonioAlfrz,1,0.00002,3939683,91.38591,4311040
17238,antonioua,1,0.00002,3939684,91.38593,4311040
17239,antonkyrylenko,1,0.00002,3939685,91.38595,4311040
17240,anuaimi,1,0.00002,3939686,91.38598,4311040
17241,Anugrahchaturvedi,1,0.00002,3939687,91.38600,4311040
17242,anuruddhal,1,0.00002,3939688,91.38602,4311040
17243,anweiss,1,0.00002,3939689,91.38605,4311040
17244,aoi1,1,0.00002,3939690,91.38607,4311040
17245,apevec,1,0.00002,3939691,91.38609,4311040
17246,apolcyn,1,0.00002,3939692,91.38612,4311040
17247,apuchitnis,1,0.00002,3939693,91.38614,4311040
17248,AravindanSridhar,1,0.00002,3939694,91.38616,4311040
17249,arbreezy,1,0.00002,3939695,91.38619,4311040
17250,arduima,1,0.00002,3939696,91.38621,4311040
17251,aredridel,1,0.00002,3939697,91.38623,4311040
17252,aretakisv,1,0.00002,3939698,91.38625,4311040
17253,arianmotamedi,1,0.00002,3939699,91.38628,4311040
17254,arielvalentin,1,0.00002,3939700,91.38630,4311040
17255,arijeet-majumdar,1,0.00002,3939701,91.38632,4311040
17256,ArimaKouseiYL,1,0.00002,3939702,91.38635,4311040
17257,ArjonBu,1,0.00002,3939703,91.38637,4311040
17258,arjunkrishnasb,1,0.00002,3939704,91.38639,4311040
17259,arnaud-deprez,1,0.00002,3939705,91.38642,4311040
17260,arnavdeshpande1,1,0.00002,3939706,91.38644,4311040
17261,a-roberts,1,0.00002,3939707,91.38646,4311040
17262,aRobinson-R7,1,0.00002,3939708,91.38649,4311040
17263,ArronaxKP,1,0.00002,3939709,91.38651,4311040
17264,arruzk,1,0.00002,3939710,91.38653,4311040
17265,artbegolli,1,0.00002,3939711,91.38656,4311040
17266,artemkozlenkov,1,0.00002,3939712,91.38658,4311040
17267,artemlops,1,0.00002,3939713,91.38660,4311040
17268,arthurbragaa,1,0.00002,3939714,91.38663,4311040
17269,arturoera,1,0.00002,3939715,91.38665,4311040
17270,arturslogins,1,0.00002,3939716,91.38667,4311040
17271,artvichi,1,0.00002,3939717,91.38670,4311040
17272,arunkjn,1,0.00002,3939718,91.38672,4311040
17273,ArunSisodiya,1,0.00002,3939719,91.38674,4311040
17274,ArvinB,1,0.00002,3939720,91.38677,4311040
17275,asafdl,1,0.00002,3939721,91.38679,4311040
17276,aschaber1,1,0.00002,3939722,91.38681,4311040
17277,asears,1,0.00002,3939723,91.38683,4311040
17278,asencis,1,0.00002,3939724,91.38686,4311040
17279,ashahab-altiscale,1,0.00002,3939725,91.38688,4311040
17280,ashahba,1,0.00002,3939726,91.38690,4311040
17281,ashirvadgupta,1,0.00002,3939727,91.38693,4311040
17282,ashish199912,1,0.00002,3939728,91.38695,4311040
17283,ashishjain14,1,0.00002,3939729,91.38697,4311040
17284,ashissharma97,1,0.00002,3939730,91.38700,4311040
17285,Asisranjan,1,0.00002,3939731,91.38702,4311040
17286,asitaru,1,0.00002,3939732,91.38704,4311040
17287,askmeegs,1,0.00002,3939733,91.38707,4311040
17288,Ask-Subhasmita,1,0.00002,3939734,91.38709,4311040
17289,asm0dey,1,0.00002,3939735,91.38711,4311040
17290,asok-mirror,1,0.00002,3939736,91.38714,4311040
17291,AsterNighT,1,0.00002,3939737,91.38716,4311040
17292,asungur,1,0.00002,3939738,91.38718,4311040
17293,aswinsuryan,1,0.00002,3939739,91.38721,4311040
17294,atangeman,1,0.00002,3939740,91.38723,4311040
17295,atifrasheed79,1,0.00002,3939741,91.38725,4311040
17296,atihkin,1,0.00002,3939742,91.38728,4311040
17297,Atish-iaf,1,0.00002,3939743,91.38730,4311040
17298,aucampia,1,0.00002,3939744,91.38732,4311040
17299,AudriusButkevicius,1,0.00002,3939745,91.38735,4311040
17300,audunsolemdal,1,0.00002,3939746,91.38737,4311040
17301,Aurorxa,1,0.00002,3939747,91.38739,4311040
17302,austincunningham,1,0.00002,3939748,91.38741,4311040
17303,avasani,1,0.00002,3939749,91.38744,4311040
17304,avinashjain7143,1,0.00002,3939750,91.38746,4311040
17305,avinson,1,0.00002,3939751,91.38748,4311040
17306,aviral26,1,0.00002,3939752,91.38751,4311040
17307,avnertzur,1,0.00002,3939753,91.38753,4311040
17308,avthart,1,0.00002,3939754,91.38755,4311040
17309,awcchungster,1,0.00002,3939755,91.38758,4311040
17310,awgneo,1,0.00002,3939756,91.38760,4311040
17311,axsauze,1,0.00002,3939757,91.38762,4311040
17312,aybabtme,1,0.00002,3939758,91.38765,4311040
17313,ayoubbensakhria,1,0.00002,3939759,91.38767,4311040
17314,azacchino,1,0.00002,3939760,91.38769,4311040
17315,azagarelz,1,0.00002,3939761,91.38772,4311040
17316,azamora-zsc,1,0.00002,3939762,91.38774,4311040
17317,azazel75,1,0.00002,3939763,91.38776,4311040
17318,azeemshaikh38,1,0.00002,3939764,91.38779,4311040
17319,azmelanar,1,0.00002,3939765,91.38781,4311040
17320,Azrael543,1,0.00002,3939766,91.38783,4311040
17321,baank,1,0.00002,3939767,91.38786,4311040
17322,bachp,1,0.00002,3939768,91.38788,4311040
17323,baconz,1,0.00002,3939769,91.38790,4311040
17324,badie,1,0.00002,3939770,91.38792,4311040
17325,baejinsoo,1,0.00002,3939771,91.38795,4311040
17326,baerwang,1,0.00002,3939772,91.38797,4311040
17327,bageljp,1,0.00002,3939773,91.38799,4311040
17328,bainsy88,1,0.00002,3939774,91.38802,4311040
17329,balajisa09,1,0.00002,3939775,91.38804,4311040
17330,bankershours,1,0.00002,3939776,91.38806,4311040
17331,baosen,1,0.00002,3939777,91.38809,4311040
17332,baptiste-dauphin,1,0.00002,3939778,91.38811,4311040
17333,BarakStout,1,0.00002,3939779,91.38813,4311040
17334,barleyer,1,0.00002,3939780,91.38816,4311040
17335,barthy1,1,0.00002,3939781,91.38818,4311040
17336,bartlettt,1,0.00002,3939782,91.38820,4311040
17337,bartmanus,1,0.00002,3939783,91.38823,4311040
17338,bartvankleef,1,0.00002,3939784,91.38825,4311040
17339,BaskiGIT,1,0.00002,3939785,91.38827,4311040
17340,bassrock,1,0.00002,3939786,91.38830,4311040
17341,bastianeicher,1,0.00002,3939787,91.38832,4311040
17342,bauerd,1,0.00002,3939788,91.38834,4311040
17343,bayudwiyansatria,1,0.00002,3939789,91.38837,4311040
17344,bbc88ks,1,0.00002,3939790,91.38839,4311040
17345,bbdimitriu,1,0.00002,3939791,91.38841,4311040
17346,bbigras,1,0.00002,3939792,91.38844,4311040
17347,bbodenmiller,1,0.00002,3939793,91.38846,4311040
17348,bbrowning,1,0.00002,3939794,91.38848,4311040
17349,bbtong,1,0.00002,3939795,91.38850,4311040
17350,bcaton85,1,0.00002,3939796,91.38853,4311040
17351,bcheung,1,0.00002,3939797,91.38855,4311040
17352,bchrobot,1,0.00002,3939798,91.38857,4311040
17353,bclouser,1,0.00002,3939799,91.38860,4311040
17354,bdekany,1,0.00002,3939800,91.38862,4311040
17355,bdfoster,1,0.00002,3939801,91.38864,4311040
17356,bdronneau,1,0.00002,3939802,91.38867,4311040
17357,bdurrow,1,0.00002,3939803,91.38869,4311040
17358,bearproof,1,0.00002,3939804,91.38871,4311040
17359,becile,1,0.00002,3939805,91.38874,4311040
17360,beckend,1,0.00002,3939806,91.38876,4311040
17361,Beckham007,1,0.00002,3939807,91.38878,4311040
17362,ben,1,0.00002,3939808,91.38881,4311040
17363,BenElgar,1,0.00002,3939809,91.38883,4311040
17364,bengland2,1,0.00002,3939810,91.38885,4311040
17365,Bengrunt,1,0.00002,3939811,91.38888,4311040
17366,benjdlambert,1,0.00002,3939812,91.38890,4311040
17367,benjefferies,1,0.00002,3939813,91.38892,4311040
17368,benjsicam,1,0.00002,3939814,91.38895,4311040
17369,bennyz,1,0.00002,3939815,91.38897,4311040
17370,BenWalters,1,0.00002,3939816,91.38899,4311040
17371,bergkvist,1,0.00002,3939817,91.38902,4311040
17372,bergquist,1,0.00002,3939818,91.38904,4311040
17373,berkil,1,0.00002,3939819,91.38906,4311040
17374,bernadinm,1,0.00002,3939820,91.38908,4311040
17375,BertelBB,1,0.00002,3939821,91.38911,4311040
17376,BertHartm,1,0.00002,3939822,91.38913,4311040
17377,Bezbran,1,0.00002,3939823,91.38915,4311040
17378,bgaillard,1,0.00002,3939824,91.38918,4311040
17379,bgokden,1,0.00002,3939825,91.38920,4311040
17380,bhabermaas,1,0.00002,3939826,91.38922,4311040
17381,bhakiyakalimuthu,1,0.00002,3939827,91.38925,4311040
17382,bhargavamin,1,0.00002,3939828,91.38927,4311040
17383,bhaumikovshek,1,0.00002,3939829,91.38929,4311040
17384,Bhavesh-Joshi,1,0.00002,3939830,91.38932,4311040
17385,bhicks329,1,0.00002,3939831,91.38934,4311040
17386,bianpengyuan,1,0.00002,3939832,91.38936,4311040
17387,bigdatasourav,1,0.00002,3939833,91.38939,4311040
17388,bigLucas,1,0.00002,3939834,91.38941,4311040
17389,bilbof,1,0.00002,3939835,91.38943,4311040
17390,BillyD73,1,0.00002,3939836,91.38946,4311040
17391,billysutomo,1,0.00002,3939837,91.38948,4311040
17392,bin3377,1,0.00002,3939838,91.38950,4311040
17393,Binyamse,1,0.00002,3939839,91.38953,4311040
17394,birbilis,1,0.00002,3939840,91.38955,4311040
17395,birdchan,1,0.00002,3939841,91.38957,4311040
17396,bitmeal,1,0.00002,3939842,91.38960,4311040
17397,bittelc,1,0.00002,3939843,91.38962,4311040
17398,bitvijays,1,0.00002,3939844,91.38964,4311040
17399,bjk-soundcloud,1,0.00002,3939845,91.38966,4311040
17400,bjosv,1,0.00002,3939846,91.38969,4311040
17401,bjwschaap,1,0.00002,3939847,91.38971,4311040
17402,bkanuka,1,0.00002,3939848,91.38973,4311040
17403,bkw,1,0.00002,3939849,91.38976,4311040
17404,BlackDark,1,0.00002,3939850,91.38978,4311040
17405,blackknight36,1,0.00002,3939851,91.38980,4311040
17406,BlackRider97,1,0.00002,3939852,91.38983,4311040
17407,bliles,1,0.00002,3939853,91.38985,4311040
17408,blond-in-blue,1,0.00002,3939854,91.38987,4311040
17409,bluebenno,1,0.00002,3939855,91.38990,4311040
17410,bmariesan,1,0.00002,3939856,91.38992,4311040
17411,bmenn,1,0.00002,3939857,91.38994,4311040
17412,bnookala,1,0.00002,3939858,91.38997,4311040
17413,bnordbo,1,0.00002,3939859,91.38999,4311040
17414,bnsblue,1,0.00002,3939860,91.39001,4311040
17415,bobvawter,1,0.00002,3939861,91.39004,4311040
17416,bobymicroby,1,0.00002,3939862,91.39006,4311040
17417,bodduv,1,0.00002,3939863,91.39008,4311040
17418,bojanv55,1,0.00002,3939864,91.39011,4311040
17419,Bolodya1997,1,0.00002,3939865,91.39013,4311040
17420,Bonn93,1,0.00002,3939866,91.39015,4311040
17421,booyaa,1,0.00002,3939867,91.39017,4311040
17422,boris-42,1,0.00002,3939868,91.39020,4311040
17423,bossjones,1,0.00002,3939869,91.39022,4311040
17424,Bplotka,1,0.00002,3939870,91.39024,4311040
17425,bradwood,1,0.00002,3939871,91.39027,4311040
17426,brandonkrull,1,0.00002,3939872,91.39029,4311040
17427,brantlk,1,0.00002,3939873,91.39031,4311040
17428,breezybaldwin,1,0.00002,3939874,91.39034,4311040
17429,brendangregg,1,0.00002,3939875,91.39036,4311040
17430,brentnk,1,0.00002,3939876,91.39038,4311040
17431,bretep,1,0.00002,3939877,91.39041,4311040
17432,BretFisher,1,0.00002,3939878,91.39043,4311040
17433,brettjacobson,1,0.00002,3939879,91.39045,4311040
17434,brews,1,0.00002,3939880,91.39048,4311040
17435,BrianMWest,1,0.00002,3939881,91.39050,4311040
17436,BrickXu,1,0.00002,3939882,91.39052,4311040
17437,britthouser,1,0.00002,3939883,91.39055,4311040
17438,brix4dayz,1,0.00002,3939884,91.39057,4311040
17439,brkykan,1,0.00002,3939885,91.39059,4311040
17440,brucehorn,1,0.00002,3939886,91.39062,4311040
17441,brujoand,1,0.00002,3939887,91.39064,4311040
17442,brunoborges,1,0.00002,3939888,91.39066,4311040
17443,brunooliveiramac,1,0.00002,3939889,91.39069,4311040
17444,brybacki,1,0.00002,3939890,91.39071,4311040
17445,brycethomsen,1,0.00002,3939891,91.39073,4311040
17446,bryce-wilkinson-rkt,1,0.00002,3939892,91.39075,4311040
17447,bschaeffer,1,0.00002,3939893,91.39078,4311040
17448,bsedat,1,0.00002,3939894,91.39080,4311040
17449,b-slim,1,0.00002,3939895,91.39082,4311040
17450,Buffer0x7cd,1,0.00002,3939896,91.39085,4311040
17451,bugcy013,1,0.00002,3939897,91.39087,4311040
17452,burke,1,0.00002,3939898,91.39089,4311040
17453,buzypi,1,0.00002,3939899,91.39092,4311040
17454,bvis,1,0.00002,3939900,91.39094,4311040
17455,byrnedo,1,0.00002,3939901,91.39096,4311040
17456,bzz,1,0.00002,3939902,91.39099,4311040
17457,c4milo,1,0.00002,3939903,91.39101,4311040
17458,cachemeoutside,1,0.00002,3939904,91.39103,4311040
17459,caiohaz,1,0.00002,3939905,91.39106,4311040
17460,calebwoofenden,1,0.00002,3939906,91.39108,4311040
17461,calinah,1,0.00002,3939907,91.39110,4311040
17462,cam3ron2,1,0.00002,3939908,91.39113,4311040
17463,CameronAckermanSEL,1,0.00002,3939909,91.39115,4311040
17464,camerondavison,1,0.00002,3939910,91.39117,4311040
17465,camille-rodriguez,1,0.00002,3939911,91.39120,4311040
17466,camsjams,1,0.00002,3939912,91.39122,4311040
17467,candonov,1,0.00002,3939913,91.39124,4311040
17468,candyleer,1,0.00002,3939914,91.39127,4311040
17469,canthefason,1,0.00002,3939915,91.39129,4311040
17470,caphrim007,1,0.00002,3939916,91.39131,4311040
17471,captainroy-hy,1,0.00002,3939917,91.39133,4311040
17472,captnbp,1,0.00002,3939918,91.39136,4311040
17473,carlin-q-scott,1,0.00002,3939919,91.39138,4311040
17474,carlosalberto,1,0.00002,3939920,91.39140,4311040
17475,carmstrong,1,0.00002,3939921,91.39143,4311040
17476,CasonChan,1,0.00002,3939922,91.39145,4311040
17477,catchups,1,0.00002,3939923,91.39147,4311040
17478,catto,1,0.00002,3939924,91.39150,4311040
17479,cazter,1,0.00002,3939925,91.39152,4311040
17480,cbenz,1,0.00002,3939926,91.39154,4311040
17481,Cbkhare,1,0.00002,3939927,91.39157,4311040
17482,cblackd7r,1,0.00002,3939928,91.39159,4311040
17483,cbrunnkvist,1,0.00002,3939929,91.39161,4311040
17484,cc4i,1,0.00002,3939930,91.39164,4311040
17485,ccollicutt,1,0.00002,3939931,91.39166,4311040
17486,cdavisafc,1,0.00002,3939932,91.39168,4311040
17487,cduch,1,0.00002,3939933,91.39171,4311040
17488,cecilphillip,1,0.00002,3939934,91.39173,4311040
17489,cedbossneo,1,0.00002,3939935,91.39175,4311040
17490,cedrickring,1,0.00002,3939936,91.39178,4311040
17491,cee-dub,1,0.00002,3939937,91.39180,4311040
17492,centur,1,0.00002,3939938,91.39182,4311040
17493,Cerberussian,1,0.00002,3939939,91.39185,4311040
17494,cesarokuti,1,0.00002,3939940,91.39187,4311040
17495,cfe84,1,0.00002,3939941,91.39189,4311040
17496,cgillum,1,0.00002,3939942,91.39191,4311040
17497,chaiyuxiao,1,0.00002,3939943,91.39194,4311040
17498,ChandraReddy97,1,0.00002,3939944,91.39196,4311040
17499,charles-d-burton,1,0.00002,3939945,91.39198,4311040
17500,charleswhchan,1,0.00002,3939946,91.39201,4311040
17501,charles-woshicai,1,0.00002,3939947,91.39203,4311040
17502,Charley-Mann,1,0.00002,3939948,91.39205,4311040
17503,chasebolt,1,0.00002,3939949,91.39208,4311040
17504,chaudum,1,0.00002,3939950,91.39210,4311040
17505,chauffer,1,0.00002,3939951,91.39212,4311040
17506,chawlanikhil24,1,0.00002,3939952,91.39215,4311040
17507,chendo,1,0.00002,3939953,91.39217,4311040
17508,cheuklau,1,0.00002,3939954,91.39219,4311040
17509,chinmaychandak,1,0.00002,3939955,91.39222,4311040
17510,chipironcin,1,0.00002,3939956,91.39224,4311040
17511,chosenken,1,0.00002,3939957,91.39226,4311040
17512,chr15murray,1,0.00002,3939958,91.39229,4311040
17513,Chr1st0ph,1,0.00002,3939959,91.39231,4311040
17514,chris530,1,0.00002,3939960,91.39233,4311040
17515,chris-armstrong,1,0.00002,3939961,91.39236,4311040
17516,chris-david-taylor,1,0.00002,3939962,91.39238,4311040
17517,chris-downs,1,0.00002,3939963,91.39240,4311040
17518,chrisgoffinet,1,0.00002,3939964,91.39243,4311040
17519,chrisplo,1,0.00002,3939965,91.39245,4311040
17520,ChrisScottThomas,1,0.00002,3939966,91.39247,4311040
17521,christian-kreuzberger-dtx,1,0.00002,3939967,91.39249,4311040
17522,ChristofferNicklassonLenswayGroup,1,0.00002,3939968,91.39252,4311040
17523,christophercutajar,1,0.00002,3939969,91.39254,4311040
17524,chriswright,1,0.00002,3939970,91.39256,4311040
17525,chrkaatz,1,0.00002,3939971,91.39259,4311040
17526,Cicatrice,1,0.00002,3939972,91.39261,4311040
17527,clarkezone,1,0.00002,3939973,91.39263,4311040
17528,ClaudiuPID,1,0.00002,3939974,91.39266,4311040
17529,claytono,1,0.00002,3939975,91.39268,4311040
17530,cleberwarmling,1,0.00002,3939976,91.39270,4311040
17531,cleech,1,0.00002,3939977,91.39273,4311040
17532,clockworksoul,1,0.00002,3939978,91.39275,4311040
17533,cloudnautique,1,0.00002,3939979,91.39277,4311040
17534,cloudoutloud,1,0.00002,3939980,91.39280,4311040
17535,cloudymax,1,0.00002,3939981,91.39282,4311040
17536,cmartintlh,1,0.00002,3939982,91.39284,4311040
17537,cmeury,1,0.00002,3939983,91.39287,4311040
17538,cmhokej,1,0.00002,3939984,91.39289,4311040
17539,cmingxu,1,0.00002,3939985,91.39291,4311040
17540,CodechCFA,1,0.00002,3939986,91.39294,4311040
17541,codeclown,1,0.00002,3939987,91.39296,4311040
17542,code-haven,1,0.00002,3939988,91.39298,4311040
17543,coderplay,1,0.00002,3939989,91.39300,4311040
17544,codingmaths,1,0.00002,3939990,91.39303,4311040
17545,colin-mccarthy,1,0.00002,3939991,91.39305,4311040
17546,come2abhi,1,0.00002,3939992,91.39307,4311040
17547,compleatang,1,0.00002,3939993,91.39310,4311040
17548,Congrool,1,0.00002,3939994,91.39312,4311040
17549,contra,1,0.00002,3939995,91.39314,4311040
17550,convexquad,1,0.00002,3939996,91.39317,4311040
17551,coollog,1,0.00002,3939997,91.39319,4311040
17552,coro,1,0.00002,3939998,91.39321,4311040
17553,coryallegory,1,0.00002,3939999,91.39324,4311040
17554,cory-klein,1,0.00002,3940000,91.39326,4311040
17555,CourseraStudent58,1,0.00002,3940001,91.39328,4311040
17556,cpatulea,1,0.00002,3940002,91.39331,4311040
17557,cpdeethree,1,0.00002,3940003,91.39333,4311040
17558,cpick,1,0.00002,3940004,91.39335,4311040
17559,cpretzer,1,0.00002,3940005,91.39338,4311040
17560,cpunella,1,0.00002,3940006,91.39340,4311040
17561,Crayeth,1,0.00002,3940007,91.39342,4311040
17562,crazytan,1,0.00002,3940008,91.39345,4311040
17563,creinig,1,0.00002,3940009,91.39347,4311040
17564,crhntr,1,0.00002,3940010,91.39349,4311040
17565,CSimpiFoN,1,0.00002,3940011,91.39352,4311040
17566,csturgess93,1,0.00002,3940012,91.39354,4311040
17567,cswinter,1,0.00002,3940013,91.39356,4311040
17568,cupello,1,0.00002,3940014,91.39358,4311040
17569,Cuppojoe,1,0.00002,3940015,91.39361,4311040
17570,cuzz22000,1,0.00002,3940016,91.39363,4311040
17571,cvanderschuere,1,0.00002,3940017,91.39365,4311040
17572,Cvr421,1,0.00002,3940018,91.39368,4311040
17573,cwiggs,1,0.00002,3940019,91.39370,4311040
17574,cwilhit,1,0.00002,3940020,91.39372,4311040
17575,cw-kuoka,1,0.00002,3940021,91.39375,4311040
17576,cwwarren,1,0.00002,3940022,91.39377,4311040
17577,CyberHippo,1,0.00002,3940023,91.39379,4311040
17578,d23,1,0.00002,3940024,91.39382,4311040
17579,daanemanz,1,0.00002,3940025,91.39384,4311040
17580,dacleyra,1,0.00002,3940026,91.39386,4311040
17581,dacloutier,1,0.00002,3940027,91.39389,4311040
17582,dadrian,1,0.00002,3940028,91.39391,4311040
17583,Dakuan,1,0.00002,3940029,91.39393,4311040
17584,dalfos,1,0.00002,3940030,91.39396,4311040
17585,dalvizu,1,0.00002,3940031,91.39398,4311040
17586,damadei-google,1,0.00002,3940032,91.39400,4311040
17587,danail-branekov,1,0.00002,3940033,91.39403,4311040
17588,danapoklepovich,1,0.00002,3940034,91.39405,4311040
17589,dandillingham,1,0.00002,3940035,91.39407,4311040
17590,danehrlich1,1,0.00002,3940036,91.39410,4311040
17591,dangarthwaite,1,0.00002,3940037,91.39412,4311040
17592,DanHeidinga,1,0.00002,3940038,91.39414,4311040
17593,danibaeyens,1,0.00002,3940039,91.39416,4311040
17594,danieldonoghue,1,0.00002,3940040,91.39419,4311040
17595,danielezer,1,0.00002,3940041,91.39421,4311040
17596,DanielLund,1,0.00002,3940042,91.39423,4311040
17597,danielmittelman,1,0.00002,3940043,91.39426,4311040
17598,danieloliveira079,1,0.00002,3940044,91.39428,4311040
17599,DanielWangZhanggui,1,0.00002,3940045,91.39430,4311040
17600,DanKerns,1,0.00002,3940046,91.39433,4311040
17601,dannyzaken,1,0.00002,3940047,91.39435,4311040
17602,danrspencer,1,0.00002,3940048,91.39437,4311040
17603,darioblanco,1,0.00002,3940049,91.39440,4311040
17604,darkdatter,1,0.00002,3940050,91.39442,4311040
17605,darkweaver87,1,0.00002,3940051,91.39444,4311040
17606,DarqueWarrior,1,0.00002,3940052,91.39447,4311040
17607,darthsuogles,1,0.00002,3940053,91.39449,4311040
17608,daryllstrauss,1,0.00002,3940054,91.39451,4311040
17609,dav009,1,0.00002,3940055,91.39454,4311040
17610,davechesebrough,1,0.00002,3940056,91.39456,4311040
17611,davegallant,1,0.00002,3940057,91.39458,4311040
17612,DaveSlinn,1,0.00002,3940058,91.39461,4311040
17613,davesteinberg,1,0.00002,3940059,91.39463,4311040
17614,davey-dev,1,0.00002,3940060,91.39465,4311040
17615,davidbatelu,1,0.00002,3940061,91.39468,4311040
17616,davidblewett,1,0.00002,3940062,91.39470,4311040
17617,davidemerritt,1,0.00002,3940063,91.39472,4311040
17618,davidffrench,1,0.00002,3940064,91.39474,4311040
17619,David-Kunz,1,0.00002,3940065,91.39477,4311040
17620,davidmirza408,1,0.00002,3940066,91.39479,4311040
17621,davidmontoyago,1,0.00002,3940067,91.39481,4311040
17622,davidmortiz,1,0.00002,3940068,91.39484,4311040
17623,davidreuss,1,0.00002,3940069,91.39486,4311040
17624,DaviSoares454,1,0.00002,3940070,91.39488,4311040
17625,davyodom,1,0.00002,3940071,91.39491,4311040
17626,dazinator,1,0.00002,3940072,91.39493,4311040
17627,dbarentine,1,0.00002,3940073,91.39495,4311040
17628,DBarthe,1,0.00002,3940074,91.39498,4311040
17629,dblate,1,0.00002,3940075,91.39500,4311040
17630,dbnegative,1,0.00002,3940076,91.39502,4311040
17631,dcj,1,0.00002,3940077,91.39505,4311040
17632,ddcprg,1,0.00002,3940078,91.39507,4311040
17633,ddlees,1,0.00002,3940079,91.39509,4311040
17634,ddobric,1,0.00002,3940080,91.39512,4311040
17635,debdutdeb,1,0.00002,3940081,91.39514,4311040
17636,debMan,1,0.00002,3940082,91.39516,4311040
17637,debojitkakoti,1,0.00002,3940083,91.39519,4311040
17638,decayofmind,1,0.00002,3940084,91.39521,4311040
17639,dedsm,1,0.00002,3940085,91.39523,4311040
17640,deepak1725,1,0.00002,3940086,91.39525,4311040
17641,defat,1,0.00002,3940087,91.39528,4311040
17642,dellintosh,1,0.00002,3940088,91.39530,4311040
17643,delroth,1,0.00002,3940089,91.39532,4311040
17644,demon,1,0.00002,3940090,91.39535,4311040
17645,deniojunior,1,0.00002,3940091,91.39537,4311040
17646,denismakogon,1,0.00002,3940092,91.39539,4311040
17647,dennis-tra,1,0.00002,3940093,91.39542,4311040
17648,derekargueta,1,0.00002,3940094,91.39544,4311040
17649,derekbit,1,0.00002,3940095,91.39546,4311040
17650,derekguo001,1,0.00002,3940096,91.39549,4311040
17651,derekm,1,0.00002,3940097,91.39551,4311040
17652,dereknola,1,0.00002,3940098,91.39553,4311040
17653,derkoe,1,0.00002,3940099,91.39556,4311040
17654,desktophero,1,0.00002,3940100,91.39558,4311040
17655,DesmondH0,1,0.00002,3940101,91.39560,4311040
17656,deveshmehta,1,0.00002,3940102,91.39563,4311040
17657,devnev,1,0.00002,3940103,91.39565,4311040
17658,devrajmaker,1,0.00002,3940104,91.39567,4311040
17659,devthejo,1,0.00002,3940105,91.39570,4311040
17660,deyuhua,1,0.00002,3940106,91.39572,4311040
17661,dfgrosso,1,0.00002,3940107,91.39574,4311040
17662,dfroberg,1,0.00002,3940108,91.39577,4311040
17663,dgn,1,0.00002,3940109,91.39579,4311040
17664,dgolovin,1,0.00002,3940110,91.39581,4311040
17665,dgreene1,1,0.00002,3940111,91.39583,4311040
17666,dgryski,1,0.00002,3940112,91.39586,4311040
17667,dguerri,1,0.00002,3940113,91.39588,4311040
17668,dgzlopes,1,0.00002,3940114,91.39590,4311040
17669,Diaphteiros,1,0.00002,3940115,91.39593,4311040
17670,diarmuidie,1,0.00002,3940116,91.39595,4311040
17671,dicarlo2,1,0.00002,3940117,91.39597,4311040
17672,dicolasi,1,0.00002,3940118,91.39600,4311040
17673,didip,1,0.00002,3940119,91.39602,4311040
17674,diegosucaria,1,0.00002,3940120,91.39604,4311040
17675,die-kriegsmarine,1,0.00002,3940121,91.39607,4311040
17676,diemtvu,1,0.00002,3940122,91.39609,4311040
17677,Dieterbe,1,0.00002,3940123,91.39611,4311040
17678,digiserg,1,0.00002,3940124,91.39614,4311040
17679,digitalkaoz,1,0.00002,3940125,91.39616,4311040
17680,digitalnomd,1,0.00002,3940126,91.39618,4311040
17681,digitole,1,0.00002,3940127,91.39621,4311040
17682,digivava,1,0.00002,3940128,91.39623,4311040
17683,dingjiefeng,1,0.00002,3940129,91.39625,4311040
17684,dingyin,1,0.00002,3940130,91.39628,4311040
17685,dinogun,1,0.00002,3940131,91.39630,4311040
17686,dio,1,0.00002,3940132,91.39632,4311040
17687,dipakparmar,1,0.00002,3940133,91.39635,4311040
17688,discreet,1,0.00002,3940134,91.39637,4311040
17689,divideby0,1,0.00002,3940135,91.39639,4311040
17690,djfinnoy,1,0.00002,3940136,91.39641,4311040
17691,djru,1,0.00002,3940137,91.39644,4311040
17692,djs55,1,0.00002,3940138,91.39646,4311040
17693,djuretic,1,0.00002,3940139,91.39648,4311040
17694,dkiser,1,0.00002,3940140,91.39651,4311040
17695,dlaufer,1,0.00002,3940141,91.39653,4311040
17696,dliappis,1,0.00002,3940142,91.39655,4311040
17697,dln,1,0.00002,3940143,91.39658,4311040
17698,dLobatog,1,0.00002,3940144,91.39660,4311040
17699,dlom,1,0.00002,3940145,91.39662,4311040
17700,dmarkwat,1,0.00002,3940146,91.39665,4311040
17701,dmegyesi,1,0.00002,3940147,91.39667,4311040
17702,dmesser,1,0.00002,3940148,91.39669,4311040
17703,dmitri-d,1,0.00002,3940149,91.39672,4311040
17704,dmitryzykov,1,0.00002,3940150,91.39674,4311040
17705,dmonakhov,1,0.00002,3940151,91.39676,4311040
17706,dmvk,1,0.00002,3940152,91.39679,4311040
17707,dnauck,1,0.00002,3940153,91.39681,4311040
17708,doctapp,1,0.00002,3940154,91.39683,4311040
17709,dogukancagatay,1,0.00002,3940155,91.39686,4311040
17710,dojadop,1,0.00002,3940156,91.39688,4311040
17711,domgreen,1,0.00002,3940157,91.39690,4311040
17712,donaldh,1,0.00002,3940158,91.39693,4311040
17713,donhcd,1,0.00002,3940159,91.39695,4311040
17714,donnikanton,1,0.00002,3940160,91.39697,4311040
17715,dorjanshurdhi,1,0.00002,3940161,91.39699,4311040
17716,douglasawh,1,0.00002,3940162,91.39702,4311040
17717,douglas-gibbons,1,0.00002,3940163,91.39704,4311040
17718,dpacierpnik,1,0.00002,3940164,91.39706,4311040
17719,dpankros,1,0.00002,3940165,91.39709,4311040
17720,dpeckett,1,0.00002,3940166,91.39711,4311040
17721,dpires,1,0.00002,3940167,91.39713,4311040
17722,DraconPern,1,0.00002,3940168,91.39716,4311040
17723,draeron,1,0.00002,3940169,91.39718,4311040
17724,dragonly,1,0.00002,3940170,91.39720,4311040
17725,draychev,1,0.00002,3940171,91.39723,4311040
17726,drcrook1,1,0.00002,3940172,91.39725,4311040
17727,dreh23,1,0.00002,3940173,91.39727,4311040
17728,drobison00,1,0.00002,3940174,91.39730,4311040
17729,DrPhil,1,0.00002,3940175,91.39732,4311040
17730,drpmma,1,0.00002,3940176,91.39734,4311040
17731,dseomn,1,0.00002,3940177,91.39737,4311040
17732,dtantsur,1,0.00002,3940178,91.39739,4311040
17733,dtatulea,1,0.00002,3940179,91.39741,4311040
17734,DTMad,1,0.00002,3940180,91.39744,4311040
17735,dt-rush,1,0.00002,3940181,91.39746,4311040
17736,dturanski,1,0.00002,3940182,91.39748,4311040
17737,ducas,1,0.00002,3940183,91.39751,4311040
17738,durairajasivam,1,0.00002,3940184,91.39753,4311040
17739,dustinblack,1,0.00002,3940185,91.39755,4311040
17740,dustyrip,1,0.00002,3940186,91.39757,4311040
17741,duyanyan,1,0.00002,3940187,91.39760,4311040
17742,duythinht,1,0.00002,3940188,91.39762,4311040
17743,dvonessen,1,0.00002,3940189,91.39764,4311040
17744,dwalleck,1,0.00002,3940190,91.39767,4311040
17745,dwarburt,1,0.00002,3940191,91.39769,4311040
17746,dwardu89,1,0.00002,3940192,91.39771,4311040
17747,dwertent,1,0.00002,3940193,91.39774,4311040
17748,dwhitena,1,0.00002,3940194,91.39776,4311040
17749,DylanBowden,1,0.00002,3940195,91.39778,4311040
17750,dylanzr,1,0.00002,3940196,91.39781,4311040
17751,dynajoe,1,0.00002,3940197,91.39783,4311040
17752,dzavalkinolx,1,0.00002,3940198,91.39785,4311040
17753,e3b0c442,1,0.00002,3940199,91.39788,4311040
17754,earth2marsh,1,0.00002,3940200,91.39790,4311040
17755,ebar0n,1,0.00002,3940201,91.39792,4311040
17756,ectogon,1,0.00002,3940202,91.39795,4311040
17757,edovale,1,0.00002,3940203,91.39797,4311040
17758,EduardoVega,1,0.00002,3940204,91.39799,4311040
17759,efistasija,1,0.00002,3940205,91.39802,4311040
17760,eformat,1,0.00002,3940206,91.39804,4311040
17761,egeturgay,1,0.00002,3940207,91.39806,4311040
17762,eguzki,1,0.00002,3940208,91.39808,4311040
17763,eirinikos,1,0.00002,3940209,91.39811,4311040
17764,ejsmith,1,0.00002,3940210,91.39813,4311040
17765,ekitson,1,0.00002,3940211,91.39815,4311040
17766,eladitzhakian,1,0.00002,3940212,91.39818,4311040
17767,ElArtista,1,0.00002,3940213,91.39820,4311040
17768,eLco,1,0.00002,3940214,91.39822,4311040
17769,elconas,1,0.00002,3940215,91.39825,4311040
17770,elfadel,1,0.00002,3940216,91.39827,4311040
17771,elharo,1,0.00002,3940217,91.39829,4311040
17772,elinesterov,1,0.00002,3940218,91.39832,4311040
17773,elliotkennedy,1,0.00002,3940219,91.39834,4311040
17774,ellis-bigelow,1,0.00002,3940220,91.39836,4311040
17775,elnemesisdivina,1,0.00002,3940221,91.39839,4311040
17776,else,1,0.00002,3940222,91.39841,4311040
17777,emailbob,1,0.00002,3940223,91.39843,4311040
17778,emailtovinod,1,0.00002,3940224,91.39846,4311040
17779,emaincourt,1,0.00002,3940225,91.39848,4311040
17780,emanuelr93,1,0.00002,3940226,91.39850,4311040
17781,emaste,1,0.00002,3940227,91.39853,4311040
17782,embs,1,0.00002,3940228,91.39855,4311040
17783,emichaf,1,0.00002,3940229,91.39857,4311040
17784,EmiiKhaos,1,0.00002,3940230,91.39860,4311040
17785,emouawad,1,0.00002,3940231,91.39862,4311040
17786,emper0r,1,0.00002,3940232,91.39864,4311040
17787,emrahcetiner,1,0.00002,3940233,91.39866,4311040
17788,endophage,1,0.00002,3940234,91.39869,4311040
17789,Engerim,1,0.00002,3940235,91.39871,4311040
17790,engineerakki,1,0.00002,3940236,91.39873,4311040
17791,enriched,1,0.00002,3940237,91.39876,4311040
17792,Enrico204,1,0.00002,3940238,91.39878,4311040
17793,enricoschiattarella,1,0.00002,3940239,91.39880,4311040
17794,eohtake,1,0.00002,3940240,91.39883,4311040
17795,eolivelli,1,0.00002,3940241,91.39885,4311040
17796,eperdeme,1,0.00002,3940242,91.39887,4311040
17797,Eran-BenShahar,1,0.00002,3940243,91.39890,4311040
17798,erdrix,1,0.00002,3940244,91.39892,4311040
17799,erekgit,1,0.00002,3940245,91.39894,4311040
17800,ErezAlster,1,0.00002,3940246,91.39897,4311040
17801,eriadam,1,0.00002,3940247,91.39899,4311040
17802,eric4545,1,0.00002,3940248,91.39901,4311040
17803,ericabramov,1,0.00002,3940249,91.39904,4311040
17804,ericandrewmeadows,1,0.00002,3940250,91.39906,4311040
17805,ericfucer,1,0.00002,3940251,91.39908,4311040
17806,eric-saintetienne,1,0.00002,3940252,91.39911,4311040
17807,erig0,1,0.00002,3940253,91.39913,4311040
17808,ermazi,1,0.00002,3940254,91.39915,4311040
17809,Eros11on,1,0.00002,3940255,91.39918,4311040
17810,erran,1,0.00002,3940256,91.39920,4311040
17811,erriapo,1,0.00002,3940257,91.39922,4311040
17812,esbie,1,0.00002,3940258,91.39924,4311040
17813,EslamElHusseiny,1,0.00002,3940259,91.39927,4311040
17814,ethanhanjiahao,1,0.00002,3940260,91.39929,4311040
17815,ethicalaakash,1,0.00002,3940261,91.39931,4311040
17816,etiennedi,1,0.00002,3940262,91.39934,4311040
17817,etoews,1,0.00002,3940263,91.39936,4311040
17818,eug48,1,0.00002,3940264,91.39938,4311040
17819,evadnoob,1,0.00002,3940265,91.39941,4311040
17820,evagonz,1,0.00002,3940266,91.39943,4311040
17821,evaneaston,1,0.00002,3940267,91.39945,4311040
17822,EvgenySamoylov,1,0.00002,3940268,91.39948,4311040
17823,Evilong,1,0.00002,3940269,91.39950,4311040
17824,ewassef,1,0.00002,3940270,91.39952,4311040
17825,ewindisch,1,0.00002,3940271,91.39955,4311040
17826,ewjmulder,1,0.00002,3940272,91.39957,4311040
17827,exu,1,0.00002,3940273,91.39959,4311040
17828,eyjohn,1,0.00002,3940274,91.39962,4311040
17829,eyusupov,1,0.00002,3940275,91.39964,4311040
17830,ezk84,1,0.00002,3940276,91.39966,4311040
17831,fabasoad,1,0.00002,3940277,91.39969,4311040
17832,fabio-510,1,0.00002,3940278,91.39971,4311040
17833,fabio-lab15,1,0.00002,3940279,91.39973,4311040
17834,fabio-rigato,1,0.00002,3940280,91.39976,4311040
17835,fabito,1,0.00002,3940281,91.39978,4311040
17836,fadesiderio,1,0.00002,3940282,91.39980,4311040
17837,fai555,1,0.00002,3940283,91.39982,4311040
17838,fallard84,1,0.00002,3940284,91.39985,4311040
17839,fams,1,0.00002,3940285,91.39987,4311040
17840,fatmcgav,1,0.00002,3940286,91.39989,4311040
17841,fbaier-fn,1,0.00002,3940287,91.39992,4311040
17842,fbrousse,1,0.00002,3940288,91.39994,4311040
17843,fbsb,1,0.00002,3940289,91.39996,4311040
17844,fdhex,1,0.00002,3940290,91.39999,4311040
17845,Felihong,1,0.00002,3940291,91.40001,4311040
17846,felixge,1,0.00002,3940292,91.40003,4311040
17847,FelixJacobsen,1,0.00002,3940293,91.40006,4311040
17848,fengwang666,1,0.00002,3940294,91.40008,4311040
17849,ferngarc,1,0.00002,3940295,91.40010,4311040
17850,fikriauliya,1,0.00002,3940296,91.40013,4311040
17851,FilipB,1,0.00002,3940297,91.40015,4311040
17852,fivesheep,1,0.00002,3940298,91.40017,4311040
17853,fkrauthan,1,0.00002,3940299,91.40020,4311040
17854,fmovlex,1,0.00002,3940300,91.40022,4311040
17855,forestgagnon,1,0.00002,3940301,91.40024,4311040
17856,forkjoseph,1,0.00002,3940302,91.40027,4311040
17857,fourierr,1,0.00002,3940303,91.40029,4311040
17858,FourSpaces,1,0.00002,3940304,91.40031,4311040
17859,foux,1,0.00002,3940305,91.40033,4311040
17860,FranCao,1,0.00002,3940306,91.40036,4311040
17861,franklin-stripe,1,0.00002,3940307,91.40038,4311040
17862,frankscholten,1,0.00002,3940308,91.40040,4311040
17863,fred,1,0.00002,3940309,91.40043,4311040
17864,frederich,1,0.00002,3940310,91.40045,4311040
17865,fredrb,1,0.00002,3940311,91.40047,4311040
17866,fredwangwang,1,0.00002,3940312,91.40050,4311040
17867,freehck-codefresh,1,0.00002,3940313,91.40052,4311040
17868,frenchtoasters,1,0.00002,3940314,91.40054,4311040
17869,fristedt,1,0.00002,3940315,91.40057,4311040
17870,FrodeHus,1,0.00002,3940316,91.40059,4311040
17871,Fryuni,1,0.00002,3940317,91.40061,4311040
17872,fsequeira1,1,0.00002,3940318,91.40064,4311040
17873,fsoppelsa,1,0.00002,3940319,91.40066,4311040
17874,fstn,1,0.00002,3940320,91.40068,4311040
17875,fuel-wlightning,1,0.00002,3940321,91.40071,4311040
17876,Furtchet,1,0.00002,3940322,91.40073,4311040
17877,furuholm,1,0.00002,3940323,91.40075,4311040
17878,fvillain,1,0.00002,3940324,91.40078,4311040
17879,fvogl,1,0.00002,3940325,91.40080,4311040
17880,fweimer,1,0.00002,3940326,91.40082,4311040
17881,fzakaria,1,0.00002,3940327,91.40085,4311040
17882,g0blin79,1,0.00002,3940328,91.40087,4311040
17883,g10f,1,0.00002,3940329,91.40089,4311040
17884,gabemeola,1,0.00002,3940330,91.40091,4311040
17885,gabemontero,1,0.00002,3940331,91.40094,4311040
17886,gabrielwen,1,0.00002,3940332,91.40096,4311040
17887,gaius-qi,1,0.00002,3940333,91.40098,4311040
17888,galbacarys,1,0.00002,3940334,91.40101,4311040
17889,gargnupur,1,0.00002,3940335,91.40103,4311040
17890,Garnaalkroket,1,0.00002,3940336,91.40105,4311040
17891,garrett-compass,1,0.00002,3940337,91.40108,4311040
17892,garyedwards,1,0.00002,3940338,91.40110,4311040
17893,gautambaghel,1,0.00002,3940339,91.40112,4311040
17894,gauthamsunjay,1,0.00002,3940340,91.40115,4311040
17895,gbaeke,1,0.00002,3940341,91.40117,4311040
17896,gbbr,1,0.00002,3940342,91.40119,4311040
17897,gbird3,1,0.00002,3940343,91.40122,4311040
17898,gdemarcsek,1,0.00002,3940344,91.40124,4311040
17899,gdhagger,1,0.00002,3940345,91.40126,4311040
17900,gdrudy,1,0.00002,3940346,91.40129,4311040
17901,GeckoSplinter,1,0.00002,3940347,91.40131,4311040
17902,geekdk,1,0.00002,3940348,91.40133,4311040
17903,GeekyTex,1,0.00002,3940349,91.40136,4311040
17904,geetachauhan,1,0.00002,3940350,91.40138,4311040
17905,geku,1,0.00002,3940351,91.40140,4311040
17906,gempesaw,1,0.00002,3940352,91.40143,4311040
17907,genedna,1,0.00002,3940353,91.40145,4311040
17908,genevieve,1,0.00002,3940354,91.40147,4311040
17909,gengu,1,0.00002,3940355,91.40149,4311040
17910,geobeau,1,0.00002,3940356,91.40152,4311040
17911,geoberle,1,0.00002,3940357,91.40154,4311040
17912,georgeharley,1,0.00002,3940358,91.40156,4311040
17913,georgelza,1,0.00002,3940359,91.40159,4311040
17914,georghinkel,1,0.00002,3940360,91.40161,4311040
17915,georgyo,1,0.00002,3940361,91.40163,4311040
17916,gerassimos,1,0.00002,3940362,91.40166,4311040
17917,gergelyke,1,0.00002,3940363,91.40168,4311040
17918,geropl,1,0.00002,3940364,91.40170,4311040
17919,geyaning,1,0.00002,3940365,91.40173,4311040
17920,gfinocchiaro,1,0.00002,3940366,91.40175,4311040
17921,ggee,1,0.00002,3940367,91.40177,4311040
17922,ggreer,1,0.00002,3940368,91.40180,4311040
17923,ghaering,1,0.00002,3940369,91.40182,4311040
17924,ghanshyammann,1,0.00002,3940370,91.40184,4311040
17925,gharsallahmoez,1,0.00002,3940371,91.40187,4311040
17926,giany,1,0.00002,3940372,91.40189,4311040
17927,giggio,1,0.00002,3940373,91.40191,4311040
17928,gila,1,0.00002,3940374,91.40194,4311040
17929,gionapaolini,1,0.00002,3940375,91.40196,4311040
17930,gionn,1,0.00002,3940376,91.40198,4311040
17931,gitanuj,1,0.00002,3940377,91.40201,4311040
17932,givia,1,0.00002,3940378,91.40203,4311040
17933,gkalele,1,0.00002,3940379,91.40205,4311040
17934,gkaskonas,1,0.00002,3940380,91.40207,4311040
17935,GlassOfWhiskey,1,0.00002,3940381,91.40210,4311040
17936,gleichda,1,0.00002,3940382,91.40212,4311040
17937,glouischandra,1,0.00002,3940383,91.40214,4311040
17938,GLYASAI,1,0.00002,3940384,91.40217,4311040
17939,glycerine,1,0.00002,3940385,91.40219,4311040
17940,gmiroshnykov,1,0.00002,3940386,91.40221,4311040
17941,GMZwinge,1,0.00002,3940387,91.40224,4311040
17942,gnarled-cipher,1,0.00002,3940388,91.40226,4311040
17943,gnirodi,1,0.00002,3940389,91.40228,4311040
17944,gnunn1,1,0.00002,3940390,91.40231,4311040
17945,gokhandincer,1,0.00002,3940391,91.40233,4311040
17946,gokhankocak,1,0.00002,3940392,91.40235,4311040
17947,golaneduard,1,0.00002,3940393,91.40238,4311040
17948,goldmann,1,0.00002,3940394,91.40240,4311040
17949,goller,1,0.00002,3940395,91.40242,4311040
17950,golonzovsky,1,0.00002,3940396,91.40245,4311040
17951,goneall,1,0.00002,3940397,91.40247,4311040
17952,gonzojive,1,0.00002,3940398,91.40249,4311040
17953,gorilych,1,0.00002,3940399,91.40252,4311040
17954,gothicfann,1,0.00002,3940400,91.40254,4311040
17955,gpflaum,1,0.00002,3940401,91.40256,4311040
17956,GrantSeltzer,1,0.00002,3940402,91.40258,4311040
17957,greenren,1,0.00002,3940403,91.40261,4311040
17958,gregkh,1,0.00002,3940404,91.40263,4311040
17959,gregoryfranklin,1,0.00002,3940405,91.40265,4311040
17960,gretel,1,0.00002,3940406,91.40268,4311040
17961,greywolve,1,0.00002,3940407,91.40270,4311040
17962,grounded042,1,0.00002,3940408,91.40272,4311040
17963,grrywlsn,1,0.00002,3940409,91.40275,4311040
17964,gruberrichard,1,0.00002,3940410,91.40277,4311040
17965,grugnog,1,0.00002,3940411,91.40279,4311040
17966,GRuuuuu,1,0.00002,3940412,91.40282,4311040
17967,gsemet,1,0.00002,3940413,91.40284,4311040
17968,gsoria,1,0.00002,3940414,91.40286,4311040
17969,guesslin,1,0.00002,3940415,91.40289,4311040
17970,guhcampos,1,0.00002,3940416,91.40291,4311040
17971,gullapalli9482,1,0.00002,3940417,91.40293,4311040
17972,guoguodan,1,0.00002,3940418,91.40296,4311040
17973,guptaabhish,1,0.00002,3940419,91.40298,4311040
17974,guptasu,1,0.00002,3940420,91.40300,4311040
17975,guxlightyear,1,0.00002,3940421,91.40303,4311040
17976,guyelia,1,0.00002,3940422,91.40305,4311040
17977,guysoft,1,0.00002,3940423,91.40307,4311040
17978,Guyzeroth,1,0.00002,3940424,91.40310,4311040
17979,gvalentinivmw,1,0.00002,3940425,91.40312,4311040
17980,gvillafanetapia,1,0.00002,3940426,91.40314,4311040
17981,h3llix,1,0.00002,3940427,91.40316,4311040
17982,hagaibarel,1,0.00002,3940428,91.40319,4311040
17983,haimberger,1,0.00002,3940429,91.40321,4311040
17984,haithamshahin333,1,0.00002,3940430,91.40323,4311040
17985,halegreen,1,0.00002,3940431,91.40326,4311040
17986,halfa,1,0.00002,3940432,91.40328,4311040
17987,Hamdan-Atypon,1,0.00002,3940433,91.40330,4311040
17988,hamza-tumturk,1,0.00002,3940434,91.40333,4311040
17989,haneefkassam,1,0.00002,3940435,91.40335,4311040
17990,Hangzhi,1,0.00002,3940436,91.40337,4311040
17991,haoch,1,0.00002,3940437,91.40340,4311040
17992,haohaolee,1,0.00002,3940438,91.40342,4311040
17993,haoyixin,1,0.00002,3940439,91.40344,4311040
17994,hargut,1,0.00002,3940440,91.40347,4311040
17995,hariharan16s,1,0.00002,3940441,91.40349,4311040
17996,harisund,1,0.00002,3940442,91.40351,4311040
17997,HarmtH,1,0.00002,3940443,91.40354,4311040
17998,harryleesan,1,0.00002,3940444,91.40356,4311040
17999,harutyundermenjyan,1,0.00002,3940445,91.40358,4311040
18000,Harwayne,1,0.00002,3940446,91.40361,4311040
18001,HassanHashemi,1,0.00002,3940447,91.40363,4311040
18002,hasueki,1,0.00002,3940448,91.40365,4311040
18003,haugene,1,0.00002,3940449,91.40368,4311040
18004,hazelnutsgz,1,0.00002,3940450,91.40370,4311040
18005,hb404,1,0.00002,3940451,91.40372,4311040
18006,hb-chen,1,0.00002,3940452,91.40374,4311040
18007,hdost,1,0.00002,3940453,91.40377,4311040
18008,hect1995,1,0.00002,3940454,91.40379,4311040
18009,helgifeiti,1,0.00002,3940455,91.40381,4311040
18010,hemantaltair,1,0.00002,3940456,91.40384,4311040
18011,hemantwasthere,1,0.00002,3940457,91.40386,4311040
18012,henderiw,1,0.00002,3940458,91.40388,4311040
18013,henderjm,1,0.00002,3940459,91.40391,4311040
18014,hendrakwong,1,0.00002,3940460,91.40393,4311040
18015,henridf,1,0.00002,3940461,91.40395,4311040
18016,henryezeanya,1,0.00002,3940462,91.40398,4311040
18017,henrywangx,1,0.00002,3940463,91.40400,4311040
18018,heoelri,1,0.00002,3940464,91.40402,4311040
18019,heppu,1,0.00002,3940465,91.40405,4311040
18020,herbguo,1,0.00002,3940466,91.40407,4311040
18021,Hermsi1337,1,0.00002,3940467,91.40409,4311040
18022,hernanpl,1,0.00002,3940468,91.40412,4311040
18023,herzcthu,1,0.00002,3940469,91.40414,4311040
18024,HeyAdityaPatidar,1,0.00002,3940470,91.40416,4311040
18025,heyjared,1,0.00002,3940471,91.40419,4311040
18026,heymingwei,1,0.00002,3940472,91.40421,4311040
18027,hfuss,1,0.00002,3940473,91.40423,4311040
18028,hfutcbl,1,0.00002,3940474,91.40426,4311040
18029,hhuchzh,1,0.00002,3940475,91.40428,4311040
18030,hickersonj,1,0.00002,3940476,91.40430,4311040
18031,Hinsteny,1,0.00002,3940477,91.40432,4311040
18032,hkailantzis,1,0.00002,3940478,91.40435,4311040
18033,hkiang01,1,0.00002,3940479,91.40437,4311040
18034,hollinwilkins,1,0.00002,3940480,91.40439,4311040
18035,hone,1,0.00002,3940481,91.40442,4311040
18036,hongymagic,1,0.00002,3940482,91.40444,4311040
18037,honza801,1,0.00002,3940483,91.40446,4311040
18038,hooten,1,0.00002,3940484,91.40449,4311040
18039,hotpxl,1,0.00002,3940485,91.40451,4311040
18040,houshengbo,1,0.00002,3940486,91.40453,4311040
18041,howardlau1999,1,0.00002,3940487,91.40456,4311040
18042,hpcsc,1,0.00002,3940488,91.40458,4311040
18043,hrkumaran,1,0.00002,3940489,91.40460,4311040
18044,huan555,1,0.00002,3940490,91.40463,4311040
18045,hughobrien,1,0.00002,3940491,91.40465,4311040
18046,hughsaunders,1,0.00002,3940492,91.40467,4311040
18047,hugobarona,1,0.00002,3940493,91.40470,4311040
18048,huija,1,0.00002,3940494,91.40472,4311040
18049,humbledude,1,0.00002,3940495,91.40474,4311040
18050,hunter,1,0.00002,3940496,91.40477,4311040
18051,huone1,1,0.00002,3940497,91.40479,4311040
18052,HusterWan,1,0.00002,3940498,91.40481,4311040
18053,huynhj93,1,0.00002,3940499,91.40484,4311040
18054,huysamen,1,0.00002,3940500,91.40486,4311040
18055,hwyan,1,0.00002,3940501,91.40488,4311040
18056,hypery2k,1,0.00002,3940502,91.40490,4311040
18057,iakisme,1,0.00002,3940503,91.40493,4311040
18058,iammuho,1,0.00002,3940504,91.40495,4311040
18059,ianburrell,1,0.00002,3940505,91.40497,4311040
18060,ian-fox,1,0.00002,3940506,91.40500,4311040
18061,ianmaddox,1,0.00002,3940507,91.40502,4311040
18062,ianunruh,1,0.00002,3940508,91.40504,4311040
18063,ianw,1,0.00002,3940509,91.40507,4311040
18064,ib-steffen,1,0.00002,3940510,91.40509,4311040
18065,ichigism,1,0.00002,3940511,91.40511,4311040
18066,IdahoPL,1,0.00002,3940512,91.40514,4311040
18067,idcrosby,1,0.00002,3940513,91.40516,4311040
18068,ido-ran,1,0.00002,3940514,91.40518,4311040
18069,idoshamun,1,0.00002,3940515,91.40521,4311040
18070,iennae,1,0.00002,3940516,91.40523,4311040
18071,iguoyr,1,0.00002,3940517,91.40525,4311040
18072,iholder-redhat,1,0.00002,3940518,91.40528,4311040
18073,ihrwein,1,0.00002,3940519,91.40530,4311040
18074,ii-dev,1,0.00002,3940520,91.40532,4311040
18075,ijsong,1,0.00002,3940521,91.40535,4311040
18076,ikandars,1,0.00002,3940522,91.40537,4311040
18077,ikingye,1,0.00002,3940523,91.40539,4311040
18078,imacube,1,0.00002,3940524,91.40541,4311040
18079,imcom,1,0.00002,3940525,91.40544,4311040
18080,IMOKURI,1,0.00002,3940526,91.40546,4311040
18081,imranzunzani,1,0.00002,3940527,91.40548,4311040
18082,imWildCat,1,0.00002,3940528,91.40551,4311040
18083,indiejames,1,0.00002,3940529,91.40553,4311040
18084,inferno-chromium,1,0.00002,3940530,91.40555,4311040
18085,infinitecompute,1,0.00002,3940531,91.40558,4311040
18086,ingcsmoreno,1,0.00002,3940532,91.40560,4311040
18087,Inkdpixels,1,0.00002,3940533,91.40562,4311040
18088,innlouvate,1,0.00002,3940534,91.40565,4311040
18089,internaught,1,0.00002,3940535,91.40567,4311040
18090,internetionals,1,0.00002,3940536,91.40569,4311040
18091,InTheCloudDan,1,0.00002,3940537,91.40572,4311040
18092,inviscid,1,0.00002,3940538,91.40574,4311040
18093,iqoption-sandbox3,1,0.00002,3940539,91.40576,4311040
18094,irees,1,0.00002,3940540,91.40579,4311040
18095,iroller,1,0.00002,3940541,91.40581,4311040
18096,ironreality,1,0.00002,3940542,91.40583,4311040
18097,irosenzw,1,0.00002,3940543,91.40586,4311040
18098,Irving23,1,0.00002,3940544,91.40588,4311040
18099,isdal,1,0.00002,3940545,91.40590,4311040
18100,Issif,1,0.00002,3940546,91.40593,4311040
18101,isurulucky,1,0.00002,3940547,91.40595,4311040
18102,isutton,1,0.00002,3940548,91.40597,4311040
18103,itamarbareket,1,0.00002,3940549,91.40599,4311040
18104,itewk,1,0.00002,3940550,91.40602,4311040
18105,ithenov,1,0.00002,3940551,91.40604,4311040
18106,itsavvy-ankur,1,0.00002,3940552,91.40606,4311040
18107,IvanKuchin,1,0.00002,3940553,91.40609,4311040
18108,ivanovUA,1,0.00002,3940554,91.40611,4311040
18109,ivucica,1,0.00002,3940555,91.40613,4311040
18110,jackmahoney,1,0.00002,3940556,91.40616,4311040
18111,jackspirou,1,0.00002,3940557,91.40618,4311040
18112,jacktuck,1,0.00002,3940558,91.40620,4311040
18113,jacobsmith928,1,0.00002,3940559,91.40623,4311040
18114,jaitaiwan,1,0.00002,3940560,91.40625,4311040
18115,jakedt,1,0.00002,3940561,91.40627,4311040
18116,jakefhyde,1,0.00002,3940562,91.40630,4311040
18117,jakubigla,1,0.00002,3940563,91.40632,4311040
18118,jalseth,1,0.00002,3940564,91.40634,4311040
18119,jambajaar,1,0.00002,3940565,91.40637,4311040
18120,jamesddube,1,0.00002,3940566,91.40639,4311040
18121,jamesfalkner,1,0.00002,3940567,91.40641,4311040
18122,jameskellynet,1,0.00002,3940568,91.40644,4311040
18123,JamesPeiris,1,0.00002,3940569,91.40646,4311040
18124,james-pollard-leapyear,1,0.00002,3940570,91.40648,4311040
18125,jamessewell,1,0.00002,3940571,91.40651,4311040
18126,jamestalton,1,0.00002,3940572,91.40653,4311040
18127,jamiesmith,1,0.00002,3940573,91.40655,4311040
18128,jan-g,1,0.00002,3940574,91.40657,4311040
18129,janludvikd3,1,0.00002,3940575,91.40660,4311040
18130,janpieper,1,0.00002,3940576,91.40662,4311040
18131,jan-sykora,1,0.00002,3940577,91.40664,4311040
18132,jaronoff97,1,0.00002,3940578,91.40667,4311040
18133,jasonaliyetti,1,0.00002,3940579,91.40669,4311040
18134,jasonk000,1,0.00002,3940580,91.40671,4311040
18135,JasonSwindle,1,0.00002,3940581,91.40674,4311040
18136,jasonumiker,1,0.00002,3940582,91.40676,4311040
18137,jasperkuperus,1,0.00002,3940583,91.40678,4311040
18138,javabrett,1,0.00002,3940584,91.40681,4311040
18139,javad-hajiani,1,0.00002,3940585,91.40683,4311040
18140,javamonkey79,1,0.00002,3940586,91.40685,4311040
18141,javierhonduco,1,0.00002,3940587,91.40688,4311040
18142,jaxi,1,0.00002,3940588,91.40690,4311040
18143,JayeshThamke,1,0.00002,3940589,91.40692,4311040
18144,JayThomason,1,0.00002,3940590,91.40695,4311040
18145,jbarreneche,1,0.00002,3940591,91.40697,4311040
18146,jbhannah,1,0.00002,3940592,91.40699,4311040
18147,jbussdieker,1,0.00002,3940593,91.40702,4311040
18148,jbyers19,1,0.00002,3940594,91.40704,4311040
18149,jcftang,1,0.00002,3940595,91.40706,4311040
18150,jckasper,1,0.00002,3940596,91.40709,4311040
18151,jcollie,1,0.00002,3940597,91.40711,4311040
18152,jcpowermac,1,0.00002,3940598,91.40713,4311040
18153,jdeprin,1,0.00002,3940599,91.40715,4311040
18154,jdoss,1,0.00002,3940600,91.40718,4311040
18155,jdu,1,0.00002,3940601,91.40720,4311040
18156,jeady,1,0.00002,3940602,91.40722,4311040
18157,jeanfrancoislarente,1,0.00002,3940603,91.40725,4311040
18158,jeckhart,1,0.00002,3940604,91.40727,4311040
18159,jef,1,0.00002,3940605,91.40729,4311040
18160,jeffersonbenson,1,0.00002,3940606,91.40732,4311040
18161,jeffhollan,1,0.00002,3940607,91.40734,4311040
18162,jenisov,1,0.00002,3940608,91.40736,4311040
18163,jenspinney,1,0.00002,3940609,91.40739,4311040
18164,JeremyAlosio,1,0.00002,3940610,91.40741,4311040
18165,jerguslejko,1,0.00002,3940611,91.40743,4311040
18166,jeromepin,1,0.00002,3940612,91.40746,4311040
18167,jerrytfleung,1,0.00002,3940613,91.40748,4311040
18168,jessechahal,1,0.00002,3940614,91.40750,4311040
18169,jesseendahl,1,0.00002,3940615,91.40753,4311040
18170,JessicaGreben,1,0.00002,3940616,91.40755,4311040
18171,jessicayuen,1,0.00002,3940617,91.40757,4311040
18172,jesusalvb,1,0.00002,3940618,91.40760,4311040
18173,jevonearth,1,0.00002,3940619,91.40762,4311040
18174,jfarrell,1,0.00002,3940620,91.40764,4311040
18175,jfcoz,1,0.00002,3940621,91.40766,4311040
18176,jfroment,1,0.00002,3940622,91.40769,4311040
18177,jgrexa,1,0.00002,3940623,91.40771,4311040
18178,jgrossmac,1,0.00002,3940624,91.40773,4311040
18179,jhcook,1,0.00002,3940625,91.40776,4311040
18180,jhmartin,1,0.00002,3940626,91.40778,4311040
18181,jhspaybar,1,0.00002,3940627,91.40780,4311040
18182,jianglai,1,0.00002,3940628,91.40783,4311040
18183,jiasr,1,0.00002,3940629,91.40785,4311040
18184,jiekun,1,0.00002,3940630,91.40787,4311040
18185,jiere,1,0.00002,3940631,91.40790,4311040
18186,jin,1,0.00002,3940632,91.40792,4311040
18187,jingxiaolu,1,0.00002,3940633,91.40794,4311040
18188,Jinkxed,1,0.00002,3940634,91.40797,4311040
18189,jinuxstyle,1,0.00002,3940635,91.40799,4311040
18190,jippeholwerda,1,0.00002,3940636,91.40801,4311040
18191,JJ11teen,1,0.00002,3940637,91.40804,4311040
18192,jjournet,1,0.00002,3940638,91.40806,4311040
18193,jkenefick,1,0.00002,3940639,91.40808,4311040
18194,jkevlin,1,0.00002,3940640,91.40811,4311040
18195,jkhelil,1,0.00002,3940641,91.40813,4311040
18196,Jkirsher,1,0.00002,3940642,91.40815,4311040
18197,jkohen,1,0.00002,3940643,91.40818,4311040
18198,jkraj,1,0.00002,3940644,91.40820,4311040
18199,jleandrocr,1,0.00002,3940645,91.40822,4311040
18200,jleni,1,0.00002,3940646,91.40824,4311040
18201,jmagnusson,1,0.00002,3940647,91.40827,4311040
18202,Jmainguy,1,0.00002,3940648,91.40829,4311040
18203,jMarkP,1,0.00002,3940649,91.40831,4311040
18204,jmesnil,1,0.00002,3940650,91.40834,4311040
18205,jmlogan,1,0.00002,3940651,91.40836,4311040
18206,jmolmo,1,0.00002,3940652,91.40838,4311040
18207,joeblubaugh,1,0.00002,3940653,91.40841,4311040
18208,joe-carpenter,1,0.00002,3940654,91.40843,4311040
18209,joefitzgerald,1,0.00002,3940655,91.40845,4311040
18210,joelrebel,1,0.00002,3940656,91.40848,4311040
18211,john-a-joyce,1,0.00002,3940657,91.40850,4311040
18212,johnjelinek,1,0.00002,3940658,91.40852,4311040
18213,johnniee,1,0.00002,3940659,91.40855,4311040
18214,JohnShahawy,1,0.00002,3940660,91.40857,4311040
18215,johnugeorge,1,0.00002,3940661,91.40859,4311040
18216,johnw188,1,0.00002,3940662,91.40862,4311040
18217,joncotton,1,0.00002,3940663,91.40864,4311040
18218,jondlm,1,0.00002,3940664,91.40866,4311040
18219,jonesbusy,1,0.00002,3940665,91.40869,4311040
18220,jonico,1,0.00002,3940666,91.40871,4311040
18221,jonmchu,1,0.00002,3940667,91.40873,4311040
18222,joodlehammond,1,0.00002,3940668,91.40876,4311040
18223,joosthof,1,0.00002,3940669,91.40878,4311040
18224,jordimassaguerpla,1,0.00002,3940670,91.40880,4311040
18225,jorgebirck,1,0.00002,3940671,91.40882,4311040
18226,jorneilander,1,0.00002,3940672,91.40885,4311040
18227,Jorricks,1,0.00002,3940673,91.40887,4311040
18228,JorritPosthuma,1,0.00002,3940674,91.40889,4311040
18229,josdirksen,1,0.00002,3940675,91.40892,4311040
18230,josecv,1,0.00002,3940676,91.40894,4311040
18231,josegonzalez,1,0.00002,3940677,91.40896,4311040
18232,josephschorr,1,0.00002,3940678,91.40899,4311040
18233,JoseThen,1,0.00002,3940679,91.40901,4311040
18234,josh-endries,1,0.00002,3940680,91.40903,4311040
18235,joshm91,1,0.00002,3940681,91.40906,4311040
18236,josh-tepper,1,0.00002,3940682,91.40908,4311040
18237,joshuawilson,1,0.00002,3940683,91.40910,4311040
18238,joyliu-q,1,0.00002,3940684,91.40913,4311040
18239,jozenstar,1,0.00002,3940685,91.40915,4311040
18240,JPFrancoia,1,0.00002,3940686,91.40917,4311040
18241,jprecuch,1,0.00002,3940687,91.40920,4311040
18242,jqueguiner,1,0.00002,3940688,91.40922,4311040
18243,jracollins,1,0.00002,3940689,91.40924,4311040
18244,jrbeilke,1,0.00002,3940690,91.40927,4311040
18245,jrcamp,1,0.00002,3940691,91.40929,4311040
18246,jshrack-ssi,1,0.00002,3940692,91.40931,4311040
18247,jspaleta,1,0.00002,3940693,91.40934,4311040
18248,jstol,1,0.00002,3940694,91.40936,4311040
18249,J-Swift,1,0.00002,3940695,91.40938,4311040
18250,jtaleric,1,0.00002,3940696,91.40940,4311040
18251,jtattermusch,1,0.00002,3940697,91.40943,4311040
18252,jthin,1,0.00002,3940698,91.40945,4311040
18253,jthomas,1,0.00002,3940699,91.40947,4311040
18254,jtlisi,1,0.00002,3940700,91.40950,4311040
18255,jtudelag,1,0.00002,3940701,91.40952,4311040
18256,jubel-han,1,0.00002,3940702,91.40954,4311040
18257,juguerre,1,0.00002,3940703,91.40957,4311040
18258,julioo,1,0.00002,3940704,91.40959,4311040
18259,juliusl,1,0.00002,3940705,91.40961,4311040
18260,jullianoacqio,1,0.00002,3940706,91.40964,4311040
18261,junaidali,1,0.00002,3940707,91.40966,4311040
18262,junawaneshivani,1,0.00002,3940708,91.40968,4311040
18263,JunJayWang,1,0.00002,3940709,91.40971,4311040
18264,jurca,1,0.00002,3940710,91.40973,4311040
18265,justinlindh-wf,1,0.00002,3940711,91.40975,4311040
18266,justinrlee,1,0.00002,3940712,91.40978,4311040
18267,jValdron,1,0.00002,3940713,91.40980,4311040
18268,jvdgeest,1,0.00002,3940714,91.40982,4311040
18269,jvmirdel,1,0.00002,3940715,91.40985,4311040
18270,jvrplmlmn,1,0.00002,3940716,91.40987,4311040
18271,jwang11,1,0.00002,3940717,91.40989,4311040
18272,JWDobken,1,0.00002,3940718,91.40992,4311040
18273,jwilander,1,0.00002,3940719,91.40994,4311040
18274,jyepesr1,1,0.00002,3940720,91.40996,4311040
18275,k0t3n,1,0.00002,3940721,91.40998,4311040
18276,k3ypad,1,0.00002,3940722,91.41001,4311040
18277,k4kratik,1,0.00002,3940723,91.41003,4311040
18278,k82ma,1,0.00002,3940724,91.41005,4311040
18279,kabooboo,1,0.00002,3940725,91.41008,4311040
18280,kadenlnelson,1,0.00002,3940726,91.41010,4311040
18281,kadursandy,1,0.00002,3940727,91.41012,4311040
18282,KaelBaldwin,1,0.00002,3940728,91.41015,4311040
18283,kaidotdev,1,0.00002,3940729,91.41017,4311040
18284,kaihendry,1,0.00002,3940730,91.41019,4311040
18285,kailun-qin,1,0.00002,3940731,91.41022,4311040
18286,kakascx,1,0.00002,3940732,91.41024,4311040
18287,KaleoCheng,1,0.00002,3940733,91.41026,4311040
18288,kalgecin,1,0.00002,3940734,91.41029,4311040
18289,kamaln7,1,0.00002,3940735,91.41031,4311040
18290,kamatama41,1,0.00002,3940736,91.41033,4311040
18291,kamialie,1,0.00002,3940737,91.41036,4311040
18292,Kangmo,1,0.00002,3940738,91.41038,4311040
18293,kangsheng89,1,0.00002,3940739,91.41040,4311040
18294,kans,1,0.00002,3940740,91.41043,4311040
18295,karajas,1,0.00002,3940741,91.41045,4311040
18296,kareem-elsayed,1,0.00002,3940742,91.41047,4311040
18297,KarsonAlford,1,0.00002,3940743,91.41049,4311040
18298,Karthik-13,1,0.00002,3940744,91.41052,4311040
18299,karthikvadla,1,0.00002,3940745,91.41054,4311040
18300,katcipis,1,0.00002,3940746,91.41056,4311040
18301,katherinealbany,1,0.00002,3940747,91.41059,4311040
18302,kav,1,0.00002,3940748,91.41061,4311040
18303,kaworu,1,0.00002,3940749,91.41063,4311040
18304,kaxil,1,0.00002,3940750,91.41066,4311040
18305,kayano,1,0.00002,3940751,91.41068,4311040
18306,kaypeter87,1,0.00002,3940752,91.41070,4311040
18307,kblin,1,0.00002,3940753,91.41073,4311040
18308,kbrwn,1,0.00002,3940754,91.41075,4311040
18309,kbudde,1,0.00002,3940755,91.41077,4311040
18310,kcq,1,0.00002,3940756,91.41080,4311040
18311,kdubb,1,0.00002,3940757,91.41082,4311040
18312,keir86,1,0.00002,3940758,91.41084,4311040
18313,kekoav,1,0.00002,3940759,91.41087,4311040
18314,kelveden,1,0.00002,3940760,91.41089,4311040
18315,kencieszykowski,1,0.00002,3940761,91.41091,4311040
18316,kendru,1,0.00002,3940762,91.41094,4311040
18317,kennethtxytqw,1,0.00002,3940763,91.41096,4311040
18318,Keralin,1,0.00002,3940764,91.41098,4311040
18319,keskad,1,0.00002,3940765,91.41101,4311040
18320,kevinmdavis,1,0.00002,3940766,91.41103,4311040
18321,kevinschumacher,1,0.00002,3940767,91.41105,4311040
18322,kevin-shelaga,1,0.00002,3940768,91.41107,4311040
18323,kg6zgj,1,0.00002,3940769,91.41110,4311040
18324,kghost,1,0.00002,3940770,91.41112,4311040
18325,khaines,1,0.00002,3940771,91.41114,4311040
18326,kheraud,1,0.00002,3940772,91.41117,4311040
18327,khipkin,1,0.00002,3940773,91.41119,4311040
18328,khuedoan,1,0.00002,3940774,91.41121,4311040
18329,Kiddinglife,1,0.00002,3940775,91.41124,4311040
18330,killcity,1,0.00002,3940776,91.41126,4311040
18331,kimwnasptd,1,0.00002,3940777,91.41128,4311040
18332,kindermoumoute,1,0.00002,3940778,91.41131,4311040
18333,King-Julien,1,0.00002,3940779,91.41133,4311040
18334,kinsolee,1,0.00002,3940780,91.41135,4311040
18335,kipit,1,0.00002,3940781,91.41138,4311040
18336,kitsutliff,1,0.00002,3940782,91.41140,4311040
18337,KitSutliff,1,0.00002,3940783,91.41142,4311040
18338,kj187,1,0.00002,3940784,91.41145,4311040
18339,kjackson87,1,0.00002,3940785,91.41147,4311040
18340,kklimonda,1,0.00002,3940786,91.41149,4311040
18341,kkroening,1,0.00002,3940787,91.41152,4311040
18342,KlausVii,1,0.00002,3940788,91.41154,4311040
18343,klud1,1,0.00002,3940789,91.41156,4311040
18344,kmadel,1,0.00002,3940790,91.41159,4311040
18345,kmjayadeep,1,0.00002,3940791,91.41161,4311040
18346,kmkramer,1,0.00002,3940792,91.41163,4311040
18347,knguyen0125,1,0.00002,3940793,91.41165,4311040
18348,knuto,1,0.00002,3940794,91.41168,4311040
18349,kobeHub,1,0.00002,3940795,91.41170,4311040
18350,kobiecrowder,1,0.00002,3940796,91.41172,4311040
18351,koder-ua,1,0.00002,3940797,91.41175,4311040
18352,kofj,1,0.00002,3940798,91.41177,4311040
18353,komal-SkyNET,1,0.00002,3940799,91.41179,4311040
18354,kongyi-ibm,1,0.00002,3940800,91.41182,4311040
18355,konvergence,1,0.00002,3940801,91.41184,4311040
18356,kopaygorodsky,1,0.00002,3940802,91.41186,4311040
18357,kornesh,1,0.00002,3940803,91.41189,4311040
18358,kostis-codefresh,1,0.00002,3940804,91.41191,4311040
18359,kpersohn,1,0.00002,3940805,91.41193,4311040
18360,kradalby,1,0.00002,3940806,91.41196,4311040
18361,krisdevopsbot,1,0.00002,3940807,91.41198,4311040
18362,krishnaduttPanchagnula,1,0.00002,3940808,91.41200,4311040
18363,krisnova,1,0.00002,3940809,91.41203,4311040
18364,krotscheck,1,0.00002,3940810,91.41205,4311040
18365,krsacme,1,0.00002,3940811,91.41207,4311040
18366,KrustyHack,1,0.00002,3940812,91.41210,4311040
18367,KrzysztofKowalczyk,1,0.00002,3940813,91.41212,4311040
18368,ksatchit,1,0.00002,3940814,91.41214,4311040
18369,kshlm,1,0.00002,3940815,91.41217,4311040
18370,kstreee-furiosa,1,0.00002,3940816,91.41219,4311040
18371,ktravis,1,0.00002,3940817,91.41221,4311040
18372,kuberkaul,1,0.00002,3940818,91.41223,4311040
18373,KubeStacker,1,0.00002,3940819,91.41226,4311040
18374,kubicgruenfeld,1,0.00002,3940820,91.41228,4311040
18375,kuboid,1,0.00002,3940821,91.41230,4311040
18376,kun-hackle,1,0.00002,3940822,91.41233,4311040
18377,kYann,1,0.00002,3940823,91.41235,4311040
18378,kyleterry,1,0.00002,3940824,91.41237,4311040
18379,kyschouv,1,0.00002,3940825,91.41240,4311040
18380,kyzh,1,0.00002,3940826,91.41242,4311040
18381,kzk,1,0.00002,3940827,91.41244,4311040
18382,kzys,1,0.00002,3940828,91.41247,4311040
18383,l1x,1,0.00002,3940829,91.41249,4311040
18384,laf0rge,1,0.00002,3940830,91.41251,4311040
18385,lalitb,1,0.00002,3940831,91.41254,4311040
18386,laloyalo,1,0.00002,3940832,91.41256,4311040
18387,lancehudson,1,0.00002,3940833,91.41258,4311040
18388,lanxenet,1,0.00002,3940834,91.41261,4311040
18389,larham,1,0.00002,3940835,91.41263,4311040
18390,larryrensing,1,0.00002,3940836,91.41265,4311040
18391,LarsOL,1,0.00002,3940837,91.41268,4311040
18392,larte,1,0.00002,3940838,91.41270,4311040
18393,LaurentLesle,1,0.00002,3940839,91.41272,4311040
18394,lavacat,1,0.00002,3940840,91.41274,4311040
18395,lavrxxx,1,0.00002,3940841,91.41277,4311040
18396,lbpage,1,0.00002,3940842,91.41279,4311040
18397,lbpdt,1,0.00002,3940843,91.41281,4311040
18398,lbscorpio,1,0.00002,3940844,91.41284,4311040
18399,lcavajani,1,0.00002,3940845,91.41286,4311040
18400,ldcastell,1,0.00002,3940846,91.41288,4311040
18401,ldd91,1,0.00002,3940847,91.41291,4311040
18402,ldelossa,1,0.00002,3940848,91.41293,4311040
18403,ldez,1,0.00002,3940849,91.41295,4311040
18404,lecgts,1,0.00002,3940850,91.41298,4311040
18405,lechuk47,1,0.00002,3940851,91.41300,4311040
18406,LEDfan,1,0.00002,3940852,91.41302,4311040
18407,LeendersR,1,0.00002,3940853,91.41305,4311040
18408,leeweir,1,0.00002,3940854,91.41307,4311040
18409,lee-zhg,1,0.00002,3940855,91.41309,4311040
18410,LelandSindt,1,0.00002,3940856,91.41312,4311040
18411,lemeurherve,1,0.00002,3940857,91.41314,4311040
18412,lenisha,1,0.00002,3940858,91.41316,4311040
18413,LenutaToderean,1,0.00002,3940859,91.41319,4311040
18414,leo1971,1,0.00002,3940860,91.41321,4311040
18415,LeonardAukea,1,0.00002,3940861,91.41323,4311040
18416,leonsp-ai,1,0.00002,3940862,91.41326,4311040
18417,leonstack,1,0.00002,3940863,91.41328,4311040
18418,Leovilhena,1,0.00002,3940864,91.41330,4311040
18419,leoxlin,1,0.00002,3940865,91.41332,4311040
18420,lestrrat,1,0.00002,3940866,91.41335,4311040
18421,lewisdiamond,1,0.00002,3940867,91.41337,4311040
18422,lexuszhi1990,1,0.00002,3940868,91.41339,4311040
18423,lgalfaso,1,0.00002,3940869,91.41342,4311040
18424,lheinlen,1,0.00002,3940870,91.41344,4311040
18425,liamchzh,1,0.00002,3940871,91.41346,4311040
18426,Librazy,1,0.00002,3940872,91.41349,4311040
18427,lichaojacobs,1,0.00002,3940873,91.41351,4311040
18428,lidongze0629,1,0.00002,3940874,91.41353,4311040
18429,lime008,1,0.00002,3940875,91.41356,4311040
18430,limoges,1,0.00002,3940876,91.41358,4311040
18431,LimpingNinja,1,0.00002,3940877,91.41360,4311040
18432,linde,1,0.00002,3940878,91.41363,4311040
18433,lingwooc,1,0.00002,3940879,91.41365,4311040
18434,liron-l,1,0.00002,3940880,91.41367,4311040
18435,liudongbo123,1,0.00002,3940881,91.41370,4311040
18436,liufuyang,1,0.00002,3940882,91.41372,4311040
18437,liwei,1,0.00002,3940883,91.41374,4311040
18438,lixuna,1,0.00002,3940884,91.41377,4311040
18439,liyihuang,1,0.00002,3940885,91.41379,4311040
18440,l-korbes,1,0.00002,3940886,91.41381,4311040
18441,LLParse,1,0.00002,3940887,91.41384,4311040
18442,LockedThread,1,0.00002,3940888,91.41386,4311040
18443,loganaden,1,0.00002,3940889,91.41388,4311040
18444,loic-sharma,1,0.00002,3940890,91.41390,4311040
18445,lokiwins,1,0.00002,3940891,91.41393,4311040
18446,LoLei,1,0.00002,3940892,91.41395,4311040
18447,lolimjake,1,0.00002,3940893,91.41397,4311040
18448,longdeqidao,1,0.00002,3940894,91.41400,4311040
18449,LongTu,1,0.00002,3940895,91.41402,4311040
18450,lookis,1,0.00002,3940896,91.41404,4311040
18451,loosebazooka,1,0.00002,3940897,91.41407,4311040
18452,LordGoodman,1,0.00002,3940898,91.41409,4311040
18453,loxley,1,0.00002,3940899,91.41411,4311040
18454,lpil,1,0.00002,3940900,91.41414,4311040
18455,lrepolho,1,0.00002,3940901,91.41416,4311040
18456,lsamayoa,1,0.00002,3940902,91.41418,4311040
18457,lszymik,1,0.00002,3940903,91.41421,4311040
18458,ltartarini,1,0.00002,3940904,91.41423,4311040
18459,ltatakis-vocovo,1,0.00002,3940905,91.41425,4311040
18460,luandrea,1,0.00002,3940906,91.41428,4311040
18461,Lucaarioo,1,0.00002,3940907,91.41430,4311040
18462,lucasarrudatrustly,1,0.00002,3940908,91.41432,4311040
18463,lucasff,1,0.00002,3940909,91.41435,4311040
18464,LucasRouckhout,1,0.00002,3940910,91.41437,4311040
18465,LucasVanHaaren,1,0.00002,3940911,91.41439,4311040
18466,LuckyDogg,1,0.00002,3940912,91.41442,4311040
18467,lucwillems,1,0.00002,3940913,91.41444,4311040
18468,ludovicbonivert,1,0.00002,3940914,91.41446,4311040
18469,luislhl,1,0.00002,3940915,91.41448,4311040
18470,luizm,1,0.00002,3940916,91.41451,4311040
18471,luizsfer,1,0.00002,3940917,91.41453,4311040
18472,Lukasa,1,0.00002,3940918,91.41455,4311040
18473,lukebond,1,0.00002,3940919,91.41458,4311040
18474,lukjaw,1,0.00002,3940920,91.41460,4311040
18475,lumi017,1,0.00002,3940921,91.41462,4311040
18476,lut777,1,0.00002,3940922,91.41465,4311040
18477,lxfontes,1,0.00002,3940923,91.41467,4311040
18478,lyptt,1,0.00002,3940924,91.41469,4311040
18479,m0ppers,1,0.00002,3940925,91.41472,4311040
18480,m0un10,1,0.00002,3940926,91.41474,4311040
18481,mabusaa,1,0.00002,3940927,91.41476,4311040
18482,macalinao,1,0.00002,3940928,91.41479,4311040
18483,mackeyja92,1,0.00002,3940929,91.41481,4311040
18484,macon,1,0.00002,3940930,91.41483,4311040
18485,mad0house,1,0.00002,3940931,91.41486,4311040
18486,maddy020,1,0.00002,3940932,91.41488,4311040
18487,madeddie,1,0.00002,3940933,91.41490,4311040
18488,mad-it,1,0.00002,3940934,91.41493,4311040
18489,madmod,1,0.00002,3940935,91.41495,4311040
18490,maeri,1,0.00002,3940936,91.41497,4311040
18491,maganaluis,1,0.00002,3940937,91.41499,4311040
18492,magikid,1,0.00002,3940938,91.41502,4311040
18493,Mahagon,1,0.00002,3940939,91.41504,4311040
18494,maheshvra,1,0.00002,3940940,91.41506,4311040
18495,maiconbaum,1,0.00002,3940941,91.41509,4311040
18496,makandre,1,0.00002,3940942,91.41511,4311040
18497,maltejk,1,0.00002,3940943,91.41513,4311040
18498,maminio,1,0.00002,3940944,91.41516,4311040
18499,manoharbrm,1,0.00002,3940945,91.41518,4311040
18500,manolama,1,0.00002,3940946,91.41520,4311040
18501,manuvaldi,1,0.00002,3940947,91.41523,4311040
18502,manvindar,1,0.00002,3940948,91.41525,4311040
18503,MarcDufresne,1,0.00002,3940949,91.41527,4311040
18504,marcellanz,1,0.00002,3940950,91.41530,4311040
18505,marcgascon,1,0.00002,3940951,91.41532,4311040
18506,marcinjahn,1,0.00002,3940952,91.41534,4311040
18507,marciopribeiro87,1,0.00002,3940953,91.41537,4311040
18508,marckamerbeek,1,0.00002,3940954,91.41539,4311040
18509,marcoamorales,1,0.00002,3940955,91.41541,4311040
18510,marc-obrien,1,0.00002,3940956,91.41544,4311040
18511,marcomancuso,1,0.00002,3940957,91.41546,4311040
18512,marcoskichel,1,0.00002,3940958,91.41548,4311040
18513,marcosrmendezthd,1,0.00002,3940959,91.41551,4311040
18514,Marcussafar,1,0.00002,3940960,91.41553,4311040
18515,marcvelasco,1,0.00002,3940961,91.41555,4311040
18516,MariamFahmy98,1,0.00002,3940962,91.41557,4311040
18517,mark-adams,1,0.00002,3940963,91.41560,4311040
18518,markdroth,1,0.00002,3940964,91.41562,4311040
18519,markito,1,0.00002,3940965,91.41564,4311040
18520,markmaas,1,0.00002,3940966,91.41567,4311040
18521,markrj,1,0.00002,3940967,91.41569,4311040
18522,markthebault,1,0.00002,3940968,91.41571,4311040
18523,marktheunissen,1,0.00002,3940969,91.41574,4311040
18524,marrobi,1,0.00002,3940970,91.41576,4311040
18525,Martande8055,1,0.00002,3940971,91.41578,4311040
18526,Mart-Bogdan,1,0.00002,3940972,91.41581,4311040
18527,Martially,1,0.00002,3940973,91.41583,4311040
18528,Martindlut,1,0.00002,3940974,91.41585,4311040
18529,martinezleoml,1,0.00002,3940975,91.41588,4311040
18530,MartinodF,1,0.00002,3940976,91.41590,4311040
18531,MartinPham,1,0.00002,3940977,91.41592,4311040
18532,martomor,1,0.00002,3940978,91.41595,4311040
18533,marwan-at-work,1,0.00002,3940979,91.41597,4311040
18534,Marza,1,0.00002,3940980,91.41599,4311040
18535,masayag,1,0.00002,3940981,91.41602,4311040
18536,mashrin,1,0.00002,3940982,91.41604,4311040
18537,masondaven,1,0.00002,3940983,91.41606,4311040
18538,masoudbahar,1,0.00002,3940984,91.41609,4311040
18539,masteinhauser,1,0.00002,3940985,91.41611,4311040
18540,mateustanaka,1,0.00002,3940986,91.41613,4311040
18541,matkosoric,1,0.00002,3940987,91.41615,4311040
18542,mattbator,1,0.00002,3940988,91.41618,4311040
18543,mattdelco,1,0.00002,3940989,91.41620,4311040
18544,MatteoJoliveau,1,0.00002,3940990,91.41622,4311040
18545,matthewberkland,1,0.00002,3940991,91.41625,4311040
18546,matthiasak,1,0.00002,3940992,91.41627,4311040
18547,mattiaforc,1,0.00002,3940993,91.41629,4311040
18548,mattjwarren,1,0.00002,3940994,91.41632,4311040
18549,mattrco,1,0.00002,3940995,91.41634,4311040
18550,matty-rose,1,0.00002,3940996,91.41636,4311040
18551,mauri,1,0.00002,3940997,91.41639,4311040
18552,MauRiEEZZZ,1,0.00002,3940998,91.41641,4311040
18553,maurodelazeri,1,0.00002,3940999,91.41643,4311040
18554,maxdebayser,1,0.00002,3941000,91.41646,4311040
18555,maximmi,1,0.00002,3941001,91.41648,4311040
18556,maxkochubey,1,0.00002,3941002,91.41650,4311040
18557,maxstreese,1,0.00002,3941003,91.41653,4311040
18558,maxx-bachurin,1,0.00002,3941004,91.41655,4311040
18559,mbahiense,1,0.00002,3941005,91.41657,4311040
18560,mbenson,1,0.00002,3941006,91.41660,4311040
18561,mbinette,1,0.00002,3941007,91.41662,4311040
18562,mblair,1,0.00002,3941008,91.41664,4311040
18563,mboldt,1,0.00002,3941009,91.41667,4311040
18564,mbrevoort,1,0.00002,3941010,91.41669,4311040
18565,McCodeman,1,0.00002,3941011,91.41671,4311040
18566,mchalla,1,0.00002,3941012,91.41673,4311040
18567,mcouthon,1,0.00002,3941013,91.41676,4311040
18568,McShauno,1,0.00002,3941014,91.41678,4311040
18569,mda590,1,0.00002,3941015,91.41680,4311040
18570,mdelder,1,0.00002,3941016,91.41683,4311040
18571,mdeuser,1,0.00002,3941017,91.41685,4311040
18572,mdirkse,1,0.00002,3941018,91.41687,4311040
18573,mdkess,1,0.00002,3941019,91.41690,4311040
18574,meganokeefe,1,0.00002,3941020,91.41692,4311040
18575,mehdihadeli,1,0.00002,3941021,91.41694,4311040
18576,mehemken,1,0.00002,3941022,91.41697,4311040
18577,menardorama,1,0.00002,3941023,91.41699,4311040
18578,mente,1,0.00002,3941024,91.41701,4311040
18579,merlante,1,0.00002,3941025,91.41704,4311040
18580,Merteg,1,0.00002,3941026,91.41706,4311040
18581,mervinkid,1,0.00002,3941027,91.41708,4311040
18582,metacosm,1,0.00002,3941028,91.41711,4311040
18583,metahertz,1,0.00002,3941029,91.41713,4311040
18584,meua,1,0.00002,3941030,91.41715,4311040
18585,meurig,1,0.00002,3941031,91.41718,4311040
18586,mfoliveira,1,0.00002,3941032,91.41720,4311040
18587,mfouilleul,1,0.00002,3941033,91.41722,4311040
18588,mfriedenhagen,1,0.00002,3941034,91.41725,4311040
18589,mfruhner,1,0.00002,3941035,91.41727,4311040
18590,mgyong,1,0.00002,3941036,91.41729,4311040
18591,mhalano,1,0.00002,3941037,91.41731,4311040
18592,mhamann,1,0.00002,3941038,91.41734,4311040
18593,MichaelOrtho,1,0.00002,3941039,91.41736,4311040
18594,michael-robbins,1,0.00002,3941040,91.41738,4311040
18595,MichelDiz,1,0.00002,3941041,91.41741,4311040
18596,micheljung,1,0.00002,3941042,91.41743,4311040
18597,mickdelaney,1,0.00002,3941043,91.41745,4311040
18598,microwavables,1,0.00002,3941044,91.41748,4311040
18599,Mierdin,1,0.00002,3941045,91.41750,4311040
18600,mihai1voicescu,1,0.00002,3941046,91.41752,4311040
18601,mihau,1,0.00002,3941047,91.41755,4311040
18602,mikberg,1,0.00002,3941048,91.41757,4311040
18603,mikeal,1,0.00002,3941049,91.41759,4311040
18604,mikebridge,1,0.00002,3941050,91.41762,4311040
18605,mikecali,1,0.00002,3941051,91.41764,4311040
18606,mikechristie,1,0.00002,3941052,91.41766,4311040
18607,MikeCongdon1,1,0.00002,3941053,91.41769,4311040
18608,mikemowgli,1,0.00002,3941054,91.41771,4311040
18609,mikepc,1,0.00002,3941055,91.41773,4311040
18610,MikeSchlosser16,1,0.00002,3941056,91.41776,4311040
18611,miketonks-form3,1,0.00002,3941057,91.41778,4311040
18612,mikluko,1,0.00002,3941058,91.41780,4311040
18613,milanhradil1-tomtom,1,0.00002,3941059,91.41782,4311040
18614,milescrabill,1,0.00002,3941060,91.41785,4311040
18615,milosonator,1,0.00002,3941061,91.41787,4311040
18616,mindjiver,1,0.00002,3941062,91.41789,4311040
18617,Mionsz,1,0.00002,3941063,91.41792,4311040
18618,mirogta,1,0.00002,3941064,91.41794,4311040
18619,mitchellh,1,0.00002,3941065,91.41796,4311040
18620,mjasion,1,0.00002,3941066,91.41799,4311040
18621,mjbrender,1,0.00002,3941067,91.41801,4311040
18622,mjeco,1,0.00002,3941068,91.41803,4311040
18623,mjlodge,1,0.00002,3941069,91.41806,4311040
18624,mkatychev,1,0.00002,3941070,91.41808,4311040
18625,mKeRix,1,0.00002,3941071,91.41810,4311040
18626,mkoertgen,1,0.00002,3941072,91.41813,4311040
18627,mlabouardy,1,0.00002,3941073,91.41815,4311040
18628,mlichvar,1,0.00002,3941074,91.41817,4311040
18629,mlococo,1,0.00002,3941075,91.41820,4311040
18630,mluedke,1,0.00002,3941076,91.41822,4311040
18631,mmalone,1,0.00002,3941077,91.41824,4311040
18632,mmanciop,1,0.00002,3941078,91.41827,4311040
18633,mmariani,1,0.00002,3941079,91.41829,4311040
18634,mmayernick,1,0.00002,3941080,91.41831,4311040
18635,mmckane,1,0.00002,3941081,91.41834,4311040
18636,MMerzinger,1,0.00002,3941082,91.41836,4311040
18637,mmgaggle,1,0.00002,3941083,91.41838,4311040
18638,mmontalvo,1,0.00002,3941084,91.41840,4311040
18639,mmrath,1,0.00002,3941085,91.41843,4311040
18640,mnoumanshahzad,1,0.00002,3941086,91.41845,4311040
18641,mnowaksuse,1,0.00002,3941087,91.41847,4311040
18642,moatorres,1,0.00002,3941088,91.41850,4311040
18643,moepot,1,0.00002,3941089,91.41852,4311040
18644,mogindi,1,0.00002,3941090,91.41854,4311040
18645,MohamedBenighil,1,0.00002,3941091,91.41857,4311040
18646,mohamed-eldafrawi,1,0.00002,3941092,91.41859,4311040
18647,mohclips,1,0.00002,3941093,91.41861,4311040
18648,m-okeefe,1,0.00002,3941094,91.41864,4311040
18649,Mokto,1,0.00002,3941095,91.41866,4311040
18650,monkeymon,1,0.00002,3941096,91.41868,4311040
18651,monomosc,1,0.00002,3941097,91.41871,4311040
18652,montenegrodr,1,0.00002,3941098,91.41873,4311040
18653,mool,1,0.00002,3941099,91.41875,4311040
18654,morgwai,1,0.00002,3941100,91.41878,4311040
18655,morigs,1,0.00002,3941101,91.41880,4311040
18656,Morl99,1,0.00002,3941102,91.41882,4311040
18657,morozov,1,0.00002,3941103,91.41885,4311040
18658,morsok,1,0.00002,3941104,91.41887,4311040
18659,MoserMichael,1,0.00002,3941105,91.41889,4311040
18660,mosfet1kg,1,0.00002,3941106,91.41892,4311040
18661,moshebe,1,0.00002,3941107,91.41894,4311040
18662,MostafaGazar,1,0.00002,3941108,91.41896,4311040
18663,mouhsen-ibrahim,1,0.00002,3941109,91.41898,4311040
18664,mowies,1,0.00002,3941110,91.41901,4311040
18665,mpepping,1,0.00002,3941111,91.41903,4311040
18666,mprigge,1,0.00002,3941112,91.41905,4311040
18667,mpseidel,1,0.00002,3941113,91.41908,4311040
18668,mrbobfrog,1,0.00002,3941114,91.41910,4311040
18669,MrChaos1993,1,0.00002,3941115,91.41912,4311040
18670,MrCroxx,1,0.00002,3941116,91.41915,4311040
18671,mreider,1,0.00002,3941117,91.41917,4311040
18672,mrhockeymonkey,1,0.00002,3941118,91.41919,4311040
18673,MrMMorris,1,0.00002,3941119,91.41922,4311040
18674,mroach,1,0.00002,3941120,91.41924,4311040
18675,mrunge,1,0.00002,3941121,91.41926,4311040
18676,mruoss,1,0.00002,3941122,91.41929,4311040
18677,msabramo,1,0.00002,3941123,91.41931,4311040
18678,mshkrebtan,1,0.00002,3941124,91.41933,4311040
18679,msolimans,1,0.00002,3941125,91.41936,4311040
18680,msperl,1,0.00002,3941126,91.41938,4311040
18681,mssola,1,0.00002,3941127,91.41940,4311040
18682,mstemm,1,0.00002,3941128,91.41943,4311040
18683,mswilson,1,0.00002,3941129,91.41945,4311040
18684,mtenrero,1,0.00002,3941130,91.41947,4311040
18685,mterhar,1,0.00002,3941131,91.41950,4311040
18686,mtk3d,1,0.00002,3941132,91.41952,4311040
18687,mugdhaadhav,1,0.00002,3941133,91.41954,4311040
18688,mumrau,1,0.00002,3941134,91.41956,4311040
18689,muratkars,1,0.00002,3941135,91.41959,4311040
18690,muratso,1,0.00002,3941136,91.41961,4311040
18691,mur-me,1,0.00002,3941137,91.41963,4311040
18692,musabmasood,1,0.00002,3941138,91.41966,4311040
18693,mvpmvh,1,0.00002,3941139,91.41968,4311040
18694,mwelch-ptc,1,0.00002,3941140,91.41970,4311040
18695,mwright-pivotal,1,0.00002,3941141,91.41973,4311040
18696,myidpt,1,0.00002,3941142,91.41975,4311040
18697,myniva,1,0.00002,3941143,91.41977,4311040
18698,mziyabo,1,0.00002,3941144,91.41980,4311040
18699,nadgowdas,1,0.00002,3941145,91.41982,4311040
18700,nagakonduri,1,0.00002,3941146,91.41984,4311040
18701,Namphibian,1,0.00002,3941147,91.41987,4311040
18702,NareshKoduru,1,0.00002,3941148,91.41989,4311040
18703,natarajan0007,1,0.00002,3941149,91.41991,4311040
18704,natehart,1,0.00002,3941150,91.41994,4311040
18705,nathanawmk,1,0.00002,3941151,91.41996,4311040
18706,nathanjosiah,1,0.00002,3941152,91.41998,4311040
18707,NathanRSmith,1,0.00002,3941153,91.42001,4311040
18708,Natim,1,0.00002,3941154,91.42003,4311040
18709,nauxliu,1,0.00002,3941155,91.42005,4311040
18710,NauxLiu,1,0.00002,3941156,91.42007,4311040
18711,navicore,1,0.00002,3941157,91.42010,4311040
18712,NBardelot,1,0.00002,3941158,91.42012,4311040
18713,nbkrause,1,0.00002,3941159,91.42014,4311040
18714,ncgee,1,0.00002,3941160,91.42017,4311040
18715,ncresswell,1,0.00002,3941161,91.42019,4311040
18716,nebulon42,1,0.00002,3941162,91.42021,4311040
18717,necrolyte2,1,0.00002,3941163,91.42024,4311040
18718,neermitt,1,0.00002,3941164,91.42026,4311040
18719,neilcx,1,0.00002,3941165,91.42028,4311040
18720,nekufa,1,0.00002,3941166,91.42031,4311040
18721,nellessen,1,0.00002,3941167,91.42033,4311040
18722,Neonox31,1,0.00002,3941168,91.42035,4311040
18723,neowisard,1,0.00002,3941169,91.42038,4311040
18724,neumanndaniel,1,0.00002,3941170,91.42040,4311040
18725,neuralsandwich,1,0.00002,3941171,91.42042,4311040
18726,nevalla,1,0.00002,3941172,91.42045,4311040
18727,Nexucis,1,0.00002,3941173,91.42047,4311040
18728,ngealy,1,0.00002,3941174,91.42049,4311040
18729,nguyentung-199,1,0.00002,3941175,91.42052,4311040
18730,niallmccullagh,1,0.00002,3941176,91.42054,4311040
18731,nicholascapo,1,0.00002,3941177,91.42056,4311040
18732,nickborges,1,0.00002,3941178,91.42059,4311040
18733,nicknezis,1,0.00002,3941179,91.42061,4311040
18734,nickpetrovic,1,0.00002,3941180,91.42063,4311040
18735,nickrmc83,1,0.00002,3941181,91.42065,4311040
18736,NickUfer,1,0.00002,3941182,91.42068,4311040
18737,nickysemenza,1,0.00002,3941183,91.42070,4311040
18738,nicolai86,1,0.00002,3941184,91.42072,4311040
18739,nicolai92,1,0.00002,3941185,91.42075,4311040
18740,nielsonsantana,1,0.00002,3941186,91.42077,4311040
18741,nielstenboom,1,0.00002,3941187,91.42079,4311040
18742,nifr,1,0.00002,3941188,91.42082,4311040
18743,nikawang,1,0.00002,3941189,91.42084,4311040
18744,nikhail,1,0.00002,3941190,91.42086,4311040
18745,nikicat,1,0.00002,3941191,91.42089,4311040
18746,nikolay-te,1,0.00002,3941192,91.42091,4311040
18747,niravparikh05,1,0.00002,3941193,91.42093,4311040
18748,Nirmalyasen,1,0.00002,3941194,91.42096,4311040
18749,nirrozenbaum,1,0.00002,3941195,91.42098,4311040
18750,nishakm,1,0.00002,3941196,91.42100,4311040
18751,niuzhi,1,0.00002,3941197,91.42103,4311040
18752,nivekastoreth,1,0.00002,3941198,91.42105,4311040
18753,njablonski,1,0.00002,3941199,91.42107,4311040
18754,njhill,1,0.00002,3941200,91.42110,4311040
18755,njuCZ,1,0.00002,3941201,91.42112,4311040
18756,nkaplatt,1,0.00002,3941202,91.42114,4311040
18757,nkaravias,1,0.00002,3941203,91.42117,4311040
18758,nmaupu,1,0.00002,3941204,91.42119,4311040
18759,nnachefski,1,0.00002,3941205,91.42121,4311040
18760,nobodyiam,1,0.00002,3941206,91.42123,4311040
18761,nobu-k,1,0.00002,3941207,91.42126,4311040
18762,nodox,1,0.00002,3941208,91.42128,4311040
18763,noeljackson,1,0.00002,3941209,91.42130,4311040
18764,nogoegst,1,0.00002,3941210,91.42133,4311040
18765,nouney,1,0.00002,3941211,91.42135,4311040
18766,noxora,1,0.00002,3941212,91.42137,4311040
18767,npabb001,1,0.00002,3941213,91.42140,4311040
18768,nsainaney,1,0.00002,3941214,91.42142,4311040
18769,nschad,1,0.00002,3941215,91.42144,4311040
18770,nslater,1,0.00002,3941216,91.42147,4311040
18771,nstoggs,1,0.00002,3941217,91.42149,4311040
18772,ntolia,1,0.00002,3941218,91.42151,4311040
18773,ntriller-plaid,1,0.00002,3941219,91.42154,4311040
18774,ntwrkguru,1,0.00002,3941220,91.42156,4311040
18775,nunosilva800,1,0.00002,3941221,91.42158,4311040
18776,nunziox,1,0.00002,3941222,91.42161,4311040
18777,nwohlgemuth,1,0.00002,3941223,91.42163,4311040
18778,nyoxi,1,0.00002,3941224,91.42165,4311040
18779,Oblynx,1,0.00002,3941225,91.42168,4311040
18780,ocaner-biz,1,0.00002,3941226,91.42170,4311040
18781,oc-christopher-billett,1,0.00002,3941227,91.42172,4311040
18782,oCHRISo,1,0.00002,3941228,91.42175,4311040
18783,OctavioCore,1,0.00002,3941229,91.42177,4311040
18784,oculos,1,0.00002,3941230,91.42179,4311040
18785,ogazitt,1,0.00002,3941231,91.42181,4311040
18786,OGKevin,1,0.00002,3941232,91.42184,4311040
18787,OGtrilliams,1,0.00002,3941233,91.42186,4311040
18788,ohadm2,1,0.00002,3941234,91.42188,4311040
18789,ohardy,1,0.00002,3941235,91.42191,4311040
18790,oiooj,1,0.00002,3941236,91.42193,4311040
18791,ojhughes,1,0.00002,3941237,91.42195,4311040
18792,OKyHb,1,0.00002,3941238,91.42198,4311040
18793,olegburov,1,0.00002,3941239,91.42200,4311040
18794,olegs-codefresh,1,0.00002,3941240,91.42202,4311040
18795,Olegt0rr,1,0.00002,3941241,91.42205,4311040
18796,olitomlinson,1,0.00002,3941242,91.42207,4311040
18797,olivierboucher,1,0.00002,3941243,91.42209,4311040
18798,olivier-mauras,1,0.00002,3941244,91.42212,4311040
18799,Olshansk,1,0.00002,3941245,91.42214,4311040
18800,omgapuppy,1,0.00002,3941246,91.42216,4311040
18801,omid-verneek,1,0.00002,3941247,91.42219,4311040
18802,ondrejhlavacek,1,0.00002,3941248,91.42221,4311040
18803,Onlinehead,1,0.00002,3941249,91.42223,4311040
18804,openrory,1,0.00002,3941250,91.42226,4311040
18805,opsroller,1,0.00002,3941251,91.42228,4311040
18806,orangemi,1,0.00002,3941252,91.42230,4311040
18807,orwillt,1,0.00002,3941253,91.42233,4311040
18808,orymate,1,0.00002,3941254,91.42235,4311040
18809,osallou,1,0.00002,3941255,91.42237,4311040
18810,oshev,1,0.00002,3941256,91.42239,4311040
18811,Oshratn,1,0.00002,3941257,91.42242,4311040
18812,othmane399,1,0.00002,3941258,91.42244,4311040
18813,oumkale,1,0.00002,3941259,91.42246,4311040
18814,ourstart,1,0.00002,3941260,91.42249,4311040
18815,owainow,1,0.00002,3941261,91.42251,4311040
18816,owais,1,0.00002,3941262,91.42253,4311040
18817,oxxenix,1,0.00002,3941263,91.42256,4311040
18818,oxyno-zeta,1,0.00002,3941264,91.42258,4311040
18819,ozooxo,1,0.00002,3941265,91.42260,4311040
18820,p0tr3c,1,0.00002,3941266,91.42263,4311040
18821,p4ali,1,0.00002,3941267,91.42265,4311040
18822,paneq,1,0.00002,3941268,91.42267,4311040
18823,ParanoidAditya,1,0.00002,3941269,91.42270,4311040
18824,paravatha,1,0.00002,3941270,91.42272,4311040
18825,paravmellanox,1,0.00002,3941271,91.42274,4311040
18826,parkedwards,1,0.00002,3941272,91.42277,4311040
18827,paroxp,1,0.00002,3941273,91.42279,4311040
18828,parth-gr,1,0.00002,3941274,91.42281,4311040
18829,particledecay,1,0.00002,3941275,91.42284,4311040
18830,pashtet04,1,0.00002,3941276,91.42286,4311040
18831,passcod,1,0.00002,3941277,91.42288,4311040
18832,Pasukaru,1,0.00002,3941278,91.42290,4311040
18833,patrasap0908,1,0.00002,3941279,91.42293,4311040
18834,pauldthomson,1,0.00002,3941280,91.42295,4311040
18835,PaulFarver,1,0.00002,3941281,91.42297,4311040
18836,paullryan,1,0.00002,3941282,91.42300,4311040
18837,PaulMaddox,1,0.00002,3941283,91.42302,4311040
18838,PauloMigAlmeida,1,0.00002,3941284,91.42304,4311040
18839,paulopontesm,1,0.00002,3941285,91.42307,4311040
18840,paulpozicheun,1,0.00002,3941286,91.42309,4311040
18841,PaulRitzkat,1,0.00002,3941287,91.42311,4311040
18842,PaulusTM,1,0.00002,3941288,91.42314,4311040
18843,pavankumar-go,1,0.00002,3941289,91.42316,4311040
18844,pawankaushal,1,0.00002,3941290,91.42318,4311040
18845,pawlean,1,0.00002,3941291,91.42321,4311040
18846,pbabilas,1,0.00002,3941292,91.42323,4311040
18847,pbagchi,1,0.00002,3941293,91.42325,4311040
18848,pclalv,1,0.00002,3941294,91.42328,4311040
18849,pdericson,1,0.00002,3941295,91.42330,4311040
18850,pdxjohnny,1,0.00002,3941296,91.42332,4311040
18851,Peakchen,1,0.00002,3941297,91.42335,4311040
18852,pecigonzalo,1,0.00002,3941298,91.42337,4311040
18853,pedjak,1,0.00002,3941299,91.42339,4311040
18854,pedroarthur,1,0.00002,3941300,91.42342,4311040
18855,peidaqi,1,0.00002,3941301,91.42344,4311040
18856,pencil001,1,0.00002,3941302,91.42346,4311040
18857,PenelopeFudd,1,0.00002,3941303,91.42348,4311040
18858,PercyLau,1,0.00002,3941304,91.42351,4311040
18859,perenesenko,1,0.00002,3941305,91.42353,4311040
18860,perk-sumo,1,0.00002,3941306,91.42355,4311040
18861,PeteE,1,0.00002,3941307,91.42358,4311040
18862,peterloron,1,0.00002,3941308,91.42360,4311040
18863,peterwhitesell,1,0.00002,3941309,91.42362,4311040
18864,petomalina,1,0.00002,3941310,91.42365,4311040
18865,PetrMc,1,0.00002,3941311,91.42367,4311040
18866,pewpewp3w,1,0.00002,3941312,91.42369,4311040
18867,pffijt,1,0.00002,3941313,91.42372,4311040
18868,pfuhrmann,1,0.00002,3941314,91.42374,4311040
18869,pgadige,1,0.00002,3941315,91.42376,4311040
18870,pgollucci,1,0.00002,3941316,91.42379,4311040
18871,PHameete,1,0.00002,3941317,91.42381,4311040
18872,pharaujo,1,0.00002,3941318,91.42383,4311040
18873,philippeboyd,1,0.00002,3941319,91.42386,4311040
18874,phillipgibson,1,0.00002,3941320,91.42388,4311040
18875,PhilParisot,1,0.00002,3941321,91.42390,4311040
18876,phlegx,1,0.00002,3941322,91.42393,4311040
18877,pianohacker,1,0.00002,3941323,91.42395,4311040
18878,piclemx,1,0.00002,3941324,91.42397,4311040
18879,pidster,1,0.00002,3941325,91.42400,4311040
18880,pilhuhn,1,0.00002,3941326,91.42402,4311040
18881,pims,1,0.00002,3941327,91.42404,4311040
18882,Piotr1215,1,0.00002,3941328,91.42406,4311040
18883,piotrminkina,1,0.00002,3941329,91.42409,4311040
18884,pisto,1,0.00002,3941330,91.42411,4311040
18885,piyush0609,1,0.00002,3941331,91.42413,4311040
18886,pjjw,1,0.00002,3941332,91.42416,4311040
18887,pkalemba,1,0.00002,3941333,91.42418,4311040
18888,pkerschbaum,1,0.00002,3941334,91.42420,4311040
18889,plallin,1,0.00002,3941335,91.42423,4311040
18890,planetf1,1,0.00002,3941336,91.42425,4311040
18891,platten,1,0.00002,3941337,91.42427,4311040
18892,pliurh,1,0.00002,3941338,91.42430,4311040
18893,pmalek-sumo,1,0.00002,3941339,91.42432,4311040
18894,pmengelbert,1,0.00002,3941340,91.42434,4311040
18895,pmsanford,1,0.00002,3941341,91.42437,4311040
18896,pnowy,1,0.00002,3941342,91.42439,4311040
18897,pnull,1,0.00002,3941343,91.42441,4311040
18898,pokearu,1,0.00002,3941344,91.42444,4311040
18899,polarathene,1,0.00002,3941345,91.42446,4311040
18900,polarn,1,0.00002,3941346,91.42448,4311040
18901,polganesh,1,0.00002,3941347,91.42451,4311040
18902,poros,1,0.00002,3941348,91.42453,4311040
18903,pplavetzki,1,0.00002,3941349,91.42455,4311040
18904,pradeepchhetri,1,0.00002,3941350,91.42458,4311040
18905,pranavgaikwad,1,0.00002,3941351,91.42460,4311040
18906,prashant-ee,1,0.00002,3941352,91.42462,4311040
18907,prashantv,1,0.00002,3941353,91.42464,4311040
18908,prateekkhera92,1,0.00002,3941354,91.42467,4311040
18909,prateeksahu,1,0.00002,3941355,91.42469,4311040
18910,pratikforcoding,1,0.00002,3941356,91.42471,4311040
18911,pratikzingade,1,0.00002,3941357,91.42474,4311040
18912,praveenchandran,1,0.00002,3941358,91.42476,4311040
18913,PraveenJP,1,0.00002,3941359,91.42478,4311040
18914,prescod,1,0.00002,3941360,91.42481,4311040
18915,pritidesai,1,0.00002,3941361,91.42483,4311040
18916,PritomAhmed,1,0.00002,3941362,91.42485,4311040
18917,psaia,1,0.00002,3941363,91.42488,4311040
18918,pschwartz,1,0.00002,3941364,91.42490,4311040
18919,psheorangithub,1,0.00002,3941365,91.42492,4311040
18920,psingarakannan,1,0.00002,3941366,91.42495,4311040
18921,ptescher,1,0.00002,3941367,91.42497,4311040
18922,ptx96,1,0.00002,3941368,91.42499,4311040
18923,puiterwijk,1,0.00002,3941369,91.42502,4311040
18924,pukkaone,1,0.00002,3941370,91.42504,4311040
18925,pulecp,1,0.00002,3941371,91.42506,4311040
18926,puneethkosaraju,1,0.00002,3941372,91.42509,4311040
18927,Puneeth-n,1,0.00002,3941373,91.42511,4311040
18928,puradox,1,0.00002,3941374,91.42513,4311040
18929,pushrax,1,0.00002,3941375,91.42515,4311040
18930,pvaneck,1,0.00002,3941376,91.42518,4311040
18931,pvcnt,1,0.00002,3941377,91.42520,4311040
18932,pyohannes,1,0.00002,3941378,91.42522,4311040
18933,pyr0hu,1,0.00002,3941379,91.42525,4311040
18934,pzimno,1,0.00002,3941380,91.42527,4311040
18935,q0115643,1,0.00002,3941381,91.42529,4311040
18936,qfel,1,0.00002,3941382,91.42532,4311040
18937,qiaolin2019,1,0.00002,3941383,91.42534,4311040
18938,qingvincentyin,1,0.00002,3941384,91.42536,4311040
18939,qiupingdai,1,0.00002,3941385,91.42539,4311040
18940,QIvan,1,0.00002,3941386,91.42541,4311040
18941,qizha,1,0.00002,3941387,91.42543,4311040
18942,quertenmont,1,0.00002,3941388,91.42546,4311040
18943,quynhdang-vt,1,0.00002,3941389,91.42548,4311040
18944,r0bnet,1,0.00002,3941390,91.42550,4311040
18945,r2dedios,1,0.00002,3941391,91.42553,4311040
18946,r2sd,1,0.00002,3941392,91.42555,4311040
18947,raam86,1,0.00002,3941393,91.42557,4311040
18948,rachfop,1,0.00002,3941394,91.42560,4311040
18949,radiohead,1,0.00002,3941395,91.42562,4311040
18950,radiosilence,1,0.00002,3941396,91.42564,4311040
18951,RafaelAybar,1,0.00002,3941397,91.42567,4311040
18952,rafaelmembrives,1,0.00002,3941398,91.42569,4311040
18953,rafaribe,1,0.00002,3941399,91.42571,4311040
18954,RafPe,1,0.00002,3941400,91.42573,4311040
18955,ragebflame,1,0.00002,3941401,91.42576,4311040
18956,rahul799,1,0.00002,3941402,91.42578,4311040
18957,rahul8590,1,0.00002,3941403,91.42580,4311040
18958,rahulakash,1,0.00002,3941404,91.42583,4311040
18959,Rahul-github,1,0.00002,3941405,91.42585,4311040
18960,rahul-kumi,1,0.00002,3941406,91.42587,4311040
18961,raiviskrumins,1,0.00002,3941407,91.42590,4311040
18962,rajitha1998,1,0.00002,3941408,91.42592,4311040
18963,rakeshdatta,1,0.00002,3941409,91.42594,4311040
18964,RakhithaRR,1,0.00002,3941410,91.42597,4311040
18965,ralgozino,1,0.00002,3941411,91.42599,4311040
18966,Ram7378,1,0.00002,3941412,91.42601,4311040
18967,ramakuka,1,0.00002,3941413,91.42604,4311040
18968,ramonPires,1,0.00002,3941414,91.42606,4311040
18969,rampatnaik,1,0.00002,3941415,91.42608,4311040
18970,rastapopulous,1,0.00002,3941416,91.42611,4311040
18971,ravishankarsrrav,1,0.00002,3941417,91.42613,4311040
18972,razo7,1,0.00002,3941418,91.42615,4311040
18973,RazzM13,1,0.00002,3941419,91.42618,4311040
18974,rbkaspr,1,0.00002,3941420,91.42620,4311040
18975,rbsilva,1,0.00002,3941421,91.42622,4311040
18976,rcarmo,1,0.00002,3941422,91.42625,4311040
18977,rcarre,1,0.00002,3941423,91.42627,4311040
18978,rcreasey,1,0.00002,3941424,91.42629,4311040
18979,rcrowe,1,0.00002,3941425,91.42631,4311040
18980,r-darwish,1,0.00002,3941426,91.42634,4311040
18981,rdiaz82,1,0.00002,3941427,91.42636,4311040
18982,r-dilip,1,0.00002,3941428,91.42638,4311040
18983,rdpa,1,0.00002,3941429,91.42641,4311040
18984,rduarte-mule,1,0.00002,3941430,91.42643,4311040
18985,reagul,1,0.00002,3941431,91.42645,4311040
18986,rebelthor,1,0.00002,3941432,91.42648,4311040
18987,recampbell,1,0.00002,3941433,91.42650,4311040
18988,recena,1,0.00002,3941434,91.42652,4311040
18989,regorsmitz,1,0.00002,3941435,91.42655,4311040
18990,RehanSaeed,1,0.00002,3941436,91.42657,4311040
18991,reidab,1,0.00002,3941437,91.42659,4311040
18992,reikani,1,0.00002,3941438,91.42662,4311040
18993,ReiReiRei,1,0.00002,3941439,91.42664,4311040
18994,remster,1,0.00002,3941440,91.42666,4311040
18995,renhwztetecs,1,0.00002,3941441,91.42669,4311040
18996,renzhengeek,1,0.00002,3941442,91.42671,4311040
18997,Rezckant,1,0.00002,3941443,91.42673,4311040
18998,rgbkrk,1,0.00002,3941444,91.42676,4311040
18999,rgoldfinger-quizlet,1,0.00002,3941445,91.42678,4311040
19000,rguthriemsft,1,0.00002,3941446,91.42680,4311040
19001,rhigdon,1,0.00002,3941447,91.42683,4311040
19002,ricardoptcosta,1,0.00002,3941448,91.42685,4311040
19003,richardelling,1,0.00002,3941449,91.42687,4311040
19004,richardmatthewsdev,1,0.00002,3941450,91.42689,4311040
19005,richbg,1,0.00002,3941451,91.42692,4311040
19006,ricoleabricot,1,0.00002,3941452,91.42694,4311040
19007,ricoms,1,0.00002,3941453,91.42696,4311040
19008,rileyjbauer,1,0.00002,3941454,91.42699,4311040
19009,rishabhkumar296,1,0.00002,3941455,91.42701,4311040
19010,rishabhsinghvi,1,0.00002,3941456,91.42703,4311040
19011,ritwizsinha,1,0.00002,3941457,91.42706,4311040
19012,rjemanuele,1,0.00002,3941458,91.42708,4311040
19013,rklhui,1,0.00002,3941459,91.42710,4311040
19014,rlaakkol,1,0.00002,3941460,91.42713,4311040
19015,rlandesman,1,0.00002,3941461,91.42715,4311040
19016,rleungx,1,0.00002,3941462,91.42717,4311040
19017,rmak-cpi,1,0.00002,3941463,91.42720,4311040
19018,rnandi,1,0.00002,3941464,91.42722,4311040
19019,rnarayana,1,0.00002,3941465,91.42724,4311040
19020,rnavarro,1,0.00002,3941466,91.42727,4311040
19021,rndmh3ro,1,0.00002,3941467,91.42729,4311040
19022,rnishtala-sumo,1,0.00002,3941468,91.42731,4311040
19023,RNogales94,1,0.00002,3941469,91.42734,4311040
19024,roadrunner,1,0.00002,3941470,91.42736,4311040
19025,robbat2,1,0.00002,3941471,91.42738,4311040
19026,robbertvdg,1,0.00002,3941472,91.42740,4311040
19027,robertlagrant,1,0.00002,3941473,91.42743,4311040
19028,robertofabrizi,1,0.00002,3941474,91.42745,4311040
19029,robertorosas,1,0.00002,3941475,91.42747,4311040
19030,robertwe,1,0.00002,3941476,91.42750,4311040
19031,RobinUS2,1,0.00002,3941477,91.42752,4311040
19032,robpblake,1,0.00002,3941478,91.42754,4311040
19033,roccoblues,1,0.00002,3941479,91.42757,4311040
19034,rockymadden,1,0.00002,3941480,91.42759,4311040
19035,rodalli,1,0.00002,3941481,91.42761,4311040
19036,Rodalli,1,0.00002,3941482,91.42764,4311040
19037,rodneywells01,1,0.00002,3941483,91.42766,4311040
19038,rofr,1,0.00002,3941484,91.42768,4311040
19039,rohankmr414,1,0.00002,3941485,91.42771,4311040
19040,RohanKurane,1,0.00002,3941486,91.42773,4311040
19041,RohitKochhar,1,0.00002,3941487,91.42775,4311040
19042,roi-codefresh,1,0.00002,3941488,91.42778,4311040
19043,roivaz,1,0.00002,3941489,91.42780,4311040
19044,rojopolis,1,0.00002,3941490,91.42782,4311040
19045,rollulus,1,0.00002,3941491,91.42785,4311040
19046,romachalm,1,0.00002,3941492,91.42787,4311040
19047,RomainPhil,1,0.00002,3941493,91.42789,4311040
19048,ron212,1,0.00002,3941494,91.42792,4311040
19049,roncrivera,1,0.00002,3941495,91.42794,4311040
19050,ronlut,1,0.00002,3941496,91.42796,4311040
19051,RonnyMaas,1,0.00002,3941497,91.42798,4311040
19052,roonie007,1,0.00002,3941498,91.42801,4311040
19053,roopakrastogi,1,0.00002,3941499,91.42803,4311040
19054,rosberglinhares,1,0.00002,3941500,91.42805,4311040
19055,rosko,1,0.00002,3941501,91.42808,4311040
19056,rossato-rh,1,0.00002,3941502,91.42810,4311040
19057,roychri,1,0.00002,3941503,91.42812,4311040
19058,roymartinezblanco,1,0.00002,3941504,91.42815,4311040
19059,roystchiang,1,0.00002,3941505,91.42817,4311040
19060,rprouse,1,0.00002,3941506,91.42819,4311040
19061,RsrchBoy,1,0.00002,3941507,91.42822,4311040
19062,rubenssoto,1,0.00002,3941508,91.42824,4311040
19063,rudolphjacksonm,1,0.00002,3941509,91.42826,4311040
19064,ruiaraujo,1,0.00002,3941510,91.42829,4311040
19065,Rui-Tang,1,0.00002,3941511,91.42831,4311040
19066,Ruoyu-y,1,0.00002,3941512,91.42833,4311040
19067,rushikeshsuryawanshi,1,0.00002,3941513,91.42836,4311040
19068,rushmorem,1,0.00002,3941514,91.42838,4311040
19069,rutulpatel,1,0.00002,3941515,91.42840,4311040
19070,rvu95,1,0.00002,3941516,91.42843,4311040
19071,ryan-dayrit,1,0.00002,3941517,91.42845,4311040
19072,ryanhanks,1,0.00002,3941518,91.42847,4311040
19073,ryanli-me,1,0.00002,3941519,91.42850,4311040
19074,ryanmaclean,1,0.00002,3941520,91.42852,4311040
19075,RyanSiu1995,1,0.00002,3941521,91.42854,4311040
19076,Sadiquedeveloper,1,0.00002,3941522,91.42856,4311040
19077,sadoMasupilami,1,0.00002,3941523,91.42859,4311040
19078,SafPlusPlus,1,0.00002,3941524,91.42861,4311040
19079,Sagar2366,1,0.00002,3941525,91.42863,4311040
19080,sahotay,1,0.00002,3941526,91.42866,4311040
19081,sai3010,1,0.00002,3941527,91.42868,4311040
19082,saiskee,1,0.00002,3941528,91.42870,4311040
19083,saivarunk,1,0.00002,3941529,91.42873,4311040
19084,sam-github,1,0.00002,3941530,91.42875,4311040
19085,samgranieri,1,0.00002,3941531,91.42877,4311040
19086,sami9gag,1,0.00002,3941532,91.42880,4311040
19087,samirmajen,1,0.00002,3941533,91.42882,4311040
19088,samj1912,1,0.00002,3941534,91.42884,4311040
19089,samsp-msft,1,0.00002,3941535,91.42887,4311040
19090,SamuAlfageme,1,0.00002,3941536,91.42889,4311040
19091,samuel-sujith,1,0.00002,3941537,91.42891,4311040
19092,samueltbrown,1,0.00002,3941538,91.42894,4311040
19093,samyak-jn,1,0.00002,3941539,91.42896,4311040
19094,sanbornick,1,0.00002,3941540,91.42898,4311040
19095,sandeeplamb,1,0.00002,3941541,91.42901,4311040
19096,sandeepmendiratta,1,0.00002,3941542,91.42903,4311040
19097,sandersaares,1,0.00002,3941543,91.42905,4311040
19098,sanjacodes,1,0.00002,3941544,91.42908,4311040
19099,sanketg86,1,0.00002,3941545,91.42910,4311040
19100,santosh0705,1,0.00002,3941546,91.42912,4311040
19101,satchinjoshi,1,0.00002,3941547,91.42914,4311040
19102,SatishNaidi,1,0.00002,3941548,91.42917,4311040
19103,sauercrowd,1,0.00002,3941549,91.42919,4311040
19104,saumoh,1,0.00002,3941550,91.42921,4311040
19105,savithruml,1,0.00002,3941551,91.42924,4311040
19106,sayjeyhi,1,0.00002,3941552,91.42926,4311040
19107,sbeaulie,1,0.00002,3941553,91.42928,4311040
19108,sbernauer,1,0.00002,3941554,91.42931,4311040
19109,scalen,1,0.00002,3941555,91.42933,4311040
19110,scbunn-avalara,1,0.00002,3941556,91.42935,4311040
19111,scele,1,0.00002,3941557,91.42938,4311040
19112,s-chand,1,0.00002,3941558,91.42940,4311040
19113,schmitzhermes,1,0.00002,3941559,91.42942,4311040
19114,Schnitzel,1,0.00002,3941560,91.42945,4311040
19115,schulzh,1,0.00002,3941561,91.42947,4311040
19116,sclevine,1,0.00002,3941562,91.42949,4311040
19117,scott0000,1,0.00002,3941563,91.42952,4311040
19118,scottconrad88,1,0.00002,3941564,91.42954,4311040
19119,ScottKGregory,1,0.00002,3941565,91.42956,4311040
19120,scottmalkie,1,0.00002,3941566,91.42959,4311040
19121,scottweitzner,1,0.00002,3941567,91.42961,4311040
19122,scurvydoggo,1,0.00002,3941568,91.42963,4311040
19123,sdf611097,1,0.00002,3941569,91.42966,4311040
19124,sdiaz,1,0.00002,3941570,91.42968,4311040
19125,sdomula,1,0.00002,3941571,91.42970,4311040
19126,seamounts,1,0.00002,3941572,91.42972,4311040
19127,sebarys,1,0.00002,3941573,91.42975,4311040
19128,sebastianroesch,1,0.00002,3941574,91.42977,4311040
19129,sebastianwoinar,1,0.00002,3941575,91.42979,4311040
19130,sebastien-rosset,1,0.00002,3941576,91.42982,4311040
19131,sechkova,1,0.00002,3941577,91.42984,4311040
19132,sekhrivijay,1,0.00002,3941578,91.42986,4311040
19133,selansen,1,0.00002,3941579,91.42989,4311040
19134,sel-vcc,1,0.00002,3941580,91.42991,4311040
19135,sengjea,1,0.00002,3941581,91.42993,4311040
19136,serenamarie125,1,0.00002,3941582,91.42996,4311040
19137,sergeevo,1,0.00002,3941583,91.42998,4311040
19138,sergeydeg,1,0.00002,3941584,91.43000,4311040
19139,sergeyfd,1,0.00002,3941585,91.43003,4311040
19140,SergeyKons,1,0.00002,3941586,91.43005,4311040
19141,sergii-koshel-exa,1,0.00002,3941587,91.43007,4311040
19142,sergmelikyan,1,0.00002,3941588,91.43010,4311040
19143,sernst,1,0.00002,3941589,91.43012,4311040
19144,sesto,1,0.00002,3941590,91.43014,4311040
19145,severinson,1,0.00002,3941591,91.43017,4311040
19146,sfenman,1,0.00002,3941592,91.43019,4311040
19147,sfluor,1,0.00002,3941593,91.43021,4311040
19148,sgoodliff,1,0.00002,3941594,91.43023,4311040
19149,sgorbaty,1,0.00002,3941595,91.43026,4311040
19150,sguyennet,1,0.00002,3941596,91.43028,4311040
19151,Sh1ftry,1,0.00002,3941597,91.43030,4311040
19152,shabicheng,1,0.00002,3941598,91.43033,4311040
19153,shaded-enmity,1,0.00002,3941599,91.43035,4311040
19154,shalako,1,0.00002,3941600,91.43037,4311040
19155,shamsalmon,1,0.00002,3941601,91.43040,4311040
19156,shaneboulden,1,0.00002,3941602,91.43042,4311040
19157,shaoyifeng1013,1,0.00002,3941603,91.43044,4311040
19158,shashankn91,1,0.00002,3941604,91.43047,4311040
19159,ShatilKhan,1,0.00002,3941605,91.43049,4311040
19160,shawnzhu,1,0.00002,3941606,91.43051,4311040
19161,shelby-moore,1,0.00002,3941607,91.43054,4311040
19162,Sheshagiri,1,0.00002,3941608,91.43056,4311040
19163,shikha-varun,1,0.00002,3941609,91.43058,4311040
19164,shimmerjs,1,0.00002,3941610,91.43061,4311040
19165,shinji3887,1,0.00002,3941611,91.43063,4311040
19166,shiyuan1992,1,0.00002,3941612,91.43065,4311040
19167,shovelend,1,0.00002,3941613,91.43068,4311040
19168,shree007,1,0.00002,3941614,91.43070,4311040
19169,shtripat,1,0.00002,3941615,91.43072,4311040
19170,shubhimainalli,1,0.00002,3941616,91.43075,4311040
19171,ShuzZzle,1,0.00002,3941617,91.43077,4311040
19172,shykes,1,0.00002,3941618,91.43079,4311040
19173,si74,1,0.00002,3941619,91.43081,4311040
19174,siddharth-sable,1,0.00002,3941620,91.43084,4311040
19175,sidiesen,1,0.00002,3941621,91.43086,4311040
19176,SiegfredRodriguez,1,0.00002,3941622,91.43088,4311040
19177,sillky,1,0.00002,3941623,91.43091,4311040
19178,SILLKY,1,0.00002,3941624,91.43093,4311040
19179,silviaDominguezP,1,0.00002,3941625,91.43095,4311040
19180,simcax,1,0.00002,3941626,91.43098,4311040
19181,SimeonPoot,1,0.00002,3941627,91.43100,4311040
19182,simonemex,1,0.00002,3941628,91.43102,4311040
19183,simonguest,1,0.00002,3941629,91.43105,4311040
19184,simonszu,1,0.00002,3941630,91.43107,4311040
19185,singhkrshivam,1,0.00002,3941631,91.43109,4311040
19186,sinhaaks,1,0.00002,3941632,91.43112,4311040
19187,sirantd,1,0.00002,3941633,91.43114,4311040
19188,siscia,1,0.00002,3941634,91.43116,4311040
19189,sistemvene,1,0.00002,3941635,91.43119,4311040
19190,sjanota,1,0.00002,3941636,91.43121,4311040
19191,sjbodzo,1,0.00002,3941637,91.43123,4311040
19192,sjtindell,1,0.00002,3941638,91.43126,4311040
19193,sjvp,1,0.00002,3941639,91.43128,4311040
19194,sk-,1,0.00002,3941640,91.43130,4311040
19195,skandragon,1,0.00002,3941641,91.43133,4311040
19196,Skeen,1,0.00002,3941642,91.43135,4311040
19197,skgsergio,1,0.00002,3941643,91.43137,4311040
19198,skippy,1,0.00002,3941644,91.43139,4311040
19199,skolenkin,1,0.00002,3941645,91.43142,4311040
19200,skozlov,1,0.00002,3941646,91.43144,4311040
19201,skylerto,1,0.00002,3941647,91.43146,4311040
19202,slamdev,1,0.00002,3941648,91.43149,4311040
19203,slandelle,1,0.00002,3941649,91.43151,4311040
19204,slapula,1,0.00002,3941650,91.43153,4311040
19205,smallinsky,1,0.00002,3941651,91.43156,4311040
19206,smark88,1,0.00002,3941652,91.43158,4311040
19207,smd134,1,0.00002,3941653,91.43160,4311040
19208,smileynewbie123,1,0.00002,3941654,91.43163,4311040
19209,smith,1,0.00002,3941655,91.43165,4311040
19210,smrutimandal,1,0.00002,3941656,91.43167,4311040
19211,Snazzie,1,0.00002,3941657,91.43170,4311040
19212,snehaljos,1,0.00002,3941658,91.43172,4311040
19213,snobu,1,0.00002,3941659,91.43174,4311040
19214,snoodleboot,1,0.00002,3941660,91.43177,4311040
19215,snoopdouglas,1,0.00002,3941661,91.43179,4311040
19216,Sodki,1,0.00002,3941662,91.43181,4311040
19217,Sodman,1,0.00002,3941663,91.43184,4311040
19218,soenkeliebau,1,0.00002,3941664,91.43186,4311040
19219,softlion,1,0.00002,3941665,91.43188,4311040
19220,softshipper,1,0.00002,3941666,91.43191,4311040
19221,sohaibmaroof,1,0.00002,3941667,91.43193,4311040
19222,soleares,1,0.00002,3941668,91.43195,4311040
19223,Solisol,1,0.00002,3941669,91.43197,4311040
19224,SonalNew,1,0.00002,3941670,91.43200,4311040
19225,songjiayang,1,0.00002,3941671,91.43202,4311040
19226,songole,1,0.00002,3941672,91.43204,4311040
19227,songskcn,1,0.00002,3941673,91.43207,4311040
19228,sonujose,1,0.00002,3941674,91.43209,4311040
19229,Souheil-Yazji,1,0.00002,3941675,91.43211,4311040
19230,soumentrivedi,1,0.00002,3941676,91.43214,4311040
19231,sp185503-ncr,1,0.00002,3941677,91.43216,4311040
19232,spekr,1,0.00002,3941678,91.43218,4311040
19233,spikeburton,1,0.00002,3941679,91.43221,4311040
19234,spots107,1,0.00002,3941680,91.43223,4311040
19235,Sprakhar97,1,0.00002,3941681,91.43225,4311040
19236,spyder007,1,0.00002,3941682,91.43228,4311040
19237,SRaddict,1,0.00002,3941683,91.43230,4311040
19238,srados,1,0.00002,3941684,91.43232,4311040
19239,sramabad1,1,0.00002,3941685,91.43235,4311040
19240,SriRamanujam,1,0.00002,3941686,91.43237,4311040
19241,sriumcp,1,0.00002,3941687,91.43239,4311040
19242,sri-vathsa,1,0.00002,3941688,91.43242,4311040
19243,sruon,1,0.00002,3941689,91.43244,4311040
19244,sryabkov,1,0.00002,3941690,91.43246,4311040
19245,ssaavedra,1,0.00002,3941691,91.43248,4311040
19246,ssabih,1,0.00002,3941692,91.43251,4311040
19247,ssuchter,1,0.00002,3941693,91.43253,4311040
19248,stackedsax,1,0.00002,3941694,91.43255,4311040
19249,Stackle,1,0.00002,3941695,91.43258,4311040
19250,stanspotts,1,0.00002,3941696,91.43260,4311040
19251,stefan-zh,1,0.00002,3941697,91.43262,4311040
19252,stellirin,1,0.00002,3941698,91.43265,4311040
19253,stephenh1991,1,0.00002,3941699,91.43267,4311040
19254,stephenharris,1,0.00002,3941700,91.43269,4311040
19255,stephenrob,1,0.00002,3941701,91.43272,4311040
19256,stevbev,1,0.00002,3941702,91.43274,4311040
19257,steve-gray,1,0.00002,3941703,91.43276,4311040
19258,stevegrubb,1,0.00002,3941704,91.43279,4311040
19259,SteveJones,1,0.00002,3941705,91.43281,4311040
19260,stevenjack,1,0.00002,3941706,91.43283,4311040
19261,StevenJDH,1,0.00002,3941707,91.43286,4311040
19262,stevenmanton,1,0.00002,3941708,91.43288,4311040
19263,StevenPG,1,0.00002,3941709,91.43290,4311040
19264,stevespringett,1,0.00002,3941710,91.43293,4311040
19265,stewartbutler,1,0.00002,3941711,91.43295,4311040
19266,stianlagstad,1,0.00002,3941712,91.43297,4311040
19267,stimmerman,1,0.00002,3941713,91.43300,4311040
19268,stmpy,1,0.00002,3941714,91.43302,4311040
19269,stopsopa,1,0.00002,3941715,91.43304,4311040
19270,stoyle,1,0.00002,3941716,91.43306,4311040
19271,strangeman,1,0.00002,3941717,91.43309,4311040
19272,stratus-ss,1,0.00002,3941718,91.43311,4311040
19273,StrongMonkey,1,0.00002,3941719,91.43313,4311040
19274,stuartleeks,1,0.00002,3941720,91.43316,4311040
19275,subfuzion,1,0.00002,3941721,91.43318,4311040
19276,suhailpatel,1,0.00002,3941722,91.43320,4311040
19277,suhas316380,1,0.00002,3941723,91.43323,4311040
19278,sukrit007,1,0.00002,3941724,91.43325,4311040
19279,sukrit007wawa,1,0.00002,3941725,91.43327,4311040
19280,sunadm,1,0.00002,3941726,91.43330,4311040
19281,sunanxiang,1,0.00002,3941727,91.43332,4311040
19282,SuperChenSSS,1,0.00002,3941728,91.43334,4311040
19283,SuperCoolAlan,1,0.00002,3941729,91.43337,4311040
19284,susana-garcia,1,0.00002,3941730,91.43339,4311040
19285,susanshi,1,0.00002,3941731,91.43341,4311040
19286,suskin,1,0.00002,3941732,91.43344,4311040
19287,svetlanabrennan,1,0.00002,3941733,91.43346,4311040
19288,swapkh91,1,0.00002,3941734,91.43348,4311040
19289,swapnil1988,1,0.00002,3941735,91.43351,4311040
19290,swapnild2111,1,0.00002,3941736,91.43353,4311040
19291,syedashrafulla,1,0.00002,3941737,91.43355,4311040
19292,syedrakib,1,0.00002,3941738,91.43358,4311040
19293,sylhero,1,0.00002,3941739,91.43360,4311040
19294,synax,1,0.00002,3941740,91.43362,4311040
19295,synhershko,1,0.00002,3941741,91.43364,4311040
19296,SystemZ,1,0.00002,3941742,91.43367,4311040
19297,szalai1,1,0.00002,3941743,91.43369,4311040
19298,szinck1,1,0.00002,3941744,91.43371,4311040
19299,szmi,1,0.00002,3941745,91.43374,4311040
19300,szprutamich,1,0.00002,3941746,91.43376,4311040
19301,szubster,1,0.00002,3941747,91.43378,4311040
19302,tadayosi,1,0.00002,3941748,91.43381,4311040
19303,tagarwal,1,0.00002,3941749,91.43383,4311040
19304,taha-au,1,0.00002,3941750,91.43385,4311040
19305,taitelman,1,0.00002,3941751,91.43388,4311040
19306,taksan,1,0.00002,3941752,91.43390,4311040
19307,Talador12,1,0.00002,3941753,91.43392,4311040
19308,tannerb,1,0.00002,3941754,91.43395,4311040
19309,tanskann,1,0.00002,3941755,91.43397,4311040
19310,tantona,1,0.00002,3941756,91.43399,4311040
19311,tarapon,1,0.00002,3941757,91.43402,4311040
19312,tarasglek,1,0.00002,3941758,91.43404,4311040
19313,tarnfeld,1,0.00002,3941759,91.43406,4311040
19314,Tatsinnit,1,0.00002,3941760,91.43409,4311040
19315,taufiqpsumarna,1,0.00002,3941761,91.43411,4311040
19316,taybur43,1,0.00002,3941762,91.43413,4311040
19317,taylorsmithgg,1,0.00002,3941763,91.43416,4311040
19318,tb137,1,0.00002,3941764,91.43418,4311040
19319,tbasim,1,0.00002,3941765,91.43420,4311040
19320,tbourrelovh,1,0.00002,3941766,91.43422,4311040
19321,tchia04,1,0.00002,3941767,91.43425,4311040
19322,tchupp,1,0.00002,3941768,91.43427,4311040
19323,tcondeixa,1,0.00002,3941769,91.43429,4311040
19324,tdmanv,1,0.00002,3941770,91.43432,4311040
19325,t-eckert,1,0.00002,3941771,91.43434,4311040
19326,teenarodriques,1,0.00002,3941772,91.43436,4311040
19327,Tehsmash,1,0.00002,3941773,91.43439,4311040
19328,tejasmanohar,1,0.00002,3941774,91.43441,4311040
19329,teknoraver,1,0.00002,3941775,91.43443,4311040
19330,temikelani,1,0.00002,3941776,91.43446,4311040
19331,teone,1,0.00002,3941777,91.43448,4311040
19332,terjesannum,1,0.00002,3941778,91.43450,4311040
19333,terorie,1,0.00002,3941779,91.43453,4311040
19334,texasmichelle,1,0.00002,3941780,91.43455,4311040
19335,tfluehmann,1,0.00002,3941781,91.43457,4311040
19336,tgjonesuk,1,0.00002,3941782,91.43460,4311040
19337,thardie,1,0.00002,3941783,91.43462,4311040
19338,thatarchguy,1,0.00002,3941784,91.43464,4311040
19339,thedug,1,0.00002,3941785,91.43467,4311040
19340,thegridman,1,0.00002,3941786,91.43469,4311040
19341,theRealWardo,1,0.00002,3941787,91.43471,4311040
19342,Thiago2436,1,0.00002,3941788,91.43474,4311040
19343,thinkerou,1,0.00002,3941789,91.43476,4311040
19344,thinkin,1,0.00002,3941790,91.43478,4311040
19345,Thinkwp,1,0.00002,3941791,91.43480,4311040
19346,tho93,1,0.00002,3941792,91.43483,4311040
19347,thojkooi,1,0.00002,3941793,91.43485,4311040
19348,thomas-b-jackson,1,0.00002,3941794,91.43487,4311040
19349,thomasliddledba,1,0.00002,3941795,91.43490,4311040
19350,ThomasSchoenbeck,1,0.00002,3941796,91.43492,4311040
19351,TiagoJMartins,1,0.00002,3941797,91.43494,4311040
19352,tiagomeireles,1,0.00002,3941798,91.43497,4311040
19353,TicktW,1,0.00002,3941799,91.43499,4311040
19354,timanovsky,1,0.00002,3941800,91.43501,4311040
19355,TimBobkov,1,0.00002,3941801,91.43504,4311040
19356,timburks,1,0.00002,3941802,91.43506,4311040
19357,timcharper,1,0.00002,3941803,91.43508,4311040
19358,timofey-drozhzhin,1,0.00002,3941804,91.43511,4311040
19359,timothyhinrichs,1,0.00002,3941805,91.43513,4311040
19360,timvandruenen,1,0.00002,3941806,91.43515,4311040
19361,tjakobsson,1,0.00002,3941807,91.43518,4311040
19362,tkinz27,1,0.00002,3941808,91.43520,4311040
19363,tlandschoff-scale,1,0.00002,3941809,91.43522,4311040
19364,tl-eirik-albrigtsen,1,0.00002,3941810,91.43525,4311040
19365,tmckayus,1,0.00002,3941811,91.43527,4311040
19366,toanju,1,0.00002,3941812,91.43529,4311040
19367,tobiasehlert,1,0.00002,3941813,91.43531,4311040
19368,toebbel,1,0.00002,3941814,91.43534,4311040
19369,tomastigera,1,0.00002,3941815,91.43536,4311040
19370,tomasz-kuzemko,1,0.00002,3941816,91.43538,4311040
19371,TomCools,1,0.00002,3941817,91.43541,4311040
19372,tomdottom,1,0.00002,3941818,91.43543,4311040
19373,tom-hadlaw-hs,1,0.00002,3941819,91.43545,4311040
19374,TomKeur,1,0.00002,3941820,91.43548,4311040
19375,tommyasai,1,0.00002,3941821,91.43550,4311040
19376,tommyulfsparre,1,0.00002,3941822,91.43552,4311040
19377,tomncooper,1,0.00002,3941823,91.43555,4311040
19378,tompscanlan,1,0.00002,3941824,91.43557,4311040
19379,tomtjose,1,0.00002,3941825,91.43559,4311040
19380,tomtom94,1,0.00002,3941826,91.43562,4311040
19381,tonanhngo,1,0.00002,3941827,91.43564,4311040
19382,TonyBarganski,1,0.00002,3941828,91.43566,4311040
19383,tonysurma,1,0.00002,3941829,91.43569,4311040
19384,TopGunBasten,1,0.00002,3941830,91.43571,4311040
19385,Toxicable,1,0.00002,3941831,91.43573,4311040
19386,TrafalgarZZZ,1,0.00002,3941832,91.43576,4311040
19387,trgeiger,1,0.00002,3941833,91.43578,4311040
19388,Tronix117,1,0.00002,3941834,91.43580,4311040
19389,trucnguyenlam,1,0.00002,3941835,91.43583,4311040
19390,ts4z,1,0.00002,3941836,91.43585,4311040
19391,tstringer,1,0.00002,3941837,91.43587,4311040
19392,tsurdilo,1,0.00002,3941838,91.43589,4311040
19393,tswast,1,0.00002,3941839,91.43592,4311040
19394,ttyS0,1,0.00002,3941840,91.43594,4311040
19395,tullo,1,0.00002,3941841,91.43596,4311040
19396,turbaszek,1,0.00002,3941842,91.43599,4311040
19397,TurboTim,1,0.00002,3941843,91.43601,4311040
19398,Turbots,1,0.00002,3941844,91.43603,4311040
19399,tustvold,1,0.00002,3941845,91.43606,4311040
19400,tux21b,1,0.00002,3941846,91.43608,4311040
19401,twaugh,1,0.00002,3941847,91.43610,4311040
19402,TwiN,1,0.00002,3941848,91.43613,4311040
19403,twk3,1,0.00002,3941849,91.43615,4311040
19404,tych0,1,0.00002,3941850,91.43617,4311040
19405,tyg03485,1,0.00002,3941851,91.43620,4311040
19406,TylerHelmuth,1,0.00002,3941852,91.43622,4311040
19407,tymokvo,1,0.00002,3941853,91.43624,4311040
19408,tytso,1,0.00002,3941854,91.43627,4311040
19409,uclaeaslam,1,0.00002,3941855,91.43629,4311040
19410,Ugzuzg,1,0.00002,3941856,91.43631,4311040
19411,uhinze,1,0.00002,3941857,91.43634,4311040
19412,uipo78,1,0.00002,3941858,91.43636,4311040
19413,ulisse31,1,0.00002,3941859,91.43638,4311040
19414,umitseremet,1,0.00002,3941860,91.43641,4311040
19415,unitto1,1,0.00002,3941861,91.43643,4311040
19416,UnwashedMeme,1,0.00002,3941862,91.43645,4311040
19417,User1m,1,0.00002,3941863,91.43647,4311040
19418,ustcyue,1,0.00002,3941864,91.43650,4311040
19419,Uvindu96,1,0.00002,3941865,91.43652,4311040
19420,vadimk2016,1,0.00002,3941866,91.43654,4311040
19421,vaibhavjain882,1,0.00002,3941867,91.43657,4311040
19422,valo,1,0.00002,3941868,91.43659,4311040
19423,vangie,1,0.00002,3941869,91.43661,4311040
19424,vanpelt,1,0.00002,3941870,91.43664,4311040
19425,varunbpatil,1,0.00002,3941871,91.43666,4311040
19426,varunkumar,1,0.00002,3941872,91.43668,4311040
19427,vbem,1,0.00002,3941873,91.43671,4311040
19428,vd-rd,1,0.00002,3941874,91.43673,4311040
19429,VedRatan,1,0.00002,3941875,91.43675,4311040
19430,vegood,1,0.00002,3941876,91.43678,4311040
19431,Venkat19967,1,0.00002,3941877,91.43680,4311040
19432,venkatpx,1,0.00002,3941878,91.43682,4311040
19433,venkyvb,1,0.00002,3941879,91.43685,4311040
19434,vFondevilla,1,0.00002,3941880,91.43687,4311040
19435,vgazzola,1,0.00002,3941881,91.43689,4311040
19436,vichargrave,1,0.00002,3941882,91.43692,4311040
19437,vidhut-singh,1,0.00002,3941883,91.43694,4311040
19438,vijaykumark,1,0.00002,3941884,91.43696,4311040
19439,vijaySamanuri,1,0.00002,3941885,91.43699,4311040
19440,vikram-yerneni,1,0.00002,3941886,91.43701,4311040
19441,ViktorHofer,1,0.00002,3941887,91.43703,4311040
19442,vinaynair,1,0.00002,3941888,91.43705,4311040
19443,VincentDu2021,1,0.00002,3941889,91.43708,4311040
19444,Vinceveve,1,0.00002,3941890,91.43710,4311040
19445,vintikzzz,1,0.00002,3941891,91.43712,4311040
19446,virtrixke,1,0.00002,3941892,91.43715,4311040
19447,vishalud,1,0.00002,3941893,91.43717,4311040
19448,visheshtanksale,1,0.00002,3941894,91.43719,4311040
19449,vishnuchalla,1,0.00002,3941895,91.43722,4311040
19450,visortelle,1,0.00002,3941896,91.43724,4311040
19451,visualphoenix,1,0.00002,3941897,91.43726,4311040
19452,vitaliy-sn,1,0.00002,3941898,91.43729,4311040
19453,vitaliy-zinchenko,1,0.00002,3941899,91.43731,4311040
19454,vito-laurenza-zocdoc,1,0.00002,3941900,91.43733,4311040
19455,vnextcoder,1,0.00002,3941901,91.43736,4311040
19456,VolCh,1,0.00002,3941902,91.43738,4311040
19457,VonRehberg,1,0.00002,3941903,91.43740,4311040
19458,voutasaurus,1,0.00002,3941904,91.43743,4311040
19459,voxik,1,0.00002,3941905,91.43745,4311040
19460,vpasquier,1,0.00002,3941906,91.43747,4311040
19461,vpavlin,1,0.00002,3941907,91.43750,4311040
19462,vpetersson,1,0.00002,3941908,91.43752,4311040
19463,vranystepan,1,0.00002,3941909,91.43754,4311040
19464,vrih,1,0.00002,3941910,91.43756,4311040
19465,vrnmthr,1,0.00002,3941911,91.43759,4311040
19466,vvicaretti,1,0.00002,3941912,91.43761,4311040
19467,w00jay,1,0.00002,3941913,91.43763,4311040
19468,wabouhamad,1,0.00002,3941914,91.43766,4311040
19469,wadkar,1,0.00002,3941915,91.43768,4311040
19470,wajeehulhassanvii,1,0.00002,3941916,91.43770,4311040
19471,walkamongus,1,0.00002,3941917,91.43773,4311040
19472,wangchenglong01,1,0.00002,3941918,91.43775,4311040
19473,wangkuiyi,1,0.00002,3941919,91.43777,4311040
19474,wangli1030,1,0.00002,3941920,91.43780,4311040
19475,wangxfbelieve,1,0.00002,3941921,91.43782,4311040
19476,watashiSHUN,1,0.00002,3941922,91.43784,4311040
19477,waterlink,1,0.00002,3941923,91.43787,4311040
19478,watermeion,1,0.00002,3941924,91.43789,4311040
19479,wathiede,1,0.00002,3941925,91.43791,4311040
19480,wavell,1,0.00002,3941926,91.43794,4311040
19481,wbarnard81,1,0.00002,3941927,91.43796,4311040
19482,wcedmisten,1,0.00002,3941928,91.43798,4311040
19483,wchrisjohnson,1,0.00002,3941929,91.43801,4311040
19484,wdauchy,1,0.00002,3941930,91.43803,4311040
19485,webberwang,1,0.00002,3941931,91.43805,4311040
19486,webframp,1,0.00002,3941932,91.43808,4311040
19487,webner,1,0.00002,3941933,91.43810,4311040
19488,webnull,1,0.00002,3941934,91.43812,4311040
19489,weijie0,1,0.00002,3941935,91.43814,4311040
19490,weiran-ms,1,0.00002,3941936,91.43817,4311040
19491,wenchenglu,1,0.00002,3941937,91.43819,4311040
19492,wengkee,1,0.00002,3941938,91.43821,4311040
19493,werdnum,1,0.00002,3941939,91.43824,4311040
19494,weshayutin,1,0.00002,3941940,91.43826,4311040
19495,wfarr,1,0.00002,3941941,91.43828,4311040
19496,whizard,1,0.00002,3941942,91.43831,4311040
19497,whynowy,1,0.00002,3941943,91.43833,4311040
19498,willgleich,1,0.00002,3941944,91.43835,4311040
19499,William-Yeh,1,0.00002,3941945,91.43838,4311040
19500,williscool,1,0.00002,3941946,91.43840,4311040
19501,wilsonwang371,1,0.00002,3941947,91.43842,4311040
19502,wim-de-groot,1,0.00002,3941948,91.43845,4311040
19503,WindzCUHK,1,0.00002,3941949,91.43847,4311040
19504,winguse,1,0.00002,3941950,91.43849,4311040
19505,wizbit,1,0.00002,3941951,91.43852,4311040
19506,wj24021040,1,0.00002,3941952,91.43854,4311040
19507,wjoel,1,0.00002,3941953,91.43856,4311040
19508,wklken,1,0.00002,3941954,91.43859,4311040
19509,wojtek-viirtue,1,0.00002,3941955,91.43861,4311040
19510,wolfeidau,1,0.00002,3941956,91.43863,4311040
19511,WoLfulus,1,0.00002,3941957,91.43866,4311040
19512,wolverian,1,0.00002,3941958,91.43868,4311040
19513,wombat,1,0.00002,3941959,91.43870,4311040
19514,wonderg,1,0.00002,3941960,91.43872,4311040
19515,wondersd,1,0.00002,3941961,91.43875,4311040
19516,workflow,1,0.00002,3941962,91.43877,4311040
19517,wpeng102,1,0.00002,3941963,91.43879,4311040
19518,wrigtim,1,0.00002,3941964,91.43882,4311040
19519,wshwawa,1,0.00002,3941965,91.43884,4311040
19520,wtait1-ff,1,0.00002,3941966,91.43886,4311040
19521,wtip,1,0.00002,3941967,91.43889,4311040
19522,wtritch,1,0.00002,3941968,91.43891,4311040
19523,wufengzlw,1,0.00002,3941969,91.43893,4311040
19524,wuqiany2,1,0.00002,3941970,91.43896,4311040
19525,wuqihui0317,1,0.00002,3941971,91.43898,4311040
19526,wusphinx,1,0.00002,3941972,91.43900,4311040
19527,wuub,1,0.00002,3941973,91.43903,4311040
19528,wvidana,1,0.00002,3941974,91.43905,4311040
19529,wweic,1,0.00002,3941975,91.43907,4311040
19530,wwwy3y3,1,0.00002,3941976,91.43910,4311040
19531,wydwww,1,0.00002,3941977,91.43912,4311040
19532,wz185,1,0.00002,3941978,91.43914,4311040
19533,XaF,1,0.00002,3941979,91.43917,4311040
19534,xbglowx,1,0.00002,3941980,91.43919,4311040
19535,xdexter,1,0.00002,3941981,91.43921,4311040
19536,xenithorb,1,0.00002,3941982,91.43924,4311040
19537,xesco,1,0.00002,3941983,91.43926,4311040
19538,xiaoluhong,1,0.00002,3941984,91.43928,4311040
19539,xibz,1,0.00002,3941985,91.43930,4311040
19540,xiekeyang,1,0.00002,3941986,91.43933,4311040
19541,xinghui-hou,1,0.00002,3941987,91.43935,4311040
19542,XishengCai,1,0.00002,3941988,91.43937,4311040
19543,xkortex,1,0.00002,3941989,91.43940,4311040
19544,xlight05,1,0.00002,3941990,91.43942,4311040
19545,xnox,1,0.00002,3941991,91.43944,4311040
19546,xonstone,1,0.00002,3941992,91.43947,4311040
19547,xq2248,1,0.00002,3941993,91.43949,4311040
19548,xrisaD,1,0.00002,3941994,91.43951,4311040
19549,Xuanwo,1,0.00002,3941995,91.43954,4311040
19550,xuchengli,1,0.00002,3941996,91.43956,4311040
19551,xvilo,1,0.00002,3941997,91.43958,4311040
19552,XVincentX,1,0.00002,3941998,91.43961,4311040
19553,xxinran,1,0.00002,3941999,91.43963,4311040
19554,xxmyjk,1,0.00002,3942000,91.43965,4311040
19555,xzy256,1,0.00002,3942001,91.43968,4311040
19556,yalosev,1,0.00002,3942002,91.43970,4311040
19557,yamaken1343,1,0.00002,3942003,91.43972,4311040
19558,yangjunsss,1,0.00002,3942004,91.43975,4311040
19559,yannick,1,0.00002,3942005,91.43977,4311040
19560,yanpozka,1,0.00002,3942006,91.43979,4311040
19561,yanweininenine,1,0.00002,3942007,91.43981,4311040
19562,yaojingguo,1,0.00002,3942008,91.43984,4311040
19563,yashrsharma44,1,0.00002,3942009,91.43986,4311040
19564,yboaron,1,0.00002,3942010,91.43988,4311040
19565,yctn,1,0.00002,3942011,91.43991,4311040
19566,yeahservice,1,0.00002,3942012,91.43993,4311040
19567,yetone,1,0.00002,3942013,91.43995,4311040
19568,yghannam,1,0.00002,3942014,91.43998,4311040
19569,yifan-gu-anchorage,1,0.00002,3942015,91.44000,4311040
19570,yimipeng,1,0.00002,3942016,91.44002,4311040
19571,yiwei-C,1,0.00002,3942017,91.44005,4311040
19572,Yizong98,1,0.00002,3942018,91.44007,4311040
19573,yjiang5,1,0.00002,3942019,91.44009,4311040
19574,YKWeyer,1,0.00002,3942020,91.44012,4311040
19575,Y-k-Y,1,0.00002,3942021,91.44014,4311040
19576,ymatsiuk,1,0.00002,3942022,91.44016,4311040
19577,yogesh-chaudhari-77,1,0.00002,3942023,91.44019,4311040
19578,yoojinl,1,0.00002,3942024,91.44021,4311040
19579,yorammi,1,0.00002,3942025,91.44023,4311040
19580,yosida95,1,0.00002,3942026,91.44026,4311040
19581,youreddy,1,0.00002,3942027,91.44028,4311040
19582,youyajie,1,0.00002,3942028,91.44030,4311040
19583,ypsilik,1,0.00002,3942029,91.44033,4311040
19584,ysma500,1,0.00002,3942030,91.44035,4311040
19585,yuananf,1,0.00002,3942031,91.44037,4311040
19586,yubozhao,1,0.00002,3942032,91.44039,4311040
19587,yuji-watanabe-jp,1,0.00002,3942033,91.44042,4311040
19588,yulin-li,1,0.00002,3942034,91.44044,4311040
19589,YunSangJun,1,0.00002,3942035,91.44046,4311040
19590,YuqiXiao,1,0.00002,3942036,91.44049,4311040
19591,yuvalman,1,0.00002,3942037,91.44051,4311040
19592,yuvgeek,1,0.00002,3942038,91.44053,4311040
19593,yyb196,1,0.00002,3942039,91.44056,4311040
19594,yzhao1012,1,0.00002,3942040,91.44058,4311040
19595,zach-source,1,0.00002,3942041,91.44060,4311040
19596,zack-johnson5455,1,0.00002,3942042,91.44063,4311040
19597,zakariae-lebriq,1,0.00002,3942043,91.44065,4311040
19598,zakharovvi,1,0.00002,3942044,91.44067,4311040
19599,zamai,1,0.00002,3942045,91.44070,4311040
19600,zamnuts,1,0.00002,3942046,91.44072,4311040
19601,zamonia500,1,0.00002,3942047,91.44074,4311040
19602,Zarca,1,0.00002,3942048,91.44077,4311040
19603,Zasimovich,1,0.00002,3942049,91.44079,4311040
19604,zbrookle,1,0.00002,3942050,91.44081,4311040
19605,zchunhai,1,0.00002,3942051,91.44084,4311040
19606,zcourts,1,0.00002,3942052,91.44086,4311040
19607,zeeke,1,0.00002,3942053,91.44088,4311040
19608,ZeroDeth,1,0.00002,3942054,91.44091,4311040
19609,zeroschism,1,0.00002,3942055,91.44093,4311040
19610,zhangzheming629,1,0.00002,3942056,91.44095,4311040
19611,zhangzujian,1,0.00002,3942057,91.44097,4311040
19612,ZhimaoL,1,0.00002,3942058,91.44100,4311040
19613,zhonghuali,1,0.00002,3942059,91.44102,4311040
19614,zhujiangyou,1,0.00002,3942060,91.44104,4311040
19615,zhuyaguang,1,0.00002,3942061,91.44107,4311040
19616,zieg8301,1,0.00002,3942062,91.44109,4311040
19617,zipper97412,1,0.00002,3942063,91.44111,4311040
19618,zmberg,1,0.00002,3942064,91.44114,4311040
19619,zmc,1,0.00002,3942065,91.44116,4311040
19620,zmedico,1,0.00002,3942066,91.44118,4311040
19621,zmhassan,1,0.00002,3942067,91.44121,4311040
19622,znd4,1,0.00002,3942068,91.44123,4311040
19623,zoni,1,0.00002,3942069,91.44125,4311040
19624,zonorti,1,0.00002,3942070,91.44128,4311040
19625,zyfjeff,1,0.00002,3942071,91.44130,4311040
19626,zzunny97,1,0.00002,3942072,91.44132,4311040
