rank_number,actor,contributions,percent,cumulative_sum,cumulative_percent,all_contributions
1,chensun,6261,2.31620,6261,2.31620,270314
2,sarahmaddox,5546,2.05169,11807,4.36788,270314
3,connor-mccarthy,4472,1.65437,16279,6.02226,270314
4,zijianjoy,4377,1.61923,20656,7.64148,270314
5,numerology,3377,1.24929,24033,8.89077,270314
6,kkasravi,2392,0.88490,26425,9.77567,270314
7,8bitmp3,1937,0.71657,28362,10.49224,270314
8,gabrielwen,1748,0.64666,30110,11.13890,270314
9,neuromage,1724,0.63778,31834,11.77667,270314
10,Linchin,1533,0.56712,33367,12.34379,270314
11,gkcalat,1456,0.53863,34823,12.88243,270314
12,abhi-g,1400,0.51792,36223,13.40034,270314
13,rmgogogo,1321,0.48869,37544,13.88903,270314
14,hongye-sun,1284,0.47500,38828,14.36404,270314
15,joeliedtke,1282,0.47426,40110,14.83830,270314
16,chongyouquan,1240,0.45873,41350,15.29702,270314
17,jingzhang36,1238,0.45799,42588,15.75501,270314
18,RFMVasconcelos,1193,0.44134,43781,16.19635,270314
19,SinaChavoshi,1182,0.43727,44963,16.63362,270314
20,capri-xiyue,1157,0.42802,46120,17.06164,270314
21,jlyaoyuli,1099,0.40656,47219,17.46820,270314
22,avdaredevil,1092,0.40397,48311,17.87218,270314
23,ckadner,1090,0.40323,49401,18.27541,270314
24,surajkota,904,0.33443,50305,18.60984,270314
25,prodonjs,863,0.31926,51168,18.92910,270314
26,texasmichelle,721,0.26673,51889,19.19582,270314
27,karthikv2k,539,0.19940,52428,19.39522,270314
28,zw0610,510,0.18867,52938,19.58389,270314
29,janeman98,492,0.18201,53430,19.76590,270314
30,ji-yaqi,478,0.17683,53908,19.94273,270314
31,zpChris,474,0.17535,54382,20.11808,270314
32,zabbasi,441,0.16314,54823,20.28123,270314
33,yuzliu,432,0.15981,55255,20.44104,270314
34,james-jwu,415,0.15353,55670,20.59457,270314
35,pvaneck,396,0.14650,56066,20.74106,270314
36,eterna2,379,0.14021,56445,20.88127,270314
37,ajchili,369,0.13651,56814,21.01778,270314
38,adrian555,364,0.13466,57178,21.15244,270314
39,happy2048,350,0.12948,57528,21.28192,270314
40,orfeas-k,323,0.11949,57851,21.40141,270314
41,ashahba,312,0.11542,58163,21.51683,270314
42,dushyanthsc,304,0.11246,58467,21.62929,270314
43,cwbeitel,296,0.10950,58763,21.73879,270314
44,Udiknedormin,296,0.10950,59059,21.84829,270314
45,drewbutlerbb4,291,0.10765,59350,21.95595,270314
46,kwasi,285,0.10543,59635,22.06138,270314
47,qimingj,285,0.10543,59920,22.16681,270314
48,shannonbradshaw,273,0.10099,60193,22.26781,270314
49,holdenk,262,0.09692,60455,22.36473,270314
50,activatedgeek,261,0.09655,60716,22.46129,270314
51,elenzio9,260,0.09618,60976,22.55747,270314
52,haoxins,241,0.08916,61217,22.64663,270314
53,ryansteakley,227,0.08398,61444,22.73060,270314
54,TheMichaelHu,224,0.08287,61668,22.81347,270314
55,nrchakradhar,216,0.07991,61884,22.89338,270314
56,jagadeeshi2i,210,0.07769,62094,22.97106,270314
57,subodh101,197,0.07288,62291,23.04394,270314
58,js-ts,191,0.07066,62482,23.11460,270314
59,JOCSTAA,190,0.07029,62672,23.18489,270314
60,difince,187,0.06918,62859,23.25407,270314
61,abchoo,185,0.06844,63044,23.32251,270314
62,ananth102,184,0.06807,63228,23.39058,270314
63,sperlingxx,180,0.06659,63408,23.45716,270314
64,c-bata,167,0.06178,63575,23.51894,270314
65,puneith,167,0.06178,63742,23.58072,270314
66,Swikar,167,0.06178,63909,23.64250,270314
67,chauhang,163,0.06030,64072,23.70280,270314
68,zichuan-scott-xu,163,0.06030,64235,23.76311,270314
69,sasha-gitg,161,0.05956,64396,23.82267,270314
70,munagekar,160,0.05919,64556,23.88186,270314
71,tasos-ale,158,0.05845,64714,23.94031,270314
72,wsxiaozhang,154,0.05697,64868,23.99728,270314
73,mbaijal,152,0.05623,65020,24.05351,270314
74,ifilonenko,151,0.05586,65171,24.10937,270314
75,chrisheecho,147,0.05438,65318,24.16375,270314
76,shrinath-suresh,145,0.05364,65463,24.21739,270314
77,Jimexist,142,0.05253,65605,24.26992,270314
78,kevinyu98,141,0.05216,65746,24.32208,270314
79,ajinkya933,140,0.05179,65886,24.37388,270314
80,xiaozhouX,139,0.05142,66025,24.42530,270314
81,luotigerlsx,138,0.05105,66163,24.47635,270314
82,kevinbache,130,0.04809,66293,24.52444,270314
83,rpasricha,125,0.04624,66418,24.57068,270314
84,cspavlou,124,0.04587,66542,24.61656,270314
85,mameshini,124,0.04587,66666,24.66243,270314
86,sen-sam,121,0.04476,66787,24.70719,270314
87,paveldournov,120,0.04439,66907,24.75159,270314
88,vkoukis,120,0.04439,67027,24.79598,270314
89,abcdefgs0324,119,0.04402,67146,24.84000,270314
90,kuizhiqing,118,0.04365,67264,24.88365,270314
91,yupbank,118,0.04365,67382,24.92731,270314
92,ddutta,116,0.04291,67498,24.97022,270314
93,carmine,115,0.04254,67613,25.01276,270314
94,casassg,115,0.04254,67728,25.05531,270314
95,jal06,113,0.04180,67841,25.09711,270314
96,dsdinter,109,0.04032,67950,25.13743,270314
97,woop,107,0.03958,68057,25.17702,270314
98,rd-pong,106,0.03921,68163,25.21623,270314
99,ConverJens,105,0.03884,68268,25.25507,270314
100,elviraux,105,0.03884,68373,25.29392,270314
101,NickLoukas,104,0.03847,68477,25.33239,270314
102,ca-scribner,103,0.03810,68580,25.37050,270314
103,evan-hataishi,102,0.03773,68682,25.40823,270314
104,jc2729,102,0.03773,68784,25.44596,270314
105,ajayalfred,101,0.03736,68885,25.48333,270314
106,jiaqianjing,101,0.03736,68986,25.52069,270314
107,DanSanche,100,0.03699,69086,25.55768,270314
108,midhun1998,100,0.03699,69186,25.59468,270314
109,deepak-muley,98,0.03625,69284,25.63093,270314
110,lynnmatrix,97,0.03588,69381,25.66682,270314
111,alecglassford,96,0.03551,69477,25.70233,270314
112,JakeTheWise,96,0.03551,69573,25.73785,270314
113,LaynePeng,94,0.03477,69667,25.77262,270314
114,ewilderj,88,0.03255,69755,25.80517,270314
115,xfate123,87,0.03218,69842,25.83736,270314
116,a9p,86,0.03181,69928,25.86917,270314
117,dldaisy,85,0.03144,70013,25.90062,270314
118,lowang-bh,85,0.03144,70098,25.93206,270314
119,SaschaHeyer,85,0.03144,70183,25.96351,270314
120,toshi-k,85,0.03144,70268,25.99495,270314
121,zanedurante,85,0.03144,70353,26.02640,270314
122,derekhh,84,0.03107,70437,26.05747,270314
123,cyrilthank,83,0.03071,70520,26.08818,270314
124,yilun-msft,82,0.03034,70602,26.11851,270314
125,cvenets,81,0.02997,70683,26.14848,270314
126,nagar-ajay,81,0.02997,70764,26.17844,270314
127,parthmishra,81,0.02997,70845,26.20841,270314
128,shaowei-su,81,0.02997,70926,26.23837,270314
129,xhejtman,81,0.02997,71007,26.26834,270314
130,yashjakhotiya,81,0.02997,71088,26.29830,270314
131,amitmukati-2604,80,0.02960,71168,26.32790,270314
132,OfficePop,80,0.02960,71248,26.35750,270314
133,tduffy000,80,0.02960,71328,26.38709,270314
134,KevinBNaughton,78,0.02886,71406,26.41595,270314
135,shaikmanu797,78,0.02886,71484,26.44480,270314
136,jackwhelpton,77,0.02849,71561,26.47329,270314
137,jiyongjung0,76,0.02812,71637,26.50140,270314
138,wukong1992,76,0.02812,71713,26.52952,270314
139,aniruddhachoudhury,75,0.02775,71788,26.55726,270314
140,pingsutw,75,0.02775,71863,26.58501,270314
141,TobiasGoerke,75,0.02775,71938,26.61275,270314
142,adilhusain-s,74,0.02738,72012,26.64013,270314
143,AlanFokCo,74,0.02738,72086,26.66751,270314
144,cleveryg,74,0.02738,72160,26.69488,270314
145,KCFindstr,74,0.02738,72234,26.72226,270314
146,Ajay191191,73,0.02701,72307,26.74926,270314
147,YinguangZhao,73,0.02701,72380,26.77627,270314
148,AlexandreBrown,72,0.02664,72452,26.80290,270314
149,deadeyegoodwin,72,0.02664,72524,26.82954,270314
150,DeeperMind,72,0.02664,72596,26.85617,270314
151,dreamryx,72,0.02664,72668,26.88281,270314
152,willb,72,0.02664,72740,26.90945,270314
153,kd303,70,0.02590,72810,26.93534,270314
154,QxiaoQ,70,0.02590,72880,26.96124,270314
155,toshiiw,69,0.02553,72949,26.98676,270314
156,yixinshi,69,0.02553,73018,27.01229,270314
157,nkashy1,67,0.02479,73085,27.03708,270314
158,adriangonz,65,0.02405,73150,27.06112,270314
159,mofanke,65,0.02405,73215,27.08517,270314
160,radcheb,65,0.02405,73280,27.10921,270314
161,tingweiwu,65,0.02405,73345,27.13326,270314
162,AnyISalIn,63,0.02331,73408,27.15657,270314
163,d-gol,63,0.02331,73471,27.17987,270314
164,jay-saldanha,63,0.02331,73534,27.20318,270314
165,kelvins,62,0.02294,73596,27.22611,270314
166,SeibertronSS,62,0.02294,73658,27.24905,270314
167,heluocs,61,0.02257,73719,27.27162,270314
168,tomalbrecht,61,0.02257,73780,27.29418,270314
169,judahrand,60,0.02220,73840,27.31638,270314
170,edi-bice-by,59,0.02183,73899,27.33821,270314
171,akgraner,58,0.02146,73957,27.35966,270314
172,willingc,58,0.02146,74015,27.38112,270314
173,asispatra,57,0.02109,74072,27.40221,270314
174,HeGaoYuan,57,0.02109,74129,27.42329,270314
175,dwightjl,56,0.02072,74185,27.44401,270314
176,Ruminateer,56,0.02072,74241,27.46473,270314
177,tiru1930,56,0.02072,74297,27.48544,270314
178,OyutianO,55,0.02035,74352,27.50579,270314
179,PeterChg,55,0.02035,74407,27.52614,270314
180,raviranjan0309,55,0.02035,74462,27.54648,270314
181,boarder7395,54,0.01998,74516,27.56646,270314
182,axel7083,53,0.01961,74569,27.58607,270314
183,edenbuaa,53,0.01961,74622,27.60567,270314
184,kim-sardine,53,0.01961,74675,27.62528,270314
185,supertetelman,53,0.01961,74728,27.64489,270314
186,qiankunli,52,0.01924,74780,27.66412,270314
187,rummens,52,0.01924,74832,27.68336,270314
188,Realsen,51,0.01887,74883,27.70223,270314
189,TimZaman,51,0.01887,74934,27.72109,270314
190,ldcastell,50,0.01850,74984,27.73959,270314
191,Subreptivus,50,0.01850,75034,27.75809,270314
192,wdhorton,50,0.01850,75084,27.77659,270314
193,daikeshi,49,0.01813,75133,27.79471,270314
194,haomengchao,49,0.01813,75182,27.81284,270314
195,jdplatt,49,0.01813,75231,27.83097,270314
196,jsondai,48,0.01776,75279,27.84872,270314
197,prem0912,48,0.01776,75327,27.86648,270314
198,rarkins,48,0.01776,75375,27.88424,270314
199,sheevy,48,0.01776,75423,27.90200,270314
200,danishsamad,47,0.01739,75470,27.91938,270314
201,hsinhoyeh,47,0.01739,75517,27.93677,270314
202,PatrickGhosn,47,0.01739,75564,27.95416,270314
203,shotarok,47,0.01739,75611,27.97154,270314
204,Shuai-Xie,47,0.01739,75658,27.98893,270314
205,warf34,46,0.01702,75704,28.00595,270314
206,hlu09,45,0.01665,75749,28.02260,270314
207,wg102,45,0.01665,75794,28.03924,270314
208,yzhaozh,45,0.01665,75839,28.05589,270314
209,amitripshtos,44,0.01628,75883,28.07217,270314
210,Hmr-ramzi,44,0.01628,75927,28.08845,270314
211,shuesc1,44,0.01628,75971,28.10472,270314
212,wengyao04,44,0.01628,76015,28.12100,270314
213,fxue,43,0.01591,76058,28.13691,270314
214,hackerboy01,43,0.01591,76101,28.15281,270314
215,MATRIX4284,43,0.01591,76144,28.16872,270314
216,mpvartak,43,0.01591,76187,28.18463,270314
217,ssheng,43,0.01591,76230,28.20054,270314
218,bokleung,42,0.01554,76272,28.21607,270314
219,hmchen-github,42,0.01554,76314,28.23161,270314
220,jkuruba,42,0.01554,76356,28.24715,270314
221,ontheway16,42,0.01554,76398,28.26269,270314
222,TrsNium,42,0.01554,76440,28.27822,270314
223,ynqa,42,0.01554,76482,28.29376,270314
224,asahalyft,41,0.01517,76523,28.30893,270314
225,sunzhaochang,41,0.01517,76564,28.32410,270314
226,thedriftofwords,41,0.01517,76605,28.33926,270314
227,yph152,41,0.01517,76646,28.35443,270314
228,zlcnju,41,0.01517,76687,28.36960,270314
229,jsitu777,40,0.01480,76727,28.38440,270314
230,shikha130vv,39,0.01443,76766,28.39883,270314
231,haijohn,38,0.01406,76804,28.41288,270314
232,vinayan3,38,0.01406,76842,28.42694,270314
233,asdfsx,37,0.01369,76879,28.44063,270314
234,carolynwang,37,0.01369,76916,28.45432,270314
235,chinmay22897,37,0.01369,76953,28.46800,270314
236,devxoxo,37,0.01369,76990,28.48169,270314
237,lehrig,37,0.01369,77027,28.49538,270314
238,rbrishabh,37,0.01369,77064,28.50907,270314
239,tingshua-yts,37,0.01369,77101,28.52276,270314
240,votti,37,0.01369,77138,28.53644,270314
241,372046933,36,0.01332,77174,28.54976,270314
242,aaron-arellano,36,0.01332,77210,28.56308,270314
243,anneum,36,0.01332,77246,28.57640,270314
244,haibingzhao,36,0.01332,77282,28.58971,270314
245,jzp1025,36,0.01332,77318,28.60303,270314
246,pahask8,36,0.01332,77354,28.61635,270314
247,robbertvdg,36,0.01332,77390,28.62967,270314
248,vit-,36,0.01332,77426,28.64299,270314
249,yoni-taranis,36,0.01332,77462,28.65630,270314
250,codeflitting,35,0.01295,77497,28.66925,270314
251,jmsking,35,0.01295,77532,28.68220,270314
252,junyazhang,35,0.01295,77567,28.69515,270314
253,magencio,35,0.01295,77602,28.70810,270314
254,susan-shu-c,35,0.01295,77637,28.72104,270314
255,terrykong,35,0.01295,77672,28.73399,270314
256,yantriks-edi-bice,35,0.01295,77707,28.74694,270314
257,bartgras,34,0.01258,77741,28.75952,270314
258,libbyandhelen,34,0.01258,77775,28.77209,270314
259,plaffitte,34,0.01258,77809,28.78467,270314
260,royxue,34,0.01258,77843,28.79725,270314
261,seong7,34,0.01258,77877,28.80983,270314
262,shanidchamal,34,0.01258,77911,28.82241,270314
263,UrmsOne,34,0.01258,77945,28.83498,270314
264,Utkagr,34,0.01258,77979,28.84756,270314
265,axelgobletbdr,33,0.01221,78012,28.85977,270314
266,b4sus,33,0.01221,78045,28.87198,270314
267,ernestmartinez,33,0.01221,78078,28.88419,270314
268,leoncamel,33,0.01221,78111,28.89639,270314
269,rem20806,33,0.01221,78144,28.90860,270314
270,XinkaiWang515,33,0.01221,78177,28.92081,270314
271,ashahab,32,0.01184,78209,28.93265,270314
272,axelborja,32,0.01184,78241,28.94449,270314
273,b675987273,32,0.01184,78273,28.95632,270314
274,Dampolo03,32,0.01184,78305,28.96816,270314
275,IMBurbank,32,0.01184,78337,28.98000,270314
276,praveen049,32,0.01184,78369,28.99184,270314
277,rc-coderepo,32,0.01184,78401,29.00368,270314
278,tedhtchang,32,0.01184,78433,29.01552,270314
279,vaskokj,32,0.01184,78465,29.02735,270314
280,wuchunghsuan,32,0.01184,78497,29.03919,270314
281,yylin1,32,0.01184,78529,29.05103,270314
282,ccarpentiere,31,0.01147,78560,29.06250,270314
283,connected-bsamadi,31,0.01147,78591,29.07397,270314
284,daganida88,31,0.01147,78622,29.08543,270314
285,descampsk,31,0.01147,78653,29.09690,270314
286,dtrawins,31,0.01147,78684,29.10837,270314
287,janvdvegt,31,0.01147,78715,29.11984,270314
288,josepholaide,31,0.01147,78746,29.13131,270314
289,KingOnTheStar,31,0.01147,78777,29.14277,270314
290,Manvi07,31,0.01147,78808,29.15424,270314
291,slenky,31,0.01147,78839,29.16571,270314
292,arshashi,30,0.01110,78869,29.17681,270314
293,crmne,30,0.01110,78899,29.18791,270314
294,frozeNinK,30,0.01110,78929,29.19901,270314
295,pranavpandit1,30,0.01110,78959,29.21010,270314
296,sulabh2000,30,0.01110,78989,29.22120,270314
297,vanpelt,30,0.01110,79019,29.23230,270314
298,abkosar,29,0.01073,79048,29.24303,270314
299,judyheflin,29,0.01073,79077,29.25376,270314
300,kindomLee,29,0.01073,79106,29.26449,270314
301,marrrcin,29,0.01073,79135,29.27521,270314
302,cloudbow,28,0.01036,79163,29.28557,270314
303,dwhitena,28,0.01036,79191,29.29593,270314
304,gilbeckers,28,0.01036,79219,29.30629,270314
305,kevinb9n,28,0.01036,79247,29.31665,270314
306,MaanavD,28,0.01036,79275,29.32700,270314
307,marcindulak,28,0.01036,79303,29.33736,270314
308,mayankjuneja,28,0.01036,79331,29.34772,270314
309,mszacillo,28,0.01036,79359,29.35808,270314
310,oikomi,28,0.01036,79387,29.36844,270314
311,r-matsuzaka,28,0.01036,79415,29.37880,270314
312,simmscg,28,0.01036,79443,29.38915,270314
313,xiaoqiuh,28,0.01036,79471,29.39951,270314
314,631068264,27,0.00999,79498,29.40950,270314
315,alexandraj777,27,0.00999,79525,29.41949,270314
316,browningjp-datatonic,27,0.00999,79552,29.42948,270314
317,Josepholaidepetro,27,0.00999,79579,29.43947,270314
318,karthikvadla,27,0.00999,79606,29.44946,270314
319,kosehy,27,0.00999,79633,29.45944,270314
320,liujiashang,27,0.00999,79660,29.46943,270314
321,Shaked,27,0.00999,79687,29.47942,270314
322,ShilpaGopal,27,0.00999,79714,29.48941,270314
323,svalleru,27,0.00999,79741,29.49940,270314
324,ucdmkt,27,0.00999,79768,29.50939,270314
325,wyljpn,27,0.00999,79795,29.51937,270314
326,zhangchunsheng,27,0.00999,79822,29.52936,270314
327,zhixian82,27,0.00999,79849,29.53935,270314
328,amrobbins,26,0.00962,79875,29.54897,270314
329,devgrok,26,0.00962,79901,29.55859,270314
330,faweis,26,0.00962,79927,29.56821,270314
331,ianhellstrom,26,0.00962,79953,29.57782,270314
332,jacobmalmberg,26,0.00962,79979,29.58744,270314
333,jeremievallee,26,0.00962,80005,29.59706,270314
334,khoa-ho,26,0.00962,80031,29.60668,270314
335,micemuni,26,0.00962,80057,29.61630,270314
336,mtickoobb,26,0.00962,80083,29.62592,270314
337,NeoKish,26,0.00962,80109,29.63553,270314
338,pvgbabu,26,0.00962,80135,29.64515,270314
339,rky0930,26,0.00962,80161,29.65477,270314
340,rtrobin,26,0.00962,80187,29.66439,270314
341,saffaalvi,26,0.00962,80213,29.67401,270314
342,shalberd,26,0.00962,80239,29.68363,270314
343,thuzhf,26,0.00962,80265,29.69325,270314
344,valentin-stefan-popa,26,0.00962,80291,29.70286,270314
345,wyong16,26,0.00962,80317,29.71248,270314
346,ysk24ok,26,0.00962,80343,29.72210,270314
347,alsrgv,25,0.00925,80368,29.73135,270314
348,capt2101akash,25,0.00925,80393,29.74060,270314
349,czheng94,25,0.00925,80418,29.74985,270314
350,decewei,25,0.00925,80443,29.75909,270314
351,majorinche,25,0.00925,80468,29.76834,270314
352,panchul,25,0.00925,80493,29.77759,270314
353,samuelvl,25,0.00925,80518,29.78684,270314
354,solovyevt,25,0.00925,80543,29.79609,270314
355,ssiegel95,25,0.00925,80568,29.80534,270314
356,tmckayus,25,0.00925,80593,29.81459,270314
357,BobLiu20,24,0.00888,80617,29.82346,270314
358,dalbhanj,24,0.00888,80641,29.83234,270314
359,Eric-Zhang1990,24,0.00888,80665,29.84122,270314
360,g-votte,24,0.00888,80689,29.85010,270314
361,JavaDerek,24,0.00888,80713,29.85898,270314
362,jiwang576,24,0.00888,80737,29.86786,270314
363,JohnPaton,24,0.00888,80761,29.87674,270314
364,kvalev,24,0.00888,80785,29.88561,270314
365,Peilun-Li,24,0.00888,80809,29.89449,270314
366,pvsousalima,24,0.00888,80833,29.90337,270314
367,ryantd,24,0.00888,80857,29.91225,270314
368,swamat,24,0.00888,80881,29.92113,270314
369,Windfarer,24,0.00888,80905,29.93001,270314
370,alongzhi,23,0.00851,80928,29.93852,270314
371,athamark,23,0.00851,80951,29.94702,270314
372,BenzhaminKim,23,0.00851,80974,29.95553,270314
373,chinhuang007,23,0.00851,80997,29.96404,270314
374,grobbie,23,0.00851,81020,29.97255,270314
375,huixa,23,0.00851,81043,29.98106,270314
376,jokerwenxiao,23,0.00851,81066,29.98957,270314
377,mai-nakagawa,23,0.00851,81089,29.99808,270314
378,matthen,23,0.00851,81112,30.00658,270314
379,owlet42,23,0.00851,81135,30.01509,270314
380,suned,23,0.00851,81158,30.02360,270314
381,umialpha,23,0.00851,81181,30.03211,270314
382,umka1332,23,0.00851,81204,30.04062,270314
383,Aaronchoo,22,0.00814,81226,30.04876,270314
384,acesir,22,0.00814,81248,30.05690,270314
385,chaowangnk1,22,0.00814,81270,30.06504,270314
386,cndaimin,22,0.00814,81292,30.07317,270314
387,DanaHan,22,0.00814,81314,30.08131,270314
388,Felihong,22,0.00814,81336,30.08945,270314
389,grapefruitL,22,0.00814,81358,30.09759,270314
390,jwwandy,22,0.00814,81380,30.10573,270314
391,kramachandran,22,0.00814,81402,30.11387,270314
392,LEDfan,22,0.00814,81424,30.12201,270314
393,maanur,22,0.00814,81446,30.13014,270314
394,marwan116,22,0.00814,81468,30.13828,270314
395,mvartakAtVerta,22,0.00814,81490,30.14642,270314
396,ogre0403,22,0.00814,81512,30.15456,270314
397,prcastro,22,0.00814,81534,30.16270,270314
398,sahilmalav,22,0.00814,81556,30.17084,270314
399,vtlrazin,22,0.00814,81578,30.17898,270314
400,yinghsienwu,22,0.00814,81600,30.18712,270314
401,yurkoff-mv,22,0.00814,81622,30.19525,270314
402,AK-ayush,21,0.00777,81643,30.20302,270314
403,amalts,21,0.00777,81664,30.21079,270314
404,bvboca,21,0.00777,81685,30.21856,270314
405,Chaos-Ju,21,0.00777,81706,30.22633,270314
406,chongchuanbing,21,0.00777,81727,30.23410,270314
407,dzungductran,21,0.00777,81748,30.24187,270314
408,hiyangbo,21,0.00777,81769,30.24964,270314
409,jizg,21,0.00777,81790,30.25740,270314
410,Julianxo,21,0.00777,81811,30.26517,270314
411,kbentaleb,21,0.00777,81832,30.27294,270314
412,kweinmeister,21,0.00777,81853,30.28071,270314
413,mfojtak,21,0.00777,81874,30.28848,270314
414,Ursanon,21,0.00777,81895,30.29625,270314
415,vaskozl,21,0.00777,81916,30.30402,270314
416,akchinSTC,20,0.00740,81936,30.31142,270314
417,ankan94,20,0.00740,81956,30.31881,270314
418,Arvind-Ideas2IT,20,0.00740,81976,30.32621,270314
419,dilzeem,20,0.00740,81996,30.33361,270314
420,happyhuman,20,0.00740,82016,30.34101,270314
421,kandrio98,20,0.00740,82036,30.34841,270314
422,Luke035,20,0.00740,82056,30.35581,270314
423,matty1979,20,0.00740,82076,30.36321,270314
424,michaelliqx,20,0.00740,82096,30.37061,270314
425,otaviocv,20,0.00740,82116,30.37800,270314
426,tanguycdls,20,0.00740,82136,30.38540,270314
427,ulrikpl,20,0.00740,82156,30.39280,270314
428,xiaohanhuang,20,0.00740,82176,30.40020,270314
429,yassine-labidi,20,0.00740,82196,30.40760,270314
430,YesterdayxD,20,0.00740,82216,30.41500,270314
431,alexeykaplin,19,0.00703,82235,30.42203,270314
432,anifort,19,0.00703,82254,30.42906,270314
433,arllanos,19,0.00703,82273,30.43609,270314
434,CBischke,19,0.00703,82292,30.44311,270314
435,FlempTW,19,0.00703,82311,30.45014,270314
436,georgkaleido,19,0.00703,82330,30.45717,270314
437,hno2,19,0.00703,82349,30.46420,270314
438,Iuiu1234,19,0.00703,82368,30.47123,270314
439,jmdevcs,19,0.00703,82387,30.47826,270314
440,lqj679ssn,19,0.00703,82406,30.48529,270314
441,plang85,19,0.00703,82425,30.49232,270314
442,pselden,19,0.00703,82444,30.49935,270314
443,smsperitus,19,0.00703,82463,30.50637,270314
444,strawberrypie,19,0.00703,82482,30.51340,270314
445,Syntax3rror404,19,0.00703,82501,30.52043,270314
446,szinck1,19,0.00703,82520,30.52746,270314
447,tarat44,19,0.00703,82539,30.53449,270314
448,ytetra,19,0.00703,82558,30.54152,270314
449,aakashbajaj,18,0.00666,82576,30.54818,270314
450,allenc97,18,0.00666,82594,30.55484,270314
451,allenzfan,18,0.00666,82612,30.56150,270314
452,cfregly,18,0.00666,82630,30.56815,270314
453,chauvenne,18,0.00666,82648,30.57481,270314
454,Davidnet,18,0.00666,82666,30.58147,270314
455,dhodun,18,0.00666,82684,30.58813,270314
456,hellobiek,18,0.00666,82702,30.59479,270314
457,himanshu9345,18,0.00666,82720,30.60145,270314
458,hitesh1907nayyar,18,0.00666,82738,30.60811,270314
459,jspenc72,18,0.00666,82756,30.61477,270314
460,juangon,18,0.00666,82774,30.62143,270314
461,leela-uppuluri,18,0.00666,82792,30.62808,270314
462,leonardosul,18,0.00666,82810,30.63474,270314
463,meibenjin,18,0.00666,82828,30.64140,270314
464,mochiliu3000,18,0.00666,82846,30.64806,270314
465,opus111,18,0.00666,82864,30.65472,270314
466,pthalasta,18,0.00666,82882,30.66138,270314
467,ptitzler,18,0.00666,82900,30.66804,270314
468,rimolive,18,0.00666,82918,30.67470,270314
469,Rishit-dagli,18,0.00666,82936,30.68136,270314
470,SebBlin,18,0.00666,82954,30.68801,270314
471,SpontaneousDuck,18,0.00666,82972,30.69467,270314
472,tcnt,18,0.00666,82990,30.70133,270314
473,vsk2015,18,0.00666,83008,30.70799,270314
474,wardVD,18,0.00666,83026,30.71465,270314
475,zoux86,18,0.00666,83044,30.72131,270314
476,andre-lx,17,0.00629,83061,30.72760,270314
477,cyzhangchenya,17,0.00629,83078,30.73389,270314
478,deepdad,17,0.00629,83095,30.74018,270314
479,dpoulopoulos,17,0.00629,83112,30.74647,270314
480,jiaxuanzhou,17,0.00629,83129,30.75275,270314
481,Junaid-Ahmed94,17,0.00629,83146,30.75904,270314
482,ketangangal,17,0.00629,83163,30.76533,270314
483,kunalyogenshah,17,0.00629,83180,30.77162,270314
484,larssuanet,17,0.00629,83197,30.77791,270314
485,panpanli521,17,0.00629,83214,30.78420,270314
486,portellaa,17,0.00629,83231,30.79049,270314
487,PrathamSolanki,17,0.00629,83248,30.79678,270314
488,sadeel,17,0.00629,83265,30.80307,270314
489,SimonCqk,17,0.00629,83282,30.80936,270314
490,sm-hawkfish,17,0.00629,83299,30.81564,270314
491,wjddyd66,17,0.00629,83316,30.82193,270314
492,andreafehrman,16,0.00592,83332,30.82785,270314
493,ChenjunZou,16,0.00592,83348,30.83377,270314
494,chethanmahadevaiah,16,0.00592,83364,30.83969,270314
495,ckchow,16,0.00592,83380,30.84561,270314
496,fdasilva59,16,0.00592,83396,30.85153,270314
497,gabornyerges,16,0.00592,83412,30.85745,270314
498,gabrielvcbessa,16,0.00592,83428,30.86337,270314
499,gogogwwb,16,0.00592,83444,30.86929,270314
500,hackenzheng,16,0.00592,83460,30.87520,270314
501,halvgaard,16,0.00592,83476,30.88112,270314
502,jobvarkey,16,0.00592,83492,30.88704,270314
503,kairos03,16,0.00592,83508,30.89296,270314
504,meizabel,16,0.00592,83524,30.89888,270314
505,melihsqsp,16,0.00592,83540,30.90480,270314
506,mmatiaschek,16,0.00592,83556,30.91072,270314
507,narennadig,16,0.00592,83572,30.91664,270314
508,prasadkyp7,16,0.00592,83588,30.92256,270314
509,RDelg,16,0.00592,83604,30.92848,270314
510,Rohithzr,16,0.00592,83620,30.93439,270314
511,solarist,16,0.00592,83636,30.94031,270314
512,TaylorHere,16,0.00592,83652,30.94623,270314
513,typeness,16,0.00592,83668,30.95215,270314
514,wadhah101,16,0.00592,83684,30.95807,270314
515,wenmin-wu,16,0.00592,83700,30.96399,270314
516,zzmao,16,0.00592,83716,30.96991,270314
517,AGKhalil,15,0.00555,83731,30.97546,270314
518,aheeruru,15,0.00555,83746,30.98101,270314
519,Akashdesarda,15,0.00555,83761,30.98656,270314
520,bkungfoo,15,0.00555,83776,30.99211,270314
521,chetanoruganti,15,0.00555,83791,30.99765,270314
522,ChethanUK,15,0.00555,83806,31.00320,270314
523,dagondagon666,15,0.00555,83821,31.00875,270314
524,dalfos,15,0.00555,83836,31.01430,270314
525,dkajtoch,15,0.00555,83851,31.01985,270314
526,edwardzjl,15,0.00555,83866,31.02540,270314
527,HongHuangNeu,15,0.00555,83881,31.03095,270314
528,johnmacnamararseg,15,0.00555,83896,31.03650,270314
529,kimkihoon0515,15,0.00555,83911,31.04205,270314
530,knave07,15,0.00555,83926,31.04760,270314
531,kpouget,15,0.00555,83941,31.05315,270314
532,LearnKen,15,0.00555,83956,31.05869,270314
533,martialblog,15,0.00555,83971,31.06424,270314
534,mkkb473,15,0.00555,83986,31.06979,270314
535,mohona17,15,0.00555,84001,31.07534,270314
536,mokpolar,15,0.00555,84016,31.08089,270314
537,neolunar7,15,0.00555,84031,31.08644,270314
538,omesser,15,0.00555,84046,31.09199,270314
539,rostam-github,15,0.00555,84061,31.09754,270314
540,RudraprakashR,15,0.00555,84076,31.10309,270314
541,sameerbhadouria,15,0.00555,84091,31.10864,270314
542,SheharyarTkxel,15,0.00555,84106,31.11419,270314
543,sports75482,15,0.00555,84121,31.11973,270314
544,summerisc,15,0.00555,84136,31.12528,270314
545,tretos53,15,0.00555,84151,31.13083,270314
546,vackysh,15,0.00555,84166,31.13638,270314
547,wajeehulhassanvii,15,0.00555,84181,31.14193,270314
548,wronk,15,0.00555,84196,31.14748,270314
549,wstian,15,0.00555,84211,31.15303,270314
550,yuhuishi-convect,15,0.00555,84226,31.15858,270314
551,yuku,15,0.00555,84241,31.16413,270314
552,zxsimple,15,0.00555,84256,31.16968,270314
553,aarondietz234,14,0.00518,84270,31.17486,270314
554,aleb,14,0.00518,84284,31.18004,270314
555,alexiguazio,14,0.00518,84298,31.18521,270314
556,anjalisood,14,0.00518,84312,31.19039,270314
557,BBK-PiJ-2015-41,14,0.00518,84326,31.19557,270314
558,CraigSterrett,14,0.00518,84340,31.20075,270314
559,dandawg,14,0.00518,84354,31.20593,270314
560,dav009,14,0.00518,84368,31.21111,270314
561,DdMad,14,0.00518,84382,31.21629,270314
562,doschkinow,14,0.00518,84396,31.22147,270314
563,edhenry,14,0.00518,84410,31.22665,270314
564,Everret-moon,14,0.00518,84424,31.23183,270314
565,farisfirenze,14,0.00518,84438,31.23701,270314
566,Farrellow,14,0.00518,84452,31.24219,270314
567,fyuan1316,14,0.00518,84466,31.24736,270314
568,GarnettWang,14,0.00518,84480,31.25254,270314
569,gogasca,14,0.00518,84494,31.25772,270314
570,gracechristina,14,0.00518,84508,31.26290,270314
571,gregbarkerdcsg,14,0.00518,84522,31.26808,270314
572,guanhuichen,14,0.00518,84536,31.27326,270314
573,hwk42,14,0.00518,84550,31.27844,270314
574,hyche,14,0.00518,84564,31.28362,270314
575,iuiu34,14,0.00518,84578,31.28880,270314
576,jiahaoc1993,14,0.00518,84592,31.29398,270314
577,jiuntian,14,0.00518,84606,31.29916,270314
578,jpatanooga,14,0.00518,84620,31.30433,270314
579,jrykr,14,0.00518,84634,31.30951,270314
580,kangwoo,14,0.00518,84648,31.31469,270314
581,Maerville,14,0.00518,84662,31.31987,270314
582,nlarusstone,14,0.00518,84676,31.32505,270314
583,post2web,14,0.00518,84690,31.33023,270314
584,Rstar1998,14,0.00518,84704,31.33541,270314
585,ryan-williams,14,0.00518,84718,31.34059,270314
586,sabiroid,14,0.00518,84732,31.34577,270314
587,skogsbrus,14,0.00518,84746,31.35095,270314
588,tlkh,14,0.00518,84760,31.35613,270314
589,toyow,14,0.00518,84774,31.36131,270314
590,wangkeqiang123,14,0.00518,84788,31.36648,270314
591,xawangyd,14,0.00518,84802,31.37166,270314
592,xiaowenxie5,14,0.00518,84816,31.37684,270314
593,Youki,14,0.00518,84830,31.38202,270314
594,zoyun,14,0.00518,84844,31.38720,270314
595,Adarsh2910,13,0.00481,84857,31.39201,270314
596,alexisgaziello,13,0.00481,84870,31.39682,270314
597,ammarn911,13,0.00481,84883,31.40163,270314
598,anatolyzolotar,13,0.00481,84896,31.40644,270314
599,andrewsmartin,13,0.00481,84909,31.41125,270314
600,benoitdr,13,0.00481,84922,31.41606,270314
601,charlescurt,13,0.00481,84935,31.42087,270314
602,chingandy,13,0.00481,84948,31.42568,270314
603,DanielQujun,13,0.00481,84961,31.43048,270314
604,deepio-oc,13,0.00481,84974,31.43529,270314
605,deepyaman,13,0.00481,84987,31.44010,270314
606,dpaks,13,0.00481,85000,31.44491,270314
607,fboylu,13,0.00481,85013,31.44972,270314
608,fischor,13,0.00481,85026,31.45453,270314
609,gaodan-fang,13,0.00481,85039,31.45934,270314
610,hexiaoting,13,0.00481,85052,31.46415,270314
611,imiller445,13,0.00481,85065,31.46896,270314
612,jlzhao27,13,0.00481,85078,31.47377,270314
613,jmendesky,13,0.00481,85091,31.47858,270314
614,jq,13,0.00481,85104,31.48339,270314
615,kamalmemon,13,0.00481,85117,31.48820,270314
616,kimchitsigai,13,0.00481,85130,31.49300,270314
617,krajasek,13,0.00481,85143,31.49781,270314
618,kylepad,13,0.00481,85156,31.50262,270314
619,lcax200000,13,0.00481,85169,31.50743,270314
620,Lijo050,13,0.00481,85182,31.51224,270314
621,ljainker,13,0.00481,85195,31.51705,270314
622,LuChengTHU,13,0.00481,85208,31.52186,270314
623,LY-today,13,0.00481,85221,31.52667,270314
624,m-mayran,13,0.00481,85234,31.53148,270314
625,mockdone,13,0.00481,85247,31.53629,270314
626,mosn,13,0.00481,85260,31.54110,270314
627,mttcnnff,13,0.00481,85273,31.54591,270314
628,myonlyzzy,13,0.00481,85286,31.55072,270314
629,nachogarciam,13,0.00481,85299,31.55552,270314
630,NKUCodingCat,13,0.00481,85312,31.56033,270314
631,ohke,13,0.00481,85325,31.56514,270314
632,pablofiumara-azumo,13,0.00481,85338,31.56995,270314
633,riklopfer,13,0.00481,85351,31.57476,270314
634,RunOrVeith,13,0.00481,85364,31.57957,270314
635,rustam-ashurov-mcx,13,0.00481,85377,31.58438,270314
636,SarathChandran,13,0.00481,85390,31.58919,270314
637,Shasvat0601,13,0.00481,85403,31.59400,270314
638,sidpalas,13,0.00481,85416,31.59881,270314
639,TrevorM15,13,0.00481,85429,31.60362,270314
640,webD97,13,0.00481,85442,31.60843,270314
641,XXXXIEHF,13,0.00481,85455,31.61323,270314
642,yingding,13,0.00481,85468,31.61804,270314
643,ykeuter,13,0.00481,85481,31.62285,270314
644,0olwzo0,12,0.00444,85493,31.62729,270314
645,abaland,12,0.00444,85505,31.63173,270314
646,aeoluswing,12,0.00444,85517,31.63617,270314
647,aginpatrick,12,0.00444,85529,31.64061,270314
648,alexeygorobets,12,0.00444,85541,31.64505,270314
649,alexwennerberg,12,0.00444,85553,31.64949,270314
650,algs,12,0.00444,85565,31.65393,270314
651,AseiSugiyama,12,0.00444,85577,31.65837,270314
652,Aut0R3V,12,0.00444,85589,31.66281,270314
653,bdoohan-goog,12,0.00444,85601,31.66725,270314
654,bencwallace,12,0.00444,85613,31.67169,270314
655,BeneaAlinAndrei,12,0.00444,85625,31.67612,270314
656,bermudezmt,12,0.00444,85637,31.68056,270314
657,bwassie,12,0.00444,85649,31.68500,270314
658,davidyuyuan,12,0.00444,85661,31.68944,270314
659,dhanisahu,12,0.00444,85673,31.69388,270314
660,DontStopMeNow,12,0.00444,85685,31.69832,270314
661,dstnluong,12,0.00444,85697,31.70276,270314
662,enriquedacostacambio,12,0.00444,85709,31.70720,270314
663,gar1t,12,0.00444,85721,31.71164,270314
664,GerardoGR,12,0.00444,85733,31.71608,270314
665,hefedev,12,0.00444,85745,31.72052,270314
666,hyeonsangjeon,12,0.00444,85757,31.72496,270314
667,Intellicode,12,0.00444,85769,31.72940,270314
668,Itega,12,0.00444,85781,31.73384,270314
669,izapolsk,12,0.00444,85793,31.73827,270314
670,javen218,12,0.00444,85805,31.74271,270314
671,jdumm,12,0.00444,85817,31.74715,270314
672,jidemoski,12,0.00444,85829,31.75159,270314
673,jmalobicky,12,0.00444,85841,31.75603,270314
674,kbthu,12,0.00444,85853,31.76047,270314
675,lauradang,12,0.00444,85865,31.76491,270314
676,Lejboelle,12,0.00444,85877,31.76935,270314
677,lomori,12,0.00444,85889,31.77379,270314
678,Lordfourteen,12,0.00444,85901,31.77823,270314
679,meowcakes,12,0.00444,85913,31.78267,270314
680,Mithil467,12,0.00444,85925,31.78711,270314
681,Nagarajj,12,0.00444,85937,31.79155,270314
682,nihir27,12,0.00444,85949,31.79599,270314
683,nikhil-koul,12,0.00444,85961,31.80042,270314
684,nitesh31mishra,12,0.00444,85973,31.80486,270314
685,nongqiqin,12,0.00444,85985,31.80930,270314
686,ocherfas,12,0.00444,85997,31.81374,270314
687,owennewo,12,0.00444,86009,31.81818,270314
688,pshiko,12,0.00444,86021,31.82262,270314
689,raddaoui,12,0.00444,86033,31.82706,270314
690,RakeshRaj97,12,0.00444,86045,31.83150,270314
691,romeokienzler,12,0.00444,86057,31.83594,270314
692,shivaylamba,12,0.00444,86069,31.84038,270314
693,sid027,12,0.00444,86081,31.84482,270314
694,tkatila,12,0.00444,86093,31.84926,270314
695,TomomasaTakatori,12,0.00444,86105,31.85370,270314
696,travishen,12,0.00444,86117,31.85814,270314
697,virgoaugustine,12,0.00444,86129,31.86257,270314
698,vvnpan,12,0.00444,86141,31.86701,270314
699,wallacezzzzz007,12,0.00444,86153,31.87145,270314
700,WangAllen851018,12,0.00444,86165,31.87589,270314
701,WEICHINLIN,12,0.00444,86177,31.88033,270314
702,yiyuanyu17,12,0.00444,86189,31.88477,270314
703,zidarko,12,0.00444,86201,31.88921,270314
704,zsaladin,12,0.00444,86213,31.89365,270314
705,zuston,12,0.00444,86225,31.89809,270314
706,aalugore-ai,11,0.00407,86236,31.90216,270314
707,ahsan-n,11,0.00407,86247,31.90623,270314
708,alforik,11,0.00407,86258,31.91030,270314
709,allenwux,11,0.00407,86269,31.91437,270314
710,amybachir,11,0.00407,86280,31.91844,270314
711,andrewm4894,11,0.00407,86291,31.92250,270314
712,bbarnes52,11,0.00407,86302,31.92657,270314
713,berlinsaint,11,0.00407,86313,31.93064,270314
714,bsikander,11,0.00407,86324,31.93471,270314
715,cc-gb2,11,0.00407,86335,31.93878,270314
716,chaoleili,11,0.00407,86346,31.94285,270314
717,dkurt,11,0.00407,86357,31.94692,270314
718,dongdan39,11,0.00407,86368,31.95099,270314
719,durandom,11,0.00407,86379,31.95506,270314
720,eggiter,11,0.00407,86390,31.95913,270314
721,Eliacus,11,0.00407,86401,31.96320,270314
722,gangliao,11,0.00407,86412,31.96727,270314
723,goldwinner,11,0.00407,86423,31.97134,270314
724,gosandhya,11,0.00407,86434,31.97541,270314
725,haudren,11,0.00407,86445,31.97948,270314
726,hmc-cs-mdrissi,11,0.00407,86456,31.98355,270314
727,iankoulski,11,0.00407,86467,31.98761,270314
728,jagane-infinstor,11,0.00407,86478,31.99168,270314
729,JakeSummers,11,0.00407,86489,31.99575,270314
730,kavemun,11,0.00407,86500,31.99982,270314
731,konsloiz,11,0.00407,86511,32.00389,270314
732,ksonbol,11,0.00407,86522,32.00796,270314
733,kuikuikuizzZ,11,0.00407,86533,32.01203,270314
734,luckyskg,11,0.00407,86544,32.01610,270314
735,lwj1980s,11,0.00407,86555,32.02017,270314
736,Mar-ai,11,0.00407,86566,32.02424,270314
737,marcjimz,11,0.00407,86577,32.02831,270314
738,MingfeiPan,11,0.00407,86588,32.03238,270314
739,mishraprafful,11,0.00407,86599,32.03645,270314
740,o0fatigue,11,0.00407,86610,32.04052,270314
741,omartin2010,11,0.00407,86621,32.04459,270314
742,Pallavi-28,11,0.00407,86632,32.04865,270314
743,ra312,11,0.00407,86643,32.05272,270314
744,rawkintrevo,11,0.00407,86654,32.05679,270314
745,reem,11,0.00407,86665,32.06086,270314
746,rionam,11,0.00407,86676,32.06493,270314
747,rrrkharse,11,0.00407,86687,32.06900,270314
748,SatwikBhandiwad,11,0.00407,86698,32.07307,270314
749,shikajiro,11,0.00407,86709,32.07714,270314
750,soleares,11,0.00407,86720,32.08121,270314
751,songm28,11,0.00407,86731,32.08528,270314
752,soyuutaku,11,0.00407,86742,32.08935,270314
753,sshakeri,11,0.00407,86753,32.09342,270314
754,sunilfernandes,11,0.00407,86764,32.09749,270314
755,tarrade,11,0.00407,86775,32.10156,270314
756,thliang01,11,0.00407,86786,32.10563,270314
757,ThomaswellY,11,0.00407,86797,32.10969,270314
758,tinyma123,11,0.00407,86808,32.11376,270314
759,ultrons,11,0.00407,86819,32.11783,270314
760,vijay-nag,11,0.00407,86830,32.12190,270314
761,vmallya-123,11,0.00407,86841,32.12597,270314
762,VoVAllen,11,0.00407,86852,32.13004,270314
763,whillas,11,0.00407,86863,32.13411,270314
764,yanp,11,0.00407,86874,32.13818,270314
765,ytsophie,11,0.00407,86885,32.14225,270314
766,41tair,10,0.00370,86895,32.14595,270314
767,achalshant,10,0.00370,86905,32.14965,270314
768,Aiden-Jeon,10,0.00370,86915,32.15335,270314
769,axeltidemann,10,0.00370,86925,32.15705,270314
770,bestowjay,10,0.00370,86935,32.16075,270314
771,blacksailer,10,0.00370,86945,32.16445,270314
772,cbreuel,10,0.00370,86955,32.16815,270314
773,clausagerskov,10,0.00370,86965,32.17184,270314
774,Corea,10,0.00370,86975,32.17554,270314
775,Crazybean-lwb,10,0.00370,86985,32.17924,270314
776,dynofu,10,0.00370,86995,32.18294,270314
777,fahadh4ilyas,10,0.00370,87005,32.18664,270314
778,fakeburst,10,0.00370,87015,32.19034,270314
779,FaustineLi,10,0.00370,87025,32.19404,270314
780,goodoid,10,0.00370,87035,32.19774,270314
781,haghabozorgi,10,0.00370,87045,32.20144,270314
782,harshad16,10,0.00370,87055,32.20514,270314
783,iamshwin,10,0.00370,87065,32.20884,270314
784,insoo67park,10,0.00370,87075,32.21254,270314
785,JetMuffin,10,0.00370,87085,32.21624,270314
786,Jose-Matsuda,10,0.00370,87095,32.21994,270314
787,josiemundi,10,0.00370,87105,32.22364,270314
788,jszanto,10,0.00370,87115,32.22734,270314
789,krish0005,10,0.00370,87125,32.23104,270314
790,LinuxDevSecOps,10,0.00370,87135,32.23473,270314
791,LSC527,10,0.00370,87145,32.23843,270314
792,lvcaiping,10,0.00370,87155,32.24213,270314
793,martham93,10,0.00370,87165,32.24583,270314
794,marwanfahmi,10,0.00370,87175,32.24953,270314
795,MatthiasCarnein,10,0.00370,87185,32.25323,270314
796,mengdong,10,0.00370,87195,32.25693,270314
797,MeranaTona,10,0.00370,87205,32.26063,270314
798,metrofun,10,0.00370,87215,32.26433,270314
799,mmwebster,10,0.00370,87225,32.26803,270314
800,moey920,10,0.00370,87235,32.27173,270314
801,MohammadOmr,10,0.00370,87245,32.27543,270314
802,NicoG94,10,0.00370,87255,32.27913,270314
803,nihil0,10,0.00370,87265,32.28283,270314
804,omlomloml,10,0.00370,87275,32.28653,270314
805,pavanaiyar,10,0.00370,87285,32.29023,270314
806,pineking,10,0.00370,87295,32.29392,270314
807,pretidav,10,0.00370,87305,32.29762,270314
808,ReyRen,10,0.00370,87315,32.30132,270314
809,robertzsun-dev,10,0.00370,87325,32.30502,270314
810,RoyerRamirez,10,0.00370,87335,32.30872,270314
811,Rustastra,10,0.00370,87345,32.31242,270314
812,saumilsdk,10,0.00370,87355,32.31612,270314
813,sdf611097,10,0.00370,87365,32.31982,270314
814,sh0gg0th,10,0.00370,87375,32.32352,270314
815,Sharon-iguazio,10,0.00370,87385,32.32722,270314
816,SumLare,10,0.00370,87395,32.33092,270314
817,sunnythepatel,10,0.00370,87405,32.33462,270314
818,tarjintor,10,0.00370,87415,32.33832,270314
819,thebinaryone1,10,0.00370,87425,32.34202,270314
820,tholop,10,0.00370,87435,32.34572,270314
821,tranlyvu,10,0.00370,87445,32.34942,270314
822,TranThanh96,10,0.00370,87455,32.35312,270314
823,tsuiot,10,0.00370,87465,32.35681,270314
824,typhoonzero,10,0.00370,87475,32.36051,270314
825,wangzewang,10,0.00370,87485,32.36421,270314
826,wilbry,10,0.00370,87495,32.36791,270314
827,wjhhuizi,10,0.00370,87505,32.37161,270314
828,xiaoxq,10,0.00370,87515,32.37531,270314
829,xybuty,10,0.00370,87525,32.37901,270314
830,yangyang919,10,0.00370,87535,32.38271,270314
831,zhangle-dev,10,0.00370,87545,32.38641,270314
832,3a78f807111,9,0.00333,87554,32.38974,270314
833,3dimaging,9,0.00333,87563,32.39307,270314
834,4everming,9,0.00333,87572,32.39640,270314
835,adepuravikrishna,9,0.00333,87581,32.39973,270314
836,akdigitalself,9,0.00333,87590,32.40306,270314
837,alicelee0606,9,0.00333,87599,32.40639,270314
838,allendred,9,0.00333,87608,32.40972,270314
839,alokumar1,9,0.00333,87617,32.41305,270314
840,AnberLu,9,0.00333,87626,32.41638,270314
841,andrewgdavis,9,0.00333,87635,32.41970,270314
842,arunnalpet,9,0.00333,87644,32.42303,270314
843,axelmagn,9,0.00333,87653,32.42636,270314
844,BioGeek,9,0.00333,87662,32.42969,270314
845,bruce3557,9,0.00333,87671,32.43302,270314
846,cabjr,9,0.00333,87680,32.43635,270314
847,cah-parita-desai,9,0.00333,87689,32.43968,270314
848,ChaseLyall,9,0.00333,87698,32.44301,270314
849,crosvera,9,0.00333,87707,32.44634,270314
850,csachs,9,0.00333,87716,32.44967,270314
851,cwei44,9,0.00333,87725,32.45300,270314
852,D0m021ng,9,0.00333,87734,32.45633,270314
853,danieldn,9,0.00333,87743,32.45966,270314
854,deathemperor,9,0.00333,87752,32.46299,270314
855,dutingda,9,0.00333,87761,32.46632,270314
856,eavelardev,9,0.00333,87770,32.46965,270314
857,edu-ap,9,0.00333,87779,32.47298,270314
858,evonit,9,0.00333,87788,32.47631,270314
859,ezioliao,9,0.00333,87797,32.47963,270314
860,FrancisLfg,9,0.00333,87806,32.48296,270314
861,gymaganis,9,0.00333,87815,32.48629,270314
862,ijackcy,9,0.00333,87824,32.48962,270314
863,IreneGi,9,0.00333,87833,32.49295,270314
864,IvyBazan,9,0.00333,87842,32.49628,270314
865,jalola,9,0.00333,87851,32.49961,270314
866,JessicaBarh,9,0.00333,87860,32.50294,270314
867,jinxingwang,9,0.00333,87869,32.50627,270314
868,joey100,9,0.00333,87878,32.50960,270314
869,johan-andersson01,9,0.00333,87887,32.51293,270314
870,jsnowacki,9,0.00333,87896,32.51626,270314
871,kevin85421,9,0.00333,87905,32.51959,270314
872,l1990790120,9,0.00333,87914,32.52292,270314
873,liuqi,9,0.00333,87923,32.52625,270314
874,lsuanet,9,0.00333,87932,32.52958,270314
875,martin-laurent,9,0.00333,87941,32.53291,270314
876,MenglingD,9,0.00333,87950,32.53624,270314
877,mhbuehler,9,0.00333,87959,32.53957,270314
878,migueltol22,9,0.00333,87968,32.54289,270314
879,mike0355,9,0.00333,87977,32.54622,270314
880,mikwieczorek,9,0.00333,87986,32.54955,270314
881,mojokb,9,0.00333,87995,32.55288,270314
882,molejnik-mergebit,9,0.00333,88004,32.55621,270314
883,monkey3199,9,0.00333,88013,32.55954,270314
884,motilalmeher,9,0.00333,88022,32.56287,270314
885,mukul-shaunik-nokia,9,0.00333,88031,32.56620,270314
886,netankit,9,0.00333,88040,32.56953,270314
887,padrian2s,9,0.00333,88049,32.57286,270314
888,PascalSchroederDE,9,0.00333,88058,32.57619,270314
889,person142,9,0.00333,88067,32.57952,270314
890,pjo256,9,0.00333,88076,32.58285,270314
891,prgawade,9,0.00333,88085,32.58618,270314
892,pvnguyen,9,0.00333,88094,32.58951,270314
893,romanzdk,9,0.00333,88103,32.59284,270314
894,SachinT95,9,0.00333,88112,32.59617,270314
895,sammy04,9,0.00333,88121,32.59950,270314
896,sarrourajerbi,9,0.00333,88130,32.60282,270314
897,shuaibiyy,9,0.00333,88139,32.60615,270314
898,speaknowpotato,9,0.00333,88148,32.60948,270314
899,statmike,9,0.00333,88157,32.61281,270314
900,tks-ai,9,0.00333,88166,32.61614,270314
901,twittidai,9,0.00333,88175,32.61947,270314
902,VaishnaviHire,9,0.00333,88184,32.62280,270314
903,vladislavkoz,9,0.00333,88193,32.62613,270314
904,wanglj-lanzer,9,0.00333,88202,32.62946,270314
905,wynn5a,9,0.00333,88211,32.63279,270314
906,zuowang,9,0.00333,88220,32.63612,270314
907,814HiManny,8,0.00296,88228,32.63908,270314
908,AahanSingh,8,0.00296,88236,32.64204,270314
909,abe-hpe,8,0.00296,88244,32.64500,270314
910,abhiverma1924,8,0.00296,88252,32.64796,270314
911,Aditya-171,8,0.00296,88260,32.65092,270314
912,alan-krumholz,8,0.00296,88268,32.65388,270314
913,alishaIBM,8,0.00296,88276,32.65684,270314
914,andrewferlitsch,8,0.00296,88284,32.65980,270314
915,areshytko,8,0.00296,88292,32.66276,270314
916,arshyasharifian,8,0.00296,88300,32.66571,270314
917,aurorazl,8,0.00296,88308,32.66867,270314
918,austynherman,8,0.00296,88316,32.67163,270314
919,avintonOfficial,8,0.00296,88324,32.67459,270314
920,aychang95,8,0.00296,88332,32.67755,270314
921,AymenFJA,8,0.00296,88340,32.68051,270314
922,bmenn,8,0.00296,88348,32.68347,270314
923,brentchang,8,0.00296,88356,32.68643,270314
924,busunkim96,8,0.00296,88364,32.68939,270314
925,butzist,8,0.00296,88372,32.69235,270314
926,catalinad90,8,0.00296,88380,32.69531,270314
927,chenwenjun-github,8,0.00296,88388,32.69827,270314
928,crauterb,8,0.00296,88396,32.70123,270314
929,crbl1122,8,0.00296,88404,32.70419,270314
930,dakl,8,0.00296,88412,32.70715,270314
931,danijar,8,0.00296,88420,32.71011,270314
932,deepakm-ntnx,8,0.00296,88428,32.71307,270314
933,EdwinZzy,8,0.00296,88436,32.71603,270314
934,eminemence,8,0.00296,88444,32.71899,270314
935,erolco,8,0.00296,88452,32.72195,270314
936,FFede0,8,0.00296,88460,32.72491,270314
937,Focke-Wulf,8,0.00296,88468,32.72786,270314
938,gbin10533,8,0.00296,88476,32.73082,270314
939,GigliOneiric,8,0.00296,88484,32.73378,270314
940,gongcan1219,8,0.00296,88492,32.73674,270314
941,Hachimaki,8,0.00296,88500,32.73970,270314
942,hieuhc,8,0.00296,88508,32.74266,270314
943,ifuwang,8,0.00296,88516,32.74562,270314
944,irabanillo91,8,0.00296,88524,32.74858,270314
945,irhawks,8,0.00296,88532,32.75154,270314
946,ivanmkc,8,0.00296,88540,32.75450,270314
947,jazka,8,0.00296,88548,32.75746,270314
948,jhagege,8,0.00296,88556,32.76042,270314
949,jhua18,8,0.00296,88564,32.76338,270314
950,jimbudarz,8,0.00296,88572,32.76634,270314
951,JK-97,8,0.00296,88580,32.76930,270314
952,jl-massey,8,0.00296,88588,32.77226,270314
953,juliadeclared,8,0.00296,88596,32.77522,270314
954,k402xxxcenxxx,8,0.00296,88604,32.77818,270314
955,kandrio,8,0.00296,88612,32.78114,270314
956,kbc8894,8,0.00296,88620,32.78410,270314
957,kdubovikov,8,0.00296,88628,32.78706,270314
958,khani92,8,0.00296,88636,32.79001,270314
959,Kulikovpavel,8,0.00296,88644,32.79297,270314
960,LuBingtan,8,0.00296,88652,32.79593,270314
961,lucasaytt,8,0.00296,88660,32.79889,270314
962,magick93,8,0.00296,88668,32.80185,270314
963,maorlipchuk,8,0.00296,88676,32.80481,270314
964,markgeejw,8,0.00296,88684,32.80777,270314
965,MattSich,8,0.00296,88692,32.81073,270314
966,maxdebayser,8,0.00296,88700,32.81369,270314
967,MaxGrtz,8,0.00296,88708,32.81665,270314
968,mcantrell,8,0.00296,88716,32.81961,270314
969,mgyong,8,0.00296,88724,32.82257,270314
970,mikel-brostrom,8,0.00296,88732,32.82553,270314
971,missingcharacter,8,0.00296,88740,32.82849,270314
972,mjurkus,8,0.00296,88748,32.83145,270314
973,monoidus,8,0.00296,88756,32.83441,270314
974,myqq0000,8,0.00296,88764,32.83737,270314
975,nepalineupane,8,0.00296,88772,32.84033,270314
976,Neytoph,8,0.00296,88780,32.84329,270314
977,nico-kuzak,8,0.00296,88788,32.84625,270314
978,nkflash,8,0.00296,88796,32.84920,270314
979,oxxygenio,8,0.00296,88804,32.85216,270314
980,Padarn,8,0.00296,88812,32.85512,270314
981,pashtet04,8,0.00296,88820,32.85808,270314
982,pavanky,8,0.00296,88828,32.86104,270314
983,pconrad-fb,8,0.00296,88836,32.86400,270314
984,PingYufeng,8,0.00296,88844,32.86696,270314
985,psheorangithub,8,0.00296,88852,32.86992,270314
986,pwzhong,8,0.00296,88860,32.87288,270314
987,Rasen-wq,8,0.00296,88868,32.87584,270314
988,rbq,8,0.00296,88876,32.87880,270314
989,sam0996,8,0.00296,88884,32.88176,270314
990,sasvaritoni,8,0.00296,88892,32.88472,270314
991,sfujiwara,8,0.00296,88900,32.88768,270314
992,shichengsg001,8,0.00296,88908,32.89064,270314
993,songkane,8,0.00296,88916,32.89360,270314
994,stsukrov,8,0.00296,88924,32.89656,270314
995,swikar1,8,0.00296,88932,32.89952,270314
996,thomas-mueller,8,0.00296,88940,32.90248,270314
997,tinuxnet,8,0.00296,88948,32.90544,270314
998,uniuuu,8,0.00296,88956,32.90840,270314
999,velascoluis,8,0.00296,88964,32.91135,270314
1000,wakanapo,8,0.00296,88972,32.91431,270314
1001,whiletruelearn,8,0.00296,88980,32.91727,270314
1002,x28646510,8,0.00296,88988,32.92023,270314
1003,xiabo2011,8,0.00296,88996,32.92319,270314
1004,xiaonancc77,8,0.00296,89004,32.92615,270314
1005,xiaqunfeng,8,0.00296,89012,32.92911,270314
1006,xqqcoder,8,0.00296,89020,32.93207,270314
1007,xRagnorokx,8,0.00296,89028,32.93503,270314
1008,yosit,8,0.00296,89036,32.93799,270314
1009,zamonia500,8,0.00296,89044,32.94095,270314
1010,15162162323,7,0.00259,89051,32.94354,270314
1011,aaltay,7,0.00259,89058,32.94613,270314
1012,abin-thomas-by,7,0.00259,89065,32.94872,270314
1013,adityaparamesh,7,0.00259,89072,32.95131,270314
1014,andrea-cola,7,0.00259,89079,32.95390,270314
1015,andreeamun,7,0.00259,89086,32.95649,270314
1016,andresmascl,7,0.00259,89093,32.95908,270314
1017,andyi2it,7,0.00259,89100,32.96167,270314
1018,AnnieWei58,7,0.00259,89107,32.96426,270314
1019,azarezade,7,0.00259,89114,32.96685,270314
1020,BAlmeidaS,7,0.00259,89121,32.96944,270314
1021,bebe424,7,0.00259,89128,32.97203,270314
1022,bobmayuze,7,0.00259,89135,32.97461,270314
1023,brettkoonce,7,0.00259,89142,32.97720,270314
1024,bryanpaget,7,0.00259,89149,32.97979,270314
1025,Can-Sahin,7,0.00259,89156,32.98238,270314
1026,cchanley2003,7,0.00259,89163,32.98497,270314
1027,ccrrvvaa,7,0.00259,89170,32.98756,270314
1028,celiawa,7,0.00259,89177,32.99015,270314
1029,celinew1221,7,0.00259,89184,32.99274,270314
1030,Crisescode,7,0.00259,89191,32.99533,270314
1031,CZYCW,7,0.00259,89198,32.99792,270314
1032,D4Lta,7,0.00259,89205,33.00051,270314
1033,dakoner,7,0.00259,89212,33.00310,270314
1034,dbg-raghulkrishna,7,0.00259,89219,33.00569,270314
1035,devashishshankar,7,0.00259,89226,33.00828,270314
1036,drozzy,7,0.00259,89233,33.01087,270314
1037,Edilmo,7,0.00259,89240,33.01346,270314
1038,emenendez,7,0.00259,89247,33.01605,270314
1039,enricomarchesin,7,0.00259,89254,33.01864,270314
1040,ereil,7,0.00259,89261,33.02123,270314
1041,eshaingle,7,0.00259,89268,33.02382,270314
1042,galv,7,0.00259,89275,33.02641,270314
1043,GetOn4,7,0.00259,89282,33.02900,270314
1044,goodpp,7,0.00259,89289,33.03159,270314
1045,goyalankit,7,0.00259,89296,33.03418,270314
1046,gpotti,7,0.00259,89303,33.03676,270314
1047,GuoHaiqing,7,0.00259,89310,33.03935,270314
1048,harperjuanl,7,0.00259,89317,33.04194,270314
1049,hassanzadeh,7,0.00259,89324,33.04453,270314
1050,hmizuma,7,0.00259,89331,33.04712,270314
1051,HumairAK,7,0.00259,89338,33.04971,270314
1052,iantowey,7,0.00259,89345,33.05230,270314
1053,imicer,7,0.00259,89352,33.05489,270314
1054,Jason-CKY,7,0.00259,89359,33.05748,270314
1055,Jeet-14,7,0.00259,89366,33.06007,270314
1056,jimthompson5802,7,0.00259,89373,33.06266,270314
1057,jjf130,7,0.00259,89380,33.06525,270314
1058,joepeskett,7,0.00259,89387,33.06784,270314
1059,jotaylo,7,0.00259,89394,33.07043,270314
1060,jpe316,7,0.00259,89401,33.07302,270314
1061,KausthubK,7,0.00259,89408,33.07561,270314
1062,kruthikakr,7,0.00259,89415,33.07820,270314
1063,kurianbenoy,7,0.00259,89422,33.08079,270314
1064,kvamshi,7,0.00259,89429,33.08338,270314
1065,lakshmanok,7,0.00259,89436,33.08597,270314
1066,lanya16,7,0.00259,89443,33.08856,270314
1067,laserK3000,7,0.00259,89450,33.09115,270314
1068,lresende,7,0.00259,89457,33.09374,270314
1069,LRSutton,7,0.00259,89464,33.09633,270314
1070,LukasBlank,7,0.00259,89471,33.09891,270314
1071,mageirakos,7,0.00259,89478,33.10150,270314
1072,maniappan,7,0.00259,89485,33.10409,270314
1073,mattiasarro,7,0.00259,89492,33.10668,270314
1074,mChowdhury-91,7,0.00259,89499,33.10927,270314
1075,mertkavi,7,0.00259,89506,33.11186,270314
1076,milkybird98,7,0.00259,89513,33.11445,270314
1077,MISSEY,7,0.00259,89520,33.11704,270314
1078,montenegrodr,7,0.00259,89527,33.11963,270314
1079,mousam-singh,7,0.00259,89534,33.12222,270314
1080,munendrasn,7,0.00259,89541,33.12481,270314
1081,mvwestendorp,7,0.00259,89548,33.12740,270314
1082,NettrixTobin,7,0.00259,89555,33.12999,270314
1083,NicholaiStaalung,7,0.00259,89562,33.13258,270314
1084,nielsmeima,7,0.00259,89569,33.13517,270314
1085,Niuxiaotong,7,0.00259,89576,33.13776,270314
1086,nkosteski,7,0.00259,89583,33.14035,270314
1087,oemergenc,7,0.00259,89590,33.14294,270314
1088,OpenZSD,7,0.00259,89597,33.14553,270314
1089,randombishop,7,0.00259,89604,33.14812,270314
1090,razumv,7,0.00259,89611,33.15071,270314
1091,rhc54,7,0.00259,89618,33.15330,270314
1092,rickysage,7,0.00259,89625,33.15589,270314
1093,rodrigocaus,7,0.00259,89632,33.15847,270314
1094,rylynchen,7,0.00259,89639,33.16106,270314
1095,ryo-matsuzaka,7,0.00259,89646,33.16365,270314
1096,sergeykuprikov,7,0.00259,89653,33.16624,270314
1097,shalankig,7,0.00259,89660,33.16883,270314
1098,shibuiwilliam,7,0.00259,89667,33.17142,270314
1099,shotarohorai,7,0.00259,89674,33.17401,270314
1100,Sim4n6,7,0.00259,89681,33.17660,270314
1101,skgreenstar,7,0.00259,89688,33.17919,270314
1102,sneelz,7,0.00259,89695,33.18178,270314
1103,snowlover173,7,0.00259,89702,33.18437,270314
1104,sshuair,7,0.00259,89709,33.18696,270314
1105,stephenhenderson,7,0.00259,89716,33.18955,270314
1106,stevebanik,7,0.00259,89723,33.19214,270314
1107,subhabratabanerjee,7,0.00259,89730,33.19473,270314
1108,sunilvb,7,0.00259,89737,33.19732,270314
1109,Suozz,7,0.00259,89744,33.19991,270314
1110,tech348712013870132,7,0.00259,89751,33.20250,270314
1111,theophilee,7,0.00259,89758,33.20509,270314
1112,thetko85,7,0.00259,89765,33.20768,270314
1113,titansmc,7,0.00259,89772,33.21027,270314
1114,Toeplitz,7,0.00259,89779,33.21286,270314
1115,tripti-singhal,7,0.00259,89786,33.21545,270314
1116,ultraji,7,0.00259,89793,33.21804,270314
1117,veliborfrobas,7,0.00259,89800,33.22062,270314
1118,WalterSmuts,7,0.00259,89807,33.22321,270314
1119,WillianFuks,7,0.00259,89814,33.22580,270314
1120,wodecki,7,0.00259,89821,33.22839,270314
1121,xiaoyili,7,0.00259,89828,33.23098,270314
1122,XinchenWan,7,0.00259,89835,33.23357,270314
1123,yongwen,7,0.00259,89842,33.23616,270314
1124,yptheangel,7,0.00259,89849,33.23875,270314
1125,zengqingfu1442,7,0.00259,89856,33.24134,270314
1126,zmdelima,7,0.00259,89863,33.24393,270314
1127,zygm0nt,7,0.00259,89870,33.24652,270314
1128,13567436138,6,0.00222,89876,33.24874,270314
1129,AbelThorne,6,0.00222,89882,33.25096,270314
1130,achandras,6,0.00222,89888,33.25318,270314
1131,adriangay,6,0.00222,89894,33.25540,270314
1132,aflc,6,0.00222,89900,33.25762,270314
1133,akiyamasho,6,0.00222,89906,33.25984,270314
1134,aktivalux,6,0.00222,89912,33.26206,270314
1135,alanhdu,6,0.00222,89918,33.26428,270314
1136,alefesta,6,0.00222,89924,33.26650,270314
1137,AlexanderEkdahl,6,0.00222,89930,33.26872,270314
1138,amalendur,6,0.00222,89936,33.27094,270314
1139,AndrewMcFarren,6,0.00222,89942,33.27316,270314
1140,anishasthana,6,0.00222,89948,33.27538,270314
1141,ardeshir,6,0.00222,89954,33.27760,270314
1142,asahnovskiy-deloitte,6,0.00222,89960,33.27982,270314
1143,beatgeek,6,0.00222,89966,33.28203,270314
1144,benash,6,0.00222,89972,33.28425,270314
1145,biaochen,6,0.00222,89978,33.28647,270314
1146,boniek83,6,0.00222,89984,33.28869,270314
1147,calvinleungyk,6,0.00222,89990,33.29091,270314
1148,capkurmagati,6,0.00222,89996,33.29313,270314
1149,chaitanyak52,6,0.00222,90002,33.29535,270314
1150,CharlesxrWu,6,0.00222,90008,33.29757,270314
1151,chenwenjun1995,6,0.00222,90014,33.29979,270314
1152,chiefkarlin,6,0.00222,90020,33.30201,270314
1153,CosyOranges,6,0.00222,90026,33.30423,270314
1154,d123456temp,6,0.00222,90032,33.30645,270314
1155,d34th4ck3r,6,0.00222,90038,33.30867,270314
1156,dale88,6,0.00222,90044,33.31089,270314
1157,defoishugo,6,0.00222,90050,33.31311,270314
1158,denis-angilella,6,0.00222,90056,33.31533,270314
1159,DennisVis,6,0.00222,90062,33.31755,270314
1160,disktnk,6,0.00222,90068,33.31977,270314
1161,divinerapier,6,0.00222,90074,33.32199,270314
1162,drPytho,6,0.00222,90080,33.32421,270314
1163,DurivetMatthias,6,0.00222,90086,33.32643,270314
1164,eastlunar,6,0.00222,90092,33.32865,270314
1165,EClaydon,6,0.00222,90098,33.33087,270314
1166,EdwardZhang88,6,0.00222,90104,33.33309,270314
1167,ericandrewmeadows,6,0.00222,90110,33.33531,270314
1168,ErikEngerd,6,0.00222,90116,33.33753,270314
1169,etsyamitra,6,0.00222,90122,33.33975,270314
1170,fabianvdW,6,0.00222,90128,33.34197,270314
1171,fedeesku1,6,0.00222,90134,33.34418,270314
1172,ferrgo,6,0.00222,90140,33.34640,270314
1173,FrancisLennon17,6,0.00222,90146,33.34862,270314
1174,fstetic,6,0.00222,90152,33.35084,270314
1175,gachiemchiep,6,0.00222,90158,33.35306,270314
1176,GdMacmillan,6,0.00222,90164,33.35528,270314
1177,ggodreau,6,0.00222,90170,33.35750,270314
1178,gidutz,6,0.00222,90176,33.35972,270314
1179,gitpushdashf,6,0.00222,90182,33.36194,270314
1180,gsunner,6,0.00222,90188,33.36416,270314
1181,halftan,6,0.00222,90194,33.36638,270314
1182,hanpeiyu94,6,0.00222,90200,33.36860,270314
1183,hansaimlim,6,0.00222,90206,33.37082,270314
1184,HelmiGH,6,0.00222,90212,33.37304,270314
1185,hjkkhj123,6,0.00222,90218,33.37526,270314
1186,hsteude,6,0.00222,90224,33.37748,270314
1187,iavinas,6,0.00222,90230,33.37970,270314
1188,ID56,6,0.00222,90236,33.38192,270314
1189,iyera,6,0.00222,90242,33.38414,270314
1190,jaffe-fly,6,0.00222,90248,33.38636,270314
1191,jaiganeshp,6,0.00222,90254,33.38858,270314
1192,jdoliner,6,0.00222,90260,33.39080,270314
1193,jerrylam,6,0.00222,90266,33.39302,270314
1194,jielou,6,0.00222,90272,33.39524,270314
1195,jmdinis,6,0.00222,90278,33.39746,270314
1196,JoeyZwicker,6,0.00222,90284,33.39968,270314
1197,johnhoman,6,0.00222,90290,33.40190,270314
1198,jorwalk,6,0.00222,90296,33.40412,270314
1199,JoshZastrow,6,0.00222,90302,33.40633,270314
1200,juanvasquezreyes,6,0.00222,90308,33.40855,270314
1201,julioyildo,6,0.00222,90314,33.41077,270314
1202,junhuihuang,6,0.00222,90320,33.41299,270314
1203,jw-websensa,6,0.00222,90326,33.41521,270314
1204,jzfb2,6,0.00222,90332,33.41743,270314
1205,kaka11chen,6,0.00222,90338,33.41965,270314
1206,kalyc,6,0.00222,90344,33.42187,270314
1207,keeplearnin,6,0.00222,90350,33.42409,270314
1208,kidddddddddddddddddddddd,6,0.00222,90356,33.42631,270314
1209,kinglion811,6,0.00222,90362,33.42853,270314
1210,kotalakshman,6,0.00222,90368,33.43075,270314
1211,kunallimaye,6,0.00222,90374,33.43297,270314
1212,LifeArchitect,6,0.00222,90380,33.43519,270314
1213,linpingta,6,0.00222,90386,33.43741,270314
1214,liorshk,6,0.00222,90392,33.43963,270314
1215,lovishch20,6,0.00222,90398,33.44185,270314
1216,lqdev,6,0.00222,90404,33.44407,270314
1217,lxl910915,6,0.00222,90410,33.44629,270314
1218,madhukarkm,6,0.00222,90416,33.44851,270314
1219,MainRo,6,0.00222,90422,33.45073,270314
1220,markmirch,6,0.00222,90428,33.45295,270314
1221,matkosoric,6,0.00222,90434,33.45517,270314
1222,mcminis1,6,0.00222,90440,33.45739,270314
1223,meandmymind,6,0.00222,90446,33.45961,270314
1224,MengYuanTsai,6,0.00222,90452,33.46183,270314
1225,micmarty-deepsense,6,0.00222,90458,33.46405,270314
1226,MLHafizur,6,0.00222,90464,33.46627,270314
1227,mmuppidi,6,0.00222,90470,33.46848,270314
1228,mshaikh786,6,0.00222,90476,33.47070,270314
1229,mtszkw,6,0.00222,90482,33.47292,270314
1230,mumarniaz,6,0.00222,90488,33.47514,270314
1231,namlh16,6,0.00222,90494,33.47736,270314
1232,nanduri1998,6,0.00222,90500,33.47958,270314
1233,nicokuzak,6,0.00222,90506,33.48180,270314
1234,NightLightTw,6,0.00222,90512,33.48402,270314
1235,nikhilsharma93,6,0.00222,90518,33.48624,270314
1236,nkrish1983,6,0.00222,90524,33.48846,270314
1237,nosmatch,6,0.00222,90530,33.49068,270314
1238,oncekey,6,0.00222,90536,33.49290,270314
1239,oonisim,6,0.00222,90542,33.49512,270314
1240,patrickpoirson,6,0.00222,90548,33.49734,270314
1241,peemblis,6,0.00222,90554,33.49956,270314
1242,PercyLau,6,0.00222,90560,33.50178,270314
1243,phoenixwu0229,6,0.00222,90566,33.50400,270314
1244,pinkavaj,6,0.00222,90572,33.50622,270314
1245,prashanthb-ai,6,0.00222,90578,33.50844,270314
1246,Princy-Malhotra,6,0.00222,90584,33.51066,270314
1247,priya170807,6,0.00222,90590,33.51288,270314
1248,pyang-aurora,6,0.00222,90596,33.51510,270314
1249,qifengz,6,0.00222,90602,33.51732,270314
1250,quanguachong,6,0.00222,90608,33.51954,270314
1251,rado-parrak,6,0.00222,90614,33.52176,270314
1252,rajesh-chawla,6,0.00222,90620,33.52398,270314
1253,raven-jia,6,0.00222,90626,33.52620,270314
1254,RDarrylR,6,0.00222,90632,33.52842,270314
1255,rileygreen-ncs,6,0.00222,90638,33.53063,270314
1256,Roma110,6,0.00222,90644,33.53285,270314
1257,saksham93,6,0.00222,90650,33.53507,270314
1258,saurabh24292,6,0.00222,90656,33.53729,270314
1259,sbakiu,6,0.00222,90662,33.53951,270314
1260,seoha-kim,6,0.00222,90668,33.54173,270314
1261,sharmahemlata,6,0.00222,90674,33.54395,270314
1262,shayancanonical,6,0.00222,90680,33.54617,270314
1263,shouryaotta,6,0.00222,90686,33.54839,270314
1264,siddharthjain1611,6,0.00222,90692,33.55061,270314
1265,simon-mo,6,0.00222,90698,33.55283,270314
1266,Soot3,6,0.00222,90704,33.55505,270314
1267,spots107,6,0.00222,90710,33.55727,270314
1268,srinjay-paul,6,0.00222,90716,33.55949,270314
1269,stomplee,6,0.00222,90722,33.56171,270314
1270,tClelford,6,0.00222,90728,33.56393,270314
1271,tidylobster,6,0.00222,90734,33.56615,270314
1272,tiliter-algorithms,6,0.00222,90740,33.56837,270314
1273,tongtaott,6,0.00222,90746,33.57059,270314
1274,Ventals,6,0.00222,90752,33.57281,270314
1275,vinaynair,6,0.00222,90758,33.57503,270314
1276,vincentarthur,6,0.00222,90764,33.57725,270314
1277,vinnysenthil,6,0.00222,90770,33.57947,270314
1278,vkoppisetti-verisk,6,0.00222,90776,33.58169,270314
1279,vlagache,6,0.00222,90782,33.58391,270314
1280,vr140,6,0.00222,90788,33.58613,270314
1281,vswami78,6,0.00222,90794,33.58835,270314
1282,wave112,6,0.00222,90800,33.59057,270314
1283,wcass77,6,0.00222,90806,33.59278,270314
1284,WestonLu,6,0.00222,90812,33.59500,270314
1285,xaoo,6,0.00222,90818,33.59722,270314
1286,yanqiangmiffy,6,0.00222,90824,33.59944,270314
1287,yarnabrina,6,0.00222,90830,33.60166,270314
1288,yetone,6,0.00222,90836,33.60388,270314
1289,yuanbw,6,0.00222,90842,33.60610,270314
1290,zeusro,6,0.00222,90848,33.60832,270314
1291,14sudharsan,5,0.00185,90853,33.61017,270314
1292,482170765,5,0.00185,90858,33.61202,270314
1293,Abhi3linku,5,0.00185,90863,33.61387,270314
1294,agemocui,5,0.00185,90868,33.61572,270314
1295,agnz,5,0.00185,90873,33.61757,270314
1296,aichiludan,5,0.00185,90878,33.61942,270314
1297,aisensiy,5,0.00185,90883,33.62127,270314
1298,AkashDharani,5,0.00185,90888,33.62312,270314
1299,akfmdl,5,0.00185,90893,33.62497,270314
1300,akshaydtada,5,0.00185,90898,33.62682,270314
1301,AlecZebrick,5,0.00185,90903,33.62867,270314
1302,alimhanif,5,0.00185,90908,33.63052,270314
1303,ali-raza-tariq,5,0.00185,90913,33.63237,270314
1304,Amitg1,5,0.00185,90918,33.63422,270314
1305,amolsr,5,0.00185,90923,33.63607,270314
1306,and-1,5,0.00185,90928,33.63792,270314
1307,Anderssorby,5,0.00185,90933,33.63977,270314
1308,anilreddyv,5,0.00185,90938,33.64162,270314
1309,anineharto,5,0.00185,90943,33.64347,270314
1310,anishjain18,5,0.00185,90948,33.64532,270314
1311,antigenius0910,5,0.00185,90953,33.64717,270314
1312,AntPeixe,5,0.00185,90958,33.64902,270314
1313,Anushka30,5,0.00185,90963,33.65087,270314
1314,asahnovskiy,5,0.00185,90968,33.65271,270314
1315,ayush-1506,5,0.00185,90973,33.65456,270314
1316,backnotprop,5,0.00185,90978,33.65641,270314
1317,bankbiz,5,0.00185,90983,33.65826,270314
1318,BarleyXu,5,0.00185,90988,33.66011,270314
1319,baskaranz,5,0.00185,90993,33.66196,270314
1320,benjaminwinokur,5,0.00185,90998,33.66381,270314
1321,bnsblue,5,0.00185,91003,33.66566,270314
1322,BoecquaertJonas,5,0.00185,91008,33.66751,270314
1323,Boes-man,5,0.00185,91013,33.66936,270314
1324,bomerzz,5,0.00185,91018,33.67121,270314
1325,brtasavpatel,5,0.00185,91023,33.67306,270314
1326,bsraya,5,0.00185,91028,33.67491,270314
1327,btphan95,5,0.00185,91033,33.67676,270314
1328,cakeislife100,5,0.00185,91038,33.67861,270314
1329,ChenhanXmu,5,0.00185,91043,33.68046,270314
1330,chie8842,5,0.00185,91048,33.68231,270314
1331,chinmaychandak,5,0.00185,91053,33.68416,270314
1332,chirag0002,5,0.00185,91058,33.68601,270314
1333,ChiragGorsia05,5,0.00185,91063,33.68786,270314
1334,condaatje,5,0.00185,91068,33.68971,270314
1335,crispto,5,0.00185,91073,33.69156,270314
1336,csteegz,5,0.00185,91078,33.69341,270314
1337,damitkwr,5,0.00185,91083,33.69526,270314
1338,danielricks,5,0.00185,91088,33.69711,270314
1339,daniel-sanche,5,0.00185,91093,33.69896,270314
1340,danielsiwiec,5,0.00185,91098,33.70081,270314
1341,danizavtz,5,0.00185,91103,33.70266,270314
1342,darthsuogles,5,0.00185,91108,33.70451,270314
1343,david-thrower,5,0.00185,91113,33.70636,270314
1344,deafdave,5,0.00185,91118,33.70821,270314
1345,deepak2431,5,0.00185,91123,33.71006,270314
1346,deepaknadig,5,0.00185,91128,33.71191,270314
1347,dejangolubovic,5,0.00185,91133,33.71376,270314
1348,dilip640,5,0.00185,91138,33.71560,270314
1349,divyadilip91,5,0.00185,91143,33.71745,270314
1350,drubinstein,5,0.00185,91148,33.71930,270314
1351,dsiegel,5,0.00185,91153,33.72115,270314
1352,dwatrous,5,0.00185,91158,33.72300,270314
1353,ElizabethSvit,5,0.00185,91163,33.72485,270314
1354,EsaFazal72,5,0.00185,91168,33.72670,270314
1355,eundonglee,5,0.00185,91173,33.72855,270314
1356,evanseabrook,5,0.00185,91178,33.73040,270314
1357,fatimaafridi,5,0.00185,91183,33.73225,270314
1358,femtonelson,5,0.00185,91188,33.73410,270314
1359,fighterhit,5,0.00185,91193,33.73595,270314
1360,fisache,5,0.00185,91198,33.73780,270314
1361,frederick0329,5,0.00185,91203,33.73965,270314
1362,frsann,5,0.00185,91208,33.74150,270314
1363,fsaina,5,0.00185,91213,33.74335,270314
1364,gaborvecsei,5,0.00185,91218,33.74520,270314
1365,gabrielecastellano,5,0.00185,91223,33.74705,270314
1366,gcheron,5,0.00185,91228,33.74890,270314
1367,geewynn,5,0.00185,91233,33.75075,270314
1368,gfursin,5,0.00185,91238,33.75260,270314
1369,g-karthik,5,0.00185,91243,33.75445,270314
1370,gmfrasca,5,0.00185,91248,33.75630,270314
1371,GraphtyLove,5,0.00185,91253,33.75815,270314
1372,gxfun,5,0.00185,91258,33.76000,270314
1373,harshit-deepsource,5,0.00185,91263,33.76185,270314
1374,hbrylkowski,5,0.00185,91268,33.76370,270314
1375,heyfey,5,0.00185,91273,33.76555,270314
1376,hholst80,5,0.00185,91278,33.76740,270314
1377,hirokinko,5,0.00185,91283,33.76925,270314
1378,hopper-signifyd,5,0.00185,91288,33.77110,270314
1379,HWiese1980,5,0.00185,91293,33.77295,270314
1380,ianonavy,5,0.00185,91298,33.77480,270314
1381,ice1x,5,0.00185,91303,33.77664,270314
1382,indraforyou,5,0.00185,91308,33.77849,270314
1383,itayvallach,5,0.00185,91313,33.78034,270314
1384,jadechip,5,0.00185,91318,33.78219,270314
1385,JaimeHolland,5,0.00185,91323,33.78404,270314
1386,james426759,5,0.00185,91328,33.78589,270314
1387,jameswnl,5,0.00185,91333,33.78774,270314
1388,janousy,5,0.00185,91338,33.78959,270314
1389,javierdlrm,5,0.00185,91343,33.79144,270314
1390,jax79sg,5,0.00185,91348,33.79329,270314
1391,jayaswalayush,5,0.00185,91353,33.79514,270314
1392,Jaydeemourg,5,0.00185,91358,33.79699,270314
1393,jcastagneri,5,0.00185,91363,33.79884,270314
1394,jcatana,5,0.00185,91368,33.80069,270314
1395,jdonnelly-apixio,5,0.00185,91373,33.80254,270314
1396,jfigura,5,0.00185,91378,33.80439,270314
1397,jinze,5,0.00185,91383,33.80624,270314
1398,jnavarro86,5,0.00185,91388,33.80809,270314
1399,JODIN1727,5,0.00185,91393,33.80994,270314
1400,joeswashington,5,0.00185,91398,33.81179,270314
1401,jonin,5,0.00185,91403,33.81364,270314
1402,jshelman,5,0.00185,91408,33.81549,270314
1403,Jude188,5,0.00185,91413,33.81734,270314
1404,jvendegna,5,0.00185,91418,33.81919,270314
1405,katiesandford,5,0.00185,91423,33.82104,270314
1406,k-gupta,5,0.00185,91428,33.82289,270314
1407,KikiCS,5,0.00185,91433,33.82474,270314
1408,krazyhaas,5,0.00185,91438,33.82659,270314
1409,Kriyszig,5,0.00185,91443,33.82844,270314
1410,kunpengprod,5,0.00185,91448,33.83029,270314
1411,kwonmha,5,0.00185,91453,33.83214,270314
1412,lechwolowski,5,0.00185,91458,33.83399,270314
1413,leetdavid,5,0.00185,91463,33.83584,270314
1414,liudonggang,5,0.00185,91468,33.83769,270314
1415,lokesh-sreedhara,5,0.00185,91473,33.83953,270314
1416,lppier,5,0.00185,91478,33.84138,270314
1417,lp-pl,5,0.00185,91483,33.84323,270314
1418,Luci1306,5,0.00185,91488,33.84508,270314
1419,Madaditya,5,0.00185,91493,33.84693,270314
1420,marcoleewow,5,0.00185,91498,33.84878,270314
1421,MatthiasVDDooren,5,0.00185,91503,33.85063,270314
1422,mauermbq,5,0.00185,91508,33.85248,270314
1423,mengkai94,5,0.00185,91513,33.85433,270314
1424,metaphor,5,0.00185,91518,33.85618,270314
1425,miguelangel,5,0.00185,91523,33.85803,270314
1426,minhwan-rocks,5,0.00185,91528,33.85988,270314
1427,MLXQ,5,0.00185,91533,33.86173,270314
1428,mnmainguy,5,0.00185,91538,33.86358,270314
1429,moorthy156,5,0.00185,91543,33.86543,270314
1430,muik,5,0.00185,91548,33.86728,270314
1431,MustafaHar,5,0.00185,91553,33.86913,270314
1432,nallagangus,5,0.00185,91558,33.87098,270314
1433,nellaivijay,5,0.00185,91563,33.87283,270314
1434,nithin8702,5,0.00185,91568,33.87468,270314
1435,npepin-hub,5,0.00185,91573,33.87653,270314
1436,NSLog0,5,0.00185,91578,33.87838,270314
1437,odellus,5,0.00185,91583,33.88023,270314
1438,ohtaro,5,0.00185,91588,33.88208,270314
1439,olegchorny,5,0.00185,91593,33.88393,270314
1440,orezahc,5,0.00185,91598,33.88578,270314
1441,orugantichetan,5,0.00185,91603,33.88763,270314
1442,patzhang,5,0.00185,91608,33.88948,270314
1443,pbalm,5,0.00185,91613,33.89133,270314
1444,pengyuan,5,0.00185,91618,33.89318,270314
1445,peterhaddad3121,5,0.00185,91623,33.89503,270314
1446,phansoks,5,0.00185,91628,33.89688,270314
1447,pod3275,5,0.00185,91633,33.89873,270314
1448,PoornimaDevii,5,0.00185,91638,33.90057,270314
1449,pshah16,5,0.00185,91643,33.90242,270314
1450,ptrckbnck,5,0.00185,91648,33.90427,270314
1451,pukkaone,5,0.00185,91653,33.90612,270314
1452,pvellanki,5,0.00185,91658,33.90797,270314
1453,Rabelaiss,5,0.00185,91663,33.90982,270314
1454,radhakrishnang,5,0.00185,91668,33.91167,270314
1455,rajan123456,5,0.00185,91673,33.91352,270314
1456,RansSelected,5,0.00185,91678,33.91537,270314
1457,rcrowe-google,5,0.00185,91683,33.91722,270314
1458,regorsmitz,5,0.00185,91688,33.91907,270314
1459,rllin,5,0.00185,91693,33.92092,270314
1460,rmporsch,5,0.00185,91698,33.92277,270314
1461,robin2008,5,0.00185,91703,33.92462,270314
1462,santiagoolivar2017,5,0.00185,91708,33.92647,270314
1463,scottcantreid,5,0.00185,91713,33.92832,270314
1464,seanswyi,5,0.00185,91718,33.93017,270314
1465,Sergiodiaz53,5,0.00185,91723,33.93202,270314
1466,serhio7,5,0.00185,91728,33.93387,270314
1467,shkr,5,0.00185,91733,33.93572,270314
1468,siganakis,5,0.00185,91738,33.93757,270314
1469,silverlining21,5,0.00185,91743,33.93942,270314
1470,sngahane,5,0.00185,91748,33.94127,270314
1471,snps-jinto,5,0.00185,91753,33.94312,270314
1472,soffieprincess06,5,0.00185,91758,33.94497,270314
1473,Souheil-Yazji,5,0.00185,91763,33.94682,270314
1474,souvik-deepsource,5,0.00185,91768,33.94867,270314
1475,Subhraj07,5,0.00185,91773,33.95052,270314
1476,subramaniankarthik,5,0.00185,91778,33.95237,270314
1477,suensummit,5,0.00185,91783,33.95422,270314
1478,suibinz,5,0.00185,91788,33.95607,270314
1479,sukumargaonkar,5,0.00185,91793,33.95792,270314
1480,superkjp,5,0.00185,91798,33.95977,270314
1481,tall-josh,5,0.00185,91803,33.96162,270314
1482,tdhite,5,0.00185,91808,33.96346,270314
1483,tgaddair,5,0.00185,91813,33.96531,270314
1484,TheFreaky,5,0.00185,91818,33.96716,270314
1485,theone4ever,5,0.00185,91823,33.96901,270314
1486,toniz,5,0.00185,91828,33.97086,270314
1487,TravRan,5,0.00185,91833,33.97271,270314
1488,tremblerz,5,0.00185,91838,33.97456,270314
1489,TristansCloud,5,0.00185,91843,33.97641,270314
1490,tristan-vt,5,0.00185,91848,33.97826,270314
1491,tteltrab,5,0.00185,91853,33.98011,270314
1492,VasiliShi,5,0.00185,91858,33.98196,270314
1493,VishDev12,5,0.00185,91863,33.98381,270314
1494,vitaly-om,5,0.00185,91868,33.98566,270314
1495,vkaushik189,5,0.00185,91873,33.98751,270314
1496,v-raja,5,0.00185,91878,33.98936,270314
1497,wangzheyuan,5,0.00185,91883,33.99121,270314
1498,wilkensoncode,5,0.00185,91888,33.99306,270314
1499,Windrill,5,0.00185,91893,33.99491,270314
1500,Winowang,5,0.00185,91898,33.99676,270314
1501,wooleybugger,5,0.00185,91903,33.99861,270314
1502,yaliqin,5,0.00185,91908,34.00046,270314
1503,zpcalan,5,0.00185,91913,34.00231,270314
1504,zyxue,5,0.00185,91918,34.00416,270314
1505,zzunny97,5,0.00185,91923,34.00601,270314
1506,0as1s,4,0.00148,91927,34.00749,270314
1507,251744647,4,0.00148,91931,34.00897,270314
1508,abhishektiwari,4,0.00148,91935,34.01045,270314
1509,adipola,4,0.00148,91939,34.01193,270314
1510,ai4life,4,0.00148,91943,34.01341,270314
1511,aikidave,4,0.00148,91947,34.01489,270314
1512,ajaypbrt,4,0.00148,91951,34.01637,270314
1513,akrava,4,0.00148,91955,34.01785,270314
1514,aldazero,4,0.00148,91959,34.01933,270314
1515,alienxt,4,0.00148,91963,34.02081,270314
1516,alinakuz,4,0.00148,91967,34.02229,270314
1517,AlirezaSadeghi,4,0.00148,91971,34.02376,270314
1518,alison-lim,4,0.00148,91975,34.02524,270314
1519,alvercau,4,0.00148,91979,34.02672,270314
1520,andaag,4,0.00148,91983,34.02820,270314
1521,andrewlarimer,4,0.00148,91987,34.02968,270314
1522,anisnasir,4,0.00148,91991,34.03116,270314
1523,anjaliagarwal8,4,0.00148,91995,34.03264,270314
1524,AnkitRai-22,4,0.00148,91999,34.03412,270314
1525,apatil4,4,0.00148,92003,34.03560,270314
1526,apatsekin,4,0.00148,92007,34.03708,270314
1527,arjunm183,4,0.00148,92011,34.03856,270314
1528,armandmcqueen,4,0.00148,92015,34.04004,270314
1529,arun-vc,4,0.00148,92019,34.04152,270314
1530,ashujain2,4,0.00148,92023,34.04300,270314
1531,asongent,4,0.00148,92027,34.04448,270314
1532,astirya,4,0.00148,92031,34.04596,270314
1533,AtrisMio,4,0.00148,92035,34.04744,270314
1534,ayush7007,4,0.00148,92039,34.04892,270314
1535,bakhtiary,4,0.00148,92043,34.05040,270314
1536,bartlomiej-malecki,4,0.00148,92047,34.05188,270314
1537,batawfic,4,0.00148,92051,34.05336,270314
1538,bbrewington,4,0.00148,92055,34.05484,270314
1539,bhkamath,4,0.00148,92059,34.05632,270314
1540,biggedi,4,0.00148,92063,34.05780,270314
1541,binblee,4,0.00148,92067,34.05928,270314
1542,bleachzk,4,0.00148,92071,34.06076,270314
1543,blsaws,4,0.00148,92075,34.06224,270314
1544,bnussbau,4,0.00148,92079,34.06372,270314
1545,Bowen0729,4,0.00148,92083,34.06520,270314
1546,brychcy,4,0.00148,92087,34.06668,270314
1547,cai-harry,4,0.00148,92091,34.06816,270314
1548,caleb-artifact,4,0.00148,92095,34.06964,270314
1549,CameliaBenLaamari,4,0.00148,92099,34.07112,270314
1550,canshiwei,4,0.00148,92103,34.07260,270314
1551,carre140,4,0.00148,92107,34.07408,270314
1552,cgebbe,4,0.00148,92111,34.07556,270314
1553,chansonzhang,4,0.00148,92115,34.07704,270314
1554,chantikummari,4,0.00148,92119,34.07852,270314
1555,charlesparasa,4,0.00148,92123,34.08000,270314
1556,CheaterAdams,4,0.00148,92127,34.08148,270314
1557,chenbodeng719,4,0.00148,92131,34.08296,270314
1558,chessahoekstra,4,0.00148,92135,34.08444,270314
1559,Chris-Paul-Li,4,0.00148,92139,34.08591,270314
1560,chromatices,4,0.00148,92143,34.08739,270314
1561,clj2567,4,0.00148,92147,34.08887,270314
1562,crispindev,4,0.00148,92151,34.09035,270314
1563,damejovanoski,4,0.00148,92155,34.09183,270314
1564,davidleejy,4,0.00148,92159,34.09331,270314
1565,dblate,4,0.00148,92163,34.09479,270314
1566,dchickabasapa,4,0.00148,92167,34.09627,270314
1567,denisl78,4,0.00148,92171,34.09775,270314
1568,devonkinghorn,4,0.00148,92175,34.09923,270314
1569,dfm871002,4,0.00148,92179,34.10071,270314
1570,dformoso,4,0.00148,92183,34.10219,270314
1571,DharmitD,4,0.00148,92187,34.10367,270314
1572,DianaDai,4,0.00148,92191,34.10515,270314
1573,dlahlou,4,0.00148,92195,34.10663,270314
1574,DmitriGekhtman,4,0.00148,92199,34.10811,270314
1575,dmsuehir,4,0.00148,92203,34.10959,270314
1576,dnavale,4,0.00148,92207,34.11107,270314
1577,doctapp,4,0.00148,92211,34.11255,270314
1578,dogopupper,4,0.00148,92215,34.11403,270314
1579,DQinYuan,4,0.00148,92219,34.11551,270314
1580,DreamerCather,4,0.00148,92223,34.11699,270314
1581,drewbo,4,0.00148,92227,34.11847,270314
1582,drewylui,4,0.00148,92231,34.11995,270314
1583,DvirDukhan,4,0.00148,92235,34.12143,270314
1584,dwang55,4,0.00148,92239,34.12291,270314
1585,dynamicwebpaige,4,0.00148,92243,34.12439,270314
1586,dyoung23,4,0.00148,92247,34.12587,270314
1587,eero-t,4,0.00148,92251,34.12735,270314
1588,elim19,4,0.00148,92255,34.12883,270314
1589,elrussord1,4,0.00148,92259,34.13031,270314
1590,elyase,4,0.00148,92263,34.13179,270314
1591,eternity1984,4,0.00148,92267,34.13327,270314
1592,fabboe,4,0.00148,92271,34.13475,270314
1593,FANG-MING,4,0.00148,92275,34.13623,270314
1594,fhingerl,4,0.00148,92279,34.13771,270314
1595,fondlykip,4,0.00148,92283,34.13919,270314
1596,fulei-9,4,0.00148,92287,34.14067,270314
1597,f-wole,4,0.00148,92291,34.14215,270314
1598,g-angstrom,4,0.00148,92295,34.14363,270314
1599,garlic5566,4,0.00148,92299,34.14511,270314
1600,Gaurang10,4,0.00148,92303,34.14659,270314
1601,gayathry2612,4,0.00148,92307,34.14806,270314
1602,gcampax,4,0.00148,92311,34.14954,270314
1603,George0112,4,0.00148,92315,34.15102,270314
1604,gethinzhang,4,0.00148,92319,34.15250,270314
1605,ggeorgakoudis,4,0.00148,92323,34.15398,270314
1606,gindeleo,4,0.00148,92327,34.15546,270314
1607,gundeti,4,0.00148,92331,34.15694,270314
1608,Guo-Yunzhe,4,0.00148,92335,34.15842,270314
1609,guoziyi-study,4,0.00148,92339,34.15990,270314
1610,haksunLee,4,0.00148,92343,34.16138,270314
1611,hanneshapke,4,0.00148,92347,34.16286,270314
1612,haydnkeung,4,0.00148,92351,34.16434,270314
1613,hebo-yang,4,0.00148,92355,34.16582,270314
1614,Heena-PyCloud,4,0.00148,92359,34.16730,270314
1615,hellodk,4,0.00148,92363,34.16878,270314
1616,helloericsf,4,0.00148,92367,34.17026,270314
1617,HP-Nunes,4,0.00148,92371,34.17174,270314
1618,hrsma2i,4,0.00148,92375,34.17322,270314
1619,huanghy95,4,0.00148,92379,34.17470,270314
1620,husamaf,4,0.00148,92383,34.17618,270314
1621,ibrahimhaddad,4,0.00148,92387,34.17766,270314
1622,ionicsolutions,4,0.00148,92391,34.17914,270314
1623,iptizer,4,0.00148,92395,34.18062,270314
1624,ispmarin,4,0.00148,92399,34.18210,270314
1625,ja06200,4,0.00148,92403,34.18358,270314
1626,jageshmaharjan,4,0.00148,92407,34.18506,270314
1627,japan4415,4,0.00148,92411,34.18654,270314
1628,Jboulery,4,0.00148,92415,34.18802,270314
1629,jceb,4,0.00148,92419,34.18950,270314
1630,jdalbosc-cisco,4,0.00148,92423,34.19098,270314
1631,jdelfino,4,0.00148,92427,34.19246,270314
1632,jer0nim0,4,0.00148,92431,34.19394,270314
1633,jerryjin2018,4,0.00148,92435,34.19542,270314
1634,jiaozhentian,4,0.00148,92439,34.19690,270314
1635,jiasenwu,4,0.00148,92443,34.19838,270314
1636,JishinJames,4,0.00148,92447,34.19986,270314
1637,jkim711,4,0.00148,92451,34.20134,270314
1638,jnatale11,4,0.00148,92455,34.20282,270314
1639,JohnRobinv,4,0.00148,92459,34.20430,270314
1640,jonasboecquaert,4,0.00148,92463,34.20578,270314
1641,josefkorbel,4,0.00148,92467,34.20726,270314
1642,JuanmaBM,4,0.00148,92471,34.20874,270314
1643,juansebashr,4,0.00148,92475,34.21021,270314
1644,justrohan,4,0.00148,92479,34.21169,270314
1645,kalakandi,4,0.00148,92483,34.21317,270314
1646,KamalAman,4,0.00148,92487,34.21465,270314
1647,karanveersingh5623,4,0.00148,92491,34.21613,270314
1648,kevinbazira,4,0.00148,92495,34.21761,270314
1649,kimuson,4,0.00148,92499,34.21909,270314
1650,KineticCookie,4,0.00148,92503,34.22057,270314
1651,kmrshntr,4,0.00148,92507,34.22205,270314
1652,Kokkini,4,0.00148,92511,34.22353,270314
1653,kolasanichaitanya,4,0.00148,92515,34.22501,270314
1654,komalkotha,4,0.00148,92519,34.22649,270314
1655,konradmalik,4,0.00148,92523,34.22797,270314
1656,kpulipati,4,0.00148,92527,34.22945,270314
1657,kschroed,4,0.00148,92531,34.23093,270314
1658,kumare3,4,0.00148,92535,34.23241,270314
1659,kxiao-fn,4,0.00148,92539,34.23389,270314
1660,langhuansanren,4,0.00148,92543,34.23537,270314
1661,learning-automation,4,0.00148,92547,34.23685,270314
1662,leeadh,4,0.00148,92551,34.23833,270314
1663,lightning-like,4,0.00148,92555,34.23981,270314
1664,longpi1,4,0.00148,92559,34.24129,270314
1665,luisquintanilla,4,0.00148,92563,34.24277,270314
1666,lzuwei,4,0.00148,92567,34.24425,270314
1667,ma2331550908,4,0.00148,92571,34.24573,270314
1668,mahsanaru,4,0.00148,92575,34.24721,270314
1669,malawskim,4,0.00148,92579,34.24869,270314
1670,manasjain0699,4,0.00148,92583,34.25017,270314
1671,marcelorum,4,0.00148,92587,34.25165,270314
1672,MarcinHawryluk,4,0.00148,92591,34.25313,270314
1673,marcinkosztolowicz,4,0.00148,92595,34.25461,270314
1674,MarcSkovMadsen,4,0.00148,92599,34.25609,270314
1675,mathematiguy,4,0.00148,92603,34.25757,270314
1676,mavencode01,4,0.00148,92607,34.25905,270314
1677,Mayank12022,4,0.00148,92611,34.26053,270314
1678,mbelton37,4,0.00148,92615,34.26201,270314
1679,Mddct,4,0.00148,92619,34.26349,270314
1680,md-shabbir,4,0.00148,92623,34.26497,270314
1681,mereldawu,4,0.00148,92627,34.26645,270314
1682,mf-giwoong-lee,4,0.00148,92631,34.26793,270314
1683,mfruhner,4,0.00148,92635,34.26941,270314
1684,michaelwsherman,4,0.00148,92639,34.27088,270314
1685,michalbrys,4,0.00148,92643,34.27236,270314
1686,millerhooks,4,0.00148,92647,34.27384,270314
1687,Mithul,4,0.00148,92651,34.27532,270314
1688,mkbahk,4,0.00148,92655,34.27680,270314
1689,MLnick,4,0.00148,92659,34.27828,270314
1690,MostafaGazar,4,0.00148,92663,34.27976,270314
1691,mosyang,4,0.00148,92667,34.28124,270314
1692,Mrreboot7,4,0.00148,92671,34.28272,270314
1693,mstopa,4,0.00148,92675,34.28420,270314
1694,msvensson222,4,0.00148,92679,34.28568,270314
1695,mukulp,4,0.00148,92683,34.28716,270314
1696,mustafaghaliUnity,4,0.00148,92687,34.28864,270314
1697,naveen24691,4,0.00148,92691,34.29012,270314
1698,nicksettje,4,0.00148,92695,34.29160,270314
1699,nidhidamodaran,4,0.00148,92699,34.29308,270314
1700,nirsagi,4,0.00148,92703,34.29456,270314
1701,N-Kingsley,4,0.00148,92707,34.29604,270314
1702,nkpng2k,4,0.00148,92711,34.29752,270314
1703,nksma,4,0.00148,92715,34.29900,270314
1704,nkumar15,4,0.00148,92719,34.30048,270314
1705,NourhanKhaled,4,0.00148,92723,34.30196,270314
1706,nsriram13,4,0.00148,92727,34.30344,270314
1707,onurgu,4,0.00148,92731,34.30492,270314
1708,oshep,4,0.00148,92735,34.30640,270314
1709,oshev,4,0.00148,92739,34.30788,270314
1710,paipaoso,4,0.00148,92743,34.30936,270314
1711,patricia92fa,4,0.00148,92747,34.31084,270314
1712,PatrickKhouryGhosn,4,0.00148,92751,34.31232,270314
1713,pdcoded,4,0.00148,92755,34.31380,270314
1714,pedrovgp,4,0.00148,92759,34.31528,270314
1715,perlinger,4,0.00148,92763,34.31676,270314
1716,persistman,4,0.00148,92767,34.31824,270314
1717,pffijt,4,0.00148,92771,34.31972,270314
1718,pheianox,4,0.00148,92775,34.32120,270314
1719,pigbrain,4,0.00148,92779,34.32268,270314
1720,pkasson,4,0.00148,92783,34.32416,270314
1721,pretendhigh,4,0.00148,92787,34.32564,270314
1722,pxu20,4,0.00148,92791,34.32712,270314
1723,PyoJunCode,4,0.00148,92795,34.32860,270314
1724,pythagoras1357,4,0.00148,92799,34.33008,270314
1725,rachitchauhan43,4,0.00148,92803,34.33156,270314
1726,Rajneesh-Tiwari,4,0.00148,92807,34.33303,270314
1727,randmind,4,0.00148,92811,34.33451,270314
1728,raphaelauv,4,0.00148,92815,34.33599,270314
1729,rc-zhang,4,0.00148,92819,34.33747,270314
1730,rganeshsharma,4,0.00148,92823,34.33895,270314
1731,rohithreddy,4,0.00148,92827,34.34043,270314
1732,Roman-Ka,4,0.00148,92831,34.34191,270314
1733,rtroutinz,4,0.00148,92835,34.34339,270314
1734,RustamGimadiev,4,0.00148,92839,34.34487,270314
1735,ryangrahamnc,4,0.00148,92843,34.34635,270314
1736,sahilkhanna129,4,0.00148,92847,34.34783,270314
1737,SaintBacchus,4,0.00148,92851,34.34931,270314
1738,saintnoah,4,0.00148,92855,34.35079,270314
1739,sandeep-krishnamurthy,4,0.00148,92859,34.35227,270314
1740,Saul-R,4,0.00148,92863,34.35375,270314
1741,saurovn,4,0.00148,92867,34.35523,270314
1742,sebastianohl,4,0.00148,92871,34.35671,270314
1743,SebastianScherer88,4,0.00148,92875,34.35819,270314
1744,sebnyberg,4,0.00148,92879,34.35967,270314
1745,seger48,4,0.00148,92883,34.36115,270314
1746,senthilsivanath,4,0.00148,92887,34.36263,270314
1747,sevensees,4,0.00148,92891,34.36411,270314
1748,shantanuVerma7,4,0.00148,92895,34.36559,270314
1749,sheep94lion,4,0.00148,92899,34.36707,270314
1750,shimdude,4,0.00148,92903,34.36855,270314
1751,shintaro-uchiyama,4,0.00148,92907,34.37003,270314
1752,shuaiyy,4,0.00148,92911,34.37151,270314
1753,ShyamSubramanian,4,0.00148,92915,34.37299,270314
1754,sidray7965,4,0.00148,92919,34.37447,270314
1755,simanadler,4,0.00148,92923,34.37595,270314
1756,sk1395,4,0.00148,92927,34.37743,270314
1757,skrawn,4,0.00148,92931,34.37891,270314
1758,slitery1234,4,0.00148,92935,34.38039,270314
1759,sradc,4,0.00148,92939,34.38187,270314
1760,srujanattunuri,4,0.00148,92943,34.38335,270314
1761,ssdst,4,0.00148,92947,34.38483,270314
1762,Sterls,4,0.00148,92951,34.38631,270314
1763,sublimotion,4,0.00148,92955,34.38779,270314
1764,suryaavala,4,0.00148,92959,34.38927,270314
1765,swapnilogale,4,0.00148,92963,34.39075,270314
1766,taivokasper,4,0.00148,92967,34.39223,270314
1767,Tauranis,4,0.00148,92971,34.39371,270314
1768,temporafugiunt,4,0.00148,92975,34.39518,270314
1769,texdade,4,0.00148,92979,34.39666,270314
1770,thavlik,4,0.00148,92983,34.39814,270314
1771,themowski,4,0.00148,92987,34.39962,270314
1772,thlevy,4,0.00148,92991,34.40110,270314
1773,tianhaoz95,4,0.00148,92995,34.40258,270314
1774,timbuktuu,4,0.00148,92999,34.40406,270314
1775,tkislan,4,0.00148,93003,34.40554,270314
1776,ToddMorrill,4,0.00148,93007,34.40702,270314
1777,TomasPihrt,4,0.00148,93011,34.40850,270314
1778,tonanhngo,4,0.00148,93015,34.40998,270314
1779,trog-levrai,4,0.00148,93019,34.41146,270314
1780,tszumowski,4,0.00148,93023,34.41294,270314
1781,tyrsius,4,0.00148,93027,34.41442,270314
1782,uhhc,4,0.00148,93031,34.41590,270314
1783,unclerayray,4,0.00148,93035,34.41738,270314
1784,unexpectedpanda,4,0.00148,93039,34.41886,270314
1785,ustcyue,4,0.00148,93043,34.42034,270314
1786,vamshi-rvk,4,0.00148,93047,34.42182,270314
1787,vandanavk,4,0.00148,93051,34.42330,270314
1788,vanillakola,4,0.00148,93055,34.42478,270314
1789,venkateshreddy1388,4,0.00148,93059,34.42626,270314
1790,vgarba2,4,0.00148,93063,34.42774,270314
1791,VibratingPig,4,0.00148,93067,34.42922,270314
1792,vicmeng,4,0.00148,93071,34.43070,270314
1793,victpf,4,0.00148,93075,34.43218,270314
1794,vigosser,4,0.00148,93079,34.43366,270314
1795,vinayjain15,4,0.00148,93083,34.43514,270314
1796,VincentDu2021,4,0.00148,93087,34.43662,270314
1797,vineetbadola,4,0.00148,93091,34.43810,270314
1798,vishal-kr-yadav,4,0.00148,93095,34.43958,270314
1799,wang-mask,4,0.00148,93099,34.44106,270314
1800,wydwww,4,0.00148,93103,34.44254,270314
1801,wywywy01,4,0.00148,93107,34.44402,270314
1802,xieqihui,4,0.00148,93111,34.44550,270314
1803,xin-hao-awx,4,0.00148,93115,34.44698,270314
1804,yajunwong,4,0.00148,93119,34.44846,270314
1805,Yaoda77,4,0.00148,93123,34.44994,270314
1806,yarcyarc,4,0.00148,93127,34.45142,270314
1807,yarongol,4,0.00148,93131,34.45290,270314
1808,ycfnana,4,0.00148,93135,34.45438,270314
1809,yeahydq,4,0.00148,93139,34.45586,270314
1810,ypitrey,4,0.00148,93143,34.45733,270314
1811,zheddie,4,0.00148,93147,34.45881,270314
1812,zulissi,4,0.00148,93151,34.46029,270314
1813,zwqjoy,4,0.00148,93155,34.46177,270314
1814,11fenil11,3,0.00111,93158,34.46288,270314
1815,64J0,3,0.00111,93161,34.46399,270314
1816,abbyearnin,3,0.00111,93164,34.46510,270314
1817,aborilov,3,0.00111,93167,34.46621,270314
1818,aburns7,3,0.00111,93170,34.46732,270314
1819,adamjablonowski,3,0.00111,93173,34.46843,270314
1820,Adithimurthi,3,0.00111,93176,34.46954,270314
1821,adrian-plutoflume,3,0.00111,93179,34.47065,270314
1822,ahmet-uyar,3,0.00111,93182,34.47176,270314
1823,ahousley,3,0.00111,93185,34.47287,270314
1824,AigizK,3,0.00111,93188,34.47398,270314
1825,ajayakumar-jayaraj,3,0.00111,93191,34.47509,270314
1826,AjayZinngg,3,0.00111,93194,34.47620,270314
1827,ajithkumar6,3,0.00111,93197,34.47731,270314
1828,ak-tanak,3,0.00111,93200,34.47842,270314
1829,AlbertCintas,3,0.00111,93203,34.47953,270314
1830,aleksandra-sp,3,0.00111,93206,34.48064,270314
1831,alessandroferrari,3,0.00111,93209,34.48175,270314
1832,alexbarta,3,0.00111,93212,34.48286,270314
1833,ali8zake,3,0.00111,93215,34.48397,270314
1834,alzindiq,3,0.00111,93218,34.48508,270314
1835,AmberCheng,3,0.00111,93221,34.48619,270314
1836,amirhessam88,3,0.00111,93224,34.48730,270314
1837,amitbhadra,3,0.00111,93227,34.48841,270314
1838,amitchatbd,3,0.00111,93230,34.48952,270314
1839,amq,3,0.00111,93233,34.49063,270314
1840,Amrit-Mann,3,0.00111,93236,34.49174,270314
1841,amyxst,3,0.00111,93239,34.49285,270314
1842,Anamika28,3,0.00111,93242,34.49396,270314
1843,andrebriggs,3,0.00111,93245,34.49507,270314
1844,AndrewLeach,3,0.00111,93248,34.49618,270314
1845,andrewspiers,3,0.00111,93251,34.49729,270314
1846,AndreyRomanchev,3,0.00111,93254,34.49840,270314
1847,anj-s,3,0.00111,93257,34.49951,270314
1848,ankur47,3,0.00111,93260,34.50062,270314
1849,antshuwen,3,0.00111,93263,34.50173,270314
1850,apulache,3,0.00111,93266,34.50284,270314
1851,argunasekhar,3,0.00111,93269,34.50395,270314
1852,arianyambao,3,0.00111,93272,34.50506,270314
1853,aritar,3,0.00111,93275,34.50617,270314
1854,aronla,3,0.00111,93278,34.50728,270314
1855,ArVar,3,0.00111,93281,34.50839,270314
1856,asavpatel92,3,0.00111,93284,34.50950,270314
1857,AshokKuramdasu,3,0.00111,93287,34.51061,270314
1858,aslisabanci,3,0.00111,93290,34.51172,270314
1859,asojoabiola,3,0.00111,93293,34.51283,270314
1860,asok-mirror,3,0.00111,93296,34.51394,270314
1861,augustovictor,3,0.00111,93299,34.51505,270314
1862,avarf,3,0.00111,93302,34.51616,270314
1863,aVideogamer,3,0.00111,93305,34.51727,270314
1864,avolution,3,0.00111,93308,34.51837,270314
1865,awittzb,3,0.00111,93311,34.51948,270314
1866,ayman107,3,0.00111,93314,34.52059,270314
1867,azadehatfxtl,3,0.00111,93317,34.52170,270314
1868,banbanandroid,3,0.00111,93320,34.52281,270314
1869,Bartket,3,0.00111,93323,34.52392,270314
1870,bbarn3y,3,0.00111,93326,34.52503,270314
1871,beliaev-maksim,3,0.00111,93329,34.52614,270314
1872,benbrandt,3,0.00111,93332,34.52725,270314
1873,BenoitLeguay,3,0.00111,93335,34.52836,270314
1874,ben-omji,3,0.00111,93338,34.52947,270314
1875,benswinney,3,0.00111,93341,34.53058,270314
1876,bharath0208,3,0.00111,93344,34.53169,270314
1877,bobuel,3,0.00111,93347,34.53280,270314
1878,bodak,3,0.00111,93350,34.53391,270314
1879,bonacciog,3,0.00111,93353,34.53502,270314
1880,BorFour,3,0.00111,93356,34.53613,270314
1881,BrainLogic,3,0.00111,93359,34.53724,270314
1882,Brajen259,3,0.00111,93362,34.53835,270314
1883,bravo325806,3,0.00111,93365,34.53946,270314
1884,bretttully,3,0.00111,93368,34.54057,270314
1885,brucechin,3,0.00111,93371,34.54168,270314
1886,bsamadi,3,0.00111,93374,34.54279,270314
1887,busycalibrating,3,0.00111,93377,34.54390,270314
1888,cah4444,3,0.00111,93380,34.54501,270314
1889,capoolebugchat,3,0.00111,93383,34.54612,270314
1890,caren-guo,3,0.00111,93386,34.54723,270314
1891,carlthome,3,0.00111,93389,34.54834,270314
1892,cblackd7r,3,0.00111,93392,34.54945,270314
1893,CBrucePerkins,3,0.00111,93395,34.55056,270314
1894,cbscientist,3,0.00111,93398,34.55167,270314
1895,ccll,3,0.00111,93401,34.55278,270314
1896,ccurro,3,0.00111,93404,34.55389,270314
1897,cejj,3,0.00111,93407,34.55500,270314
1898,cesargomez,3,0.00111,93410,34.55611,270314
1899,chaosxeras,3,0.00111,93413,34.55722,270314
1900,chelarua,3,0.00111,93416,34.55833,270314
1901,chengmengli06,3,0.00111,93419,34.55944,270314
1902,chintha-v,3,0.00111,93422,34.56055,270314
1903,chiragjn,3,0.00111,93425,34.56166,270314
1904,chxk,3,0.00111,93428,34.56277,270314
1905,CJZheng91,3,0.00111,93431,34.56388,270314
1906,ClaudioDavi,3,0.00111,93434,34.56499,270314
1907,claytonlemons,3,0.00111,93437,34.56610,270314
1908,cloudw,3,0.00111,93440,34.56721,270314
1909,cmhokej,3,0.00111,93443,34.56832,270314
1910,CoderHam,3,0.00111,93446,34.56943,270314
1911,cody-yancey,3,0.00111,93449,34.57054,270314
1912,ColinCampbell-GBI,3,0.00111,93452,34.57165,270314
1913,ConnorBarnhill,3,0.00111,93455,34.57276,270314
1914,cp2587,3,0.00111,93458,34.57387,270314
1915,cpedrinaci,3,0.00111,93461,34.57498,270314
1916,croesuslab,3,0.00111,93464,34.57609,270314
1917,daniel-beyond,3,0.00111,93467,34.57720,270314
1918,DanieleBaranzini,3,0.00111,93470,34.57831,270314
1919,DanielLund,3,0.00111,93473,34.57942,270314
1920,danielschulz,3,0.00111,93476,34.58052,270314
1921,dannydk6,3,0.00111,93479,34.58163,270314
1922,dari-o,3,0.00111,93482,34.58274,270314
1923,davidLif,3,0.00111,93485,34.58385,270314
1924,dboc,3,0.00111,93488,34.58496,270314
1925,dctelus,3,0.00111,93491,34.58607,270314
1926,dcyoung,3,0.00111,93494,34.58718,270314
1927,deepanker13,3,0.00111,93497,34.58829,270314
1928,deeptikorwar,3,0.00111,93500,34.58940,270314
1929,dennis1du,3,0.00111,93503,34.59051,270314
1930,destornillador,3,0.00111,93506,34.59162,270314
1931,diegodgs,3,0.00111,93509,34.59273,270314
1932,diegok-unity,3,0.00111,93512,34.59384,270314
1933,dizcology,3,0.00111,93515,34.59495,270314
1934,Don12138,3,0.00111,93518,34.59606,270314
1935,DonggeunYu,3,0.00111,93521,34.59717,270314
1936,doodlesbykumbi,3,0.00111,93524,34.59828,270314
1937,Dottorepoloni,3,0.00111,93527,34.59939,270314
1938,Dravigon,3,0.00111,93530,34.60050,270314
1939,drawesomenic,3,0.00111,93533,34.60161,270314
1940,duchy,3,0.00111,93536,34.60272,270314
1941,duongnt,3,0.00111,93539,34.60383,270314
1942,eCeleritas,3,0.00111,93542,34.60494,270314
1943,edgar971,3,0.00111,93545,34.60605,270314
1944,Edward-liang,3,0.00111,93548,34.60716,270314
1945,Edwardsleo,3,0.00111,93551,34.60827,270314
1946,elcombato,3,0.00111,93554,34.60938,270314
1947,elenimou,3,0.00111,93557,34.61049,270314
1948,eliastsironis,3,0.00111,93560,34.61160,270314
1949,ElnazBigdeli,3,0.00111,93563,34.61271,270314
1950,Enzo90910,3,0.00111,93566,34.61382,270314
1951,eqqe,3,0.00111,93569,34.61493,270314
1952,eran-nussbaum,3,0.00111,93572,34.61604,270314
1953,erhwenkuo,3,0.00111,93575,34.61715,270314
1954,Eros11on,3,0.00111,93578,34.61826,270314
1955,ErraticO,3,0.00111,93581,34.61937,270314
1956,esha-ingle-mpf,3,0.00111,93584,34.62048,270314
1957,ettiee,3,0.00111,93587,34.62159,270314
1958,EUCHI1996,3,0.00111,93590,34.62270,270314
1959,EvanFabry,3,0.00111,93593,34.62381,270314
1960,eyalcha,3,0.00111,93596,34.62492,270314
1961,ezeeyahoo,3,0.00111,93599,34.62603,270314
1962,fakeskimo,3,0.00111,93602,34.62714,270314
1963,feizerl,3,0.00111,93605,34.62825,270314
1964,Fkawala,3,0.00111,93608,34.62936,270314
1965,florian-koenig,3,0.00111,93611,34.63047,270314
1966,frankmanbb,3,0.00111,93614,34.63158,270314
1967,frankzhao,3,0.00111,93617,34.63269,270314
1968,fuhuifang,3,0.00111,93620,34.63380,270314
1969,gehring,3,0.00111,93623,34.63491,270314
1970,georgetree,3,0.00111,93626,34.63602,270314
1971,gettheguru,3,0.00111,93629,34.63713,270314
1972,gigi-at-zymergen,3,0.00111,93632,34.63824,270314
1973,gnovack,3,0.00111,93635,34.63935,270314
1974,goat023,3,0.00111,93638,34.64046,270314
1975,gogeof,3,0.00111,93641,34.64156,270314
1976,gokuatkai,3,0.00111,93644,34.64267,270314
1977,gomrinal,3,0.00111,93647,34.64378,270314
1978,GoodJoey,3,0.00111,93650,34.64489,270314
1979,goodluckbot,3,0.00111,93653,34.64600,270314
1980,gopitk,3,0.00111,93656,34.64711,270314
1981,gordonsilvera,3,0.00111,93659,34.64822,270314
1982,Gorosia,3,0.00111,93662,34.64933,270314
1983,govindsinghnegi,3,0.00111,93665,34.65044,270314
1984,gprashanthkumar,3,0.00111,93668,34.65155,270314
1985,grehce,3,0.00111,93671,34.65266,270314
1986,grischa,3,0.00111,93674,34.65377,270314
1987,gtoonstra,3,0.00111,93677,34.65488,270314
1988,GT-ZhangAcer,3,0.00111,93680,34.65599,270314
1989,gudipudipradeep,3,0.00111,93683,34.65710,270314
1990,gugumituo,3,0.00111,93686,34.65821,270314
1991,gxin0426,3,0.00111,93689,34.65932,270314
1992,hainp,3,0.00111,93692,34.66043,270314
1993,halayudha,3,0.00111,93695,34.66154,270314
1994,haoxinst,3,0.00111,93698,34.66265,270314
1995,HaozhengAN,3,0.00111,93701,34.66376,270314
1996,harshsaini,3,0.00111,93704,34.66487,270314
1997,harshvladha,3,0.00111,93707,34.66598,270314
1998,harupy,3,0.00111,93710,34.66709,270314
1999,hecheng64,3,0.00111,93713,34.66820,270314
2000,Helvind,3,0.00111,93716,34.66931,270314
2001,HenrryVargas,3,0.00111,93719,34.67042,270314
2002,Henry-Kim-Youngwoo,3,0.00111,93722,34.67153,270314
2003,hepwori,3,0.00111,93725,34.67264,270314
2004,hgrsd,3,0.00111,93728,34.67375,270314
2005,hongjunGu2019,3,0.00111,93731,34.67486,270314
2006,huan11,3,0.00111,93734,34.67597,270314
2007,hunhoon21,3,0.00111,93737,34.67708,270314
2008,hykych,3,0.00111,93740,34.67819,270314
2009,hyzhak,3,0.00111,93743,34.67930,270314
2010,hzliangbin,3,0.00111,93746,34.68041,270314
2011,iamvarol,3,0.00111,93749,34.68152,270314
2012,iBluemind,3,0.00111,93752,34.68263,270314
2013,ifs-pauljegouic,3,0.00111,93755,34.68374,270314
2014,ijaouani,3,0.00111,93758,34.68485,270314
2015,InCogNiTo124,3,0.00111,93761,34.68596,270314
2016,isaacyuenhk01,3,0.00111,93764,34.68707,270314
2017,ishanmadan1996,3,0.00111,93767,34.68818,270314
2018,ivanbrave,3,0.00111,93770,34.68929,270314
2019,jackhuang007,3,0.00111,93773,34.69040,270314
2020,jainprachi2506,3,0.00111,93776,34.69151,270314
2021,jaminsore,3,0.00111,93779,34.69262,270314
2022,janbe-ts,3,0.00111,93782,34.69373,270314
2023,jardon,3,0.00111,93785,34.69484,270314
2024,jasonbrancazio,3,0.00111,93788,34.69595,270314
2025,jayanthp-intellect,3,0.00111,93791,34.69706,270314
2026,JBosom,3,0.00111,93794,34.69817,270314
2027,jeanbaptiste-brasselet,3,0.00111,93797,34.69928,270314
2028,jednymslowem,3,0.00111,93800,34.70039,270314
2029,jernster,3,0.00111,93803,34.70150,270314
2030,jerry40214,3,0.00111,93806,34.70261,270314
2031,jetbasrawi,3,0.00111,93809,34.70371,270314
2032,jhasm,3,0.00111,93812,34.70482,270314
2033,jhattingh,3,0.00111,93815,34.70593,270314
2034,jianhuashao,3,0.00111,93818,34.70704,270314
2035,jimmy-hawkfish,3,0.00111,93821,34.70815,270314
2036,jingli0118,3,0.00111,93824,34.70926,270314
2037,jinnovation,3,0.00111,93827,34.71037,270314
2038,JishnuM,3,0.00111,93830,34.71148,270314
2039,jjayadeep06,3,0.00111,93833,34.71259,270314
2040,jklaise,3,0.00111,93836,34.71370,270314
2041,jlouea,3,0.00111,93839,34.71481,270314
2042,joaquingarciaatos,3,0.00111,93842,34.71592,270314
2043,JohannesTK,3,0.00111,93845,34.71703,270314
2044,johnbuluba,3,0.00111,93848,34.71814,270314
2045,john-cr,3,0.00111,93851,34.71925,270314
2046,JohnWick-888,3,0.00111,93854,34.72036,270314
2047,JoinHands,3,0.00111,93857,34.72147,270314
2048,Jonuknownothingsnow,3,0.00111,93860,34.72258,270314
2049,jovan-absci,3,0.00111,93863,34.72369,270314
2050,jphines,3,0.00111,93866,34.72480,270314
2051,JuanValencia,3,0.00111,93869,34.72591,270314
2052,Juggernaut1997,3,0.00111,93872,34.72702,270314
2053,JunPyoL22,3,0.00111,93875,34.72813,270314
2054,justin0322,3,0.00111,93878,34.72924,270314
2055,JV-DHL,3,0.00111,93881,34.73035,270314
2056,k4rth33k,3,0.00111,93884,34.73146,270314
2057,kabilan6,3,0.00111,93887,34.73257,270314
2058,kaishah,3,0.00111,93890,34.73368,270314
2059,kakaxilyp,3,0.00111,93893,34.73479,270314
2060,katieole,3,0.00111,93896,34.73590,270314
2061,kaybon,3,0.00111,93899,34.73701,270314
2062,kbmanseau,3,0.00111,93902,34.73812,270314
2063,kemp2001,3,0.00111,93905,34.73923,270314
2064,kenly-ldk,3,0.00111,93908,34.74034,270314
2065,keshavpeswani,3,0.00111,93911,34.74145,270314
2066,kevinstumpf,3,0.00111,93914,34.74256,270314
2067,khersey,3,0.00111,93917,34.74367,270314
2068,kilicbaran,3,0.00111,93920,34.74478,270314
2069,kim-seoha,3,0.00111,93923,34.74589,270314
2070,kishoreallwynraj,3,0.00111,93926,34.74700,270314
2071,kkolli,3,0.00111,93929,34.74811,270314
2072,Kloempi,3,0.00111,93932,34.74922,270314
2073,kmr0877,3,0.00111,93935,34.75033,270314
2074,konnase,3,0.00111,93938,34.75144,270314
2075,Kribylet,3,0.00111,93941,34.75255,270314
2076,KunWuLuan,3,0.00111,93944,34.75366,270314
2077,kwokon0ng,3,0.00111,93947,34.75477,270314
2078,kzhai,3,0.00111,93950,34.75588,270314
2079,LeeJian,3,0.00111,93953,34.75699,270314
2080,Lee-Yeongjae,3,0.00111,93956,34.75810,270314
2081,leopd,3,0.00111,93959,34.75921,270314
2082,linuraj,3,0.00111,93962,34.76032,270314
2083,liuweibin6566396837,3,0.00111,93965,34.76143,270314
2084,livneros,3,0.00111,93968,34.76254,270314
2085,liyinhgqw,3,0.00111,93971,34.76365,270314
2086,llimboy,3,0.00111,93974,34.76476,270314
2087,lnmohankumar,3,0.00111,93977,34.76586,270314
2088,LucidNeko,3,0.00111,93980,34.76697,270314
2089,LuigiCerone,3,0.00111,93983,34.76808,270314
2090,ma08,3,0.00111,93986,34.76919,270314
2091,mabi08,3,0.00111,93989,34.77030,270314
2092,Madhav111,3,0.00111,93992,34.77141,270314
2093,magreenberg1,3,0.00111,93995,34.77252,270314
2094,majidhali,3,0.00111,93998,34.77363,270314
2095,mak-454,3,0.00111,94001,34.77474,270314
2096,makeitai,3,0.00111,94004,34.77585,270314
2097,manojlds,3,0.00111,94007,34.77696,270314
2098,manuelsh,3,0.00111,94010,34.77807,270314
2099,mappedinn,3,0.00111,94013,34.77918,270314
2100,marcmillien,3,0.00111,94016,34.78029,270314
2101,markqiu,3,0.00111,94019,34.78140,270314
2102,MartinRogmann,3,0.00111,94022,34.78251,270314
2103,masoudjalayer90,3,0.00111,94025,34.78362,270314
2104,matejaputic,3,0.00111,94028,34.78473,270314
2105,mathieulallier807,3,0.00111,94031,34.78584,270314
2106,mattshma,3,0.00111,94034,34.78695,270314
2107,maxisacoder,3,0.00111,94037,34.78806,270314
2108,mayakacz,3,0.00111,94040,34.78917,270314
2109,mdew192837,3,0.00111,94043,34.79028,270314
2110,Meadosc,3,0.00111,94046,34.79139,270314
2111,meiblorn,3,0.00111,94049,34.79250,270314
2112,mesaverde0207,3,0.00111,94052,34.79361,270314
2113,Mesilenceki,3,0.00111,94055,34.79472,270314
2114,MessKon,3,0.00111,94058,34.79583,270314
2115,mgwismer,3,0.00111,94061,34.79694,270314
2116,mhamdan91,3,0.00111,94064,34.79805,270314
2117,MichaelJiangPlus,3,0.00111,94067,34.79916,270314
2118,mickeyh,3,0.00111,94070,34.80027,270314
2119,mikejmills,3,0.00111,94073,34.80138,270314
2120,mikereeves,3,0.00111,94076,34.80249,270314
2121,mikevoets,3,0.00111,94079,34.80360,270314
2122,mindthevirt,3,0.00111,94082,34.80471,270314
2123,MKRNaqeebi,3,0.00111,94085,34.80582,270314
2124,mlegore,3,0.00111,94088,34.80693,270314
2125,mnoble-vody,3,0.00111,94091,34.80804,270314
2126,MohammedRashad,3,0.00111,94094,34.80915,270314
2127,mohite-abhi,3,0.00111,94097,34.81026,270314
2128,mohittalele,3,0.00111,94100,34.81137,270314
2129,moonyoung430,3,0.00111,94103,34.81248,270314
2130,Morride,3,0.00111,94106,34.81359,270314
2131,mosabami,3,0.00111,94109,34.81470,270314
2132,mradha-beat,3,0.00111,94112,34.81581,270314
2133,mroy31,3,0.00111,94115,34.81692,270314
2134,MrPhilosopher,3,0.00111,94118,34.81803,270314
2135,mschuwalow,3,0.00111,94121,34.81914,270314
2136,muhammadtehseenSystemsltd,3,0.00111,94124,34.82025,270314
2137,Muzry,3,0.00111,94127,34.82136,270314
2138,mwoodbri,3,0.00111,94130,34.82247,270314
2139,n3o-Bhushan,3,0.00111,94133,34.82358,270314
2140,narner90,3,0.00111,94136,34.82469,270314
2141,nashra2637,3,0.00111,94139,34.82580,270314
2142,NathanHowell,3,0.00111,94142,34.82691,270314
2143,navo1194,3,0.00111,94145,34.82801,270314
2144,neonihil,3,0.00111,94148,34.82912,270314
2145,neupaneaj,3,0.00111,94151,34.83023,270314
2146,nicholas-abad,3,0.00111,94154,34.83134,270314
2147,nickozilla,3,0.00111,94157,34.83245,270314
2148,NiveditaViswanathNVIDIA,3,0.00111,94160,34.83356,270314
2149,NoahRoseLedesma,3,0.00111,94163,34.83467,270314
2150,NohaIhab,3,0.00111,94166,34.83578,270314
2151,noushi,3,0.00111,94169,34.83689,270314
2152,nroberts1,3,0.00111,94172,34.83800,270314
2153,nsteblay,3,0.00111,94175,34.83911,270314
2154,ntl-ibm,3,0.00111,94178,34.84022,270314
2155,nuel-d1,3,0.00111,94181,34.84133,270314
2156,nurcandurak,3,0.00111,94184,34.84244,270314
2157,nutmilk10,3,0.00111,94187,34.84355,270314
2158,oadams,3,0.00111,94190,34.84466,270314
2159,ofir-bt,3,0.00111,94193,34.84577,270314
2160,Omoong,3,0.00111,94196,34.84688,270314
2161,onelittlenightmusic,3,0.00111,94199,34.84799,270314
2162,onetonfoot,3,0.00111,94202,34.84910,270314
2163,onur-sam-gtn-ai,3,0.00111,94205,34.85021,270314
2164,opalelement,3,0.00111,94208,34.85132,270314
2165,panbalag,3,0.00111,94211,34.85243,270314
2166,parano,3,0.00111,94214,34.85354,270314
2167,patcombe,3,0.00111,94217,34.85465,270314
2168,paulbaumgart,3,0.00111,94220,34.85576,270314
2169,pavan-infiswift,3,0.00111,94223,34.85687,270314
2170,pavankumarboinapalli,3,0.00111,94226,34.85798,270314
2171,pbrzostowski,3,0.00111,94229,34.85909,270314
2172,Pedrohgv,3,0.00111,94232,34.86020,270314
2173,pinglin,3,0.00111,94235,34.86131,270314
2174,pkourouklidis,3,0.00111,94238,34.86242,270314
2175,plainenough,3,0.00111,94241,34.86353,270314
2176,pmcvay,3,0.00111,94244,34.86464,270314
2177,pmuilu,3,0.00111,94247,34.86575,270314
2178,pogacsa,3,0.00111,94250,34.86686,270314
2179,potix2,3,0.00111,94253,34.86797,270314
2180,prashanthharshangi,3,0.00111,94256,34.86908,270314
2181,pratibhadeepti,3,0.00111,94259,34.87019,270314
2182,PrimeF,3,0.00111,94262,34.87130,270314
2183,probirsil,3,0.00111,94265,34.87241,270314
2184,prograhamer,3,0.00111,94268,34.87352,270314
2185,prsrepo,3,0.00111,94271,34.87463,270314
2186,punkerpunker,3,0.00111,94274,34.87574,270314
2187,qinjie545,3,0.00111,94277,34.87685,270314
2188,quaterneon,3,0.00111,94280,34.87796,270314
2189,rabierp,3,0.00111,94283,34.87907,270314
2190,rahuja23,3,0.00111,94286,34.88018,270314
2191,rahulsmehta,3,0.00111,94289,34.88129,270314
2192,rajatonit,3,0.00111,94292,34.88240,270314
2193,rajendra-tamboli,3,0.00111,94295,34.88351,270314
2194,ramakrishnamamidi,3,0.00111,94298,34.88462,270314
2195,rameshkemp,3,0.00111,94301,34.88573,270314
2196,rastislavs,3,0.00111,94304,34.88684,270314
2197,rclough,3,0.00111,94307,34.88795,270314
2198,rduan,3,0.00111,94310,34.88905,270314
2199,rebsp,3,0.00111,94313,34.89016,270314
2200,Reldan,3,0.00111,94316,34.89127,270314
2201,revathijay,3,0.00111,94319,34.89238,270314
2202,revolutionisme,3,0.00111,94322,34.89349,270314
2203,rexad,3,0.00111,94325,34.89460,270314
2204,richardagalvez,3,0.00111,94328,34.89571,270314
2205,riosv,3,0.00111,94331,34.89682,270314
2206,ritaarex,3,0.00111,94334,34.89793,270314
2207,riyaj8888,3,0.00111,94337,34.89904,270314
2208,rjtshrm,3,0.00111,94340,34.90015,270314
2209,rmard90,3,0.00111,94343,34.90126,270314
2210,RobinKa,3,0.00111,94346,34.90237,270314
2211,romankazinnik,3,0.00111,94349,34.90348,270314
2212,RosaCandela,3,0.00111,94352,34.90459,270314
2213,rosgluk,3,0.00111,94355,34.90570,270314
2214,rubenaranamorera,3,0.00111,94358,34.90681,270314
2215,rushins,3,0.00111,94361,34.90792,270314
2216,rvesse,3,0.00111,94364,34.90903,270314
2217,sagravat,3,0.00111,94367,34.91014,270314
2218,salilmishra23,3,0.00111,94370,34.91125,270314
2219,SamChb72,3,0.00111,94373,34.91236,270314
2220,samuelmi2,3,0.00111,94376,34.91347,270314
2221,sathiez,3,0.00111,94379,34.91458,270314
2222,SatyaNarayan1,3,0.00111,94382,34.91569,270314
2223,scott0000,3,0.00111,94385,34.91680,270314
2224,SeanNaren,3,0.00111,94388,34.91791,270314
2225,seansxl,3,0.00111,94391,34.91902,270314
2226,senarvi,3,0.00111,94394,34.92013,270314
2227,shan100github,3,0.00111,94397,34.92124,270314
2228,shashank3959,3,0.00111,94400,34.92235,270314
2229,shashikant-ghangare,3,0.00111,94403,34.92346,270314
2230,shashisingh,3,0.00111,94406,34.92457,270314
2231,shbijlan,3,0.00111,94409,34.92568,270314
2232,shimpel,3,0.00111,94412,34.92679,270314
2233,shivaga9esh,3,0.00111,94415,34.92790,270314
2234,shivam-rai,3,0.00111,94418,34.92901,270314
2235,shruthingcp,3,0.00111,94421,34.93012,270314
2236,ShuhanYan,3,0.00111,94424,34.93123,270314
2237,shuhaohe,3,0.00111,94427,34.93234,270314
2238,shunkakinoki,3,0.00111,94430,34.93345,270314
2239,siddharthchaurasia-tudip,3,0.00111,94433,34.93456,270314
2240,Sifat1998,3,0.00111,94436,34.93567,270314
2241,sijieamoy,3,0.00111,94439,34.93678,270314
2242,Silentphantom62,3,0.00111,94442,34.93789,270314
2243,siriusa51,3,0.00111,94445,34.93900,270314
2244,skothawa-tibco,3,0.00111,94448,34.94011,270314
2245,skuchipu,3,0.00111,94451,34.94122,270314
2246,smurli,3,0.00111,94454,34.94233,270314
2247,soochem,3,0.00111,94457,34.94344,270314
2248,SpecialAll,3,0.00111,94460,34.94455,270314
2249,sriharan16,3,0.00111,94463,34.94566,270314
2250,stampcrab,3,0.00111,94466,34.94677,270314
2251,steveplazafb,3,0.00111,94469,34.94788,270314
2252,subramp,3,0.00111,94472,34.94899,270314
2253,SunilManika,3,0.00111,94475,34.95010,270314
2254,suryabdev,3,0.00111,94478,34.95120,270314
2255,sushkov-r,3,0.00111,94481,34.95231,270314
2256,sxmon,3,0.00111,94484,34.95342,270314
2257,szymonbcoding,3,0.00111,94487,34.95453,270314
2258,TaChao,3,0.00111,94490,34.95564,270314
2259,talcoh2x,3,0.00111,94493,34.95675,270314
2260,TalhaNaeem101,3,0.00111,94496,34.95786,270314
2261,tamera-lanham,3,0.00111,94499,34.95897,270314
2262,tbaggu,3,0.00111,94502,34.96008,270314
2263,tech509201941,3,0.00111,94505,34.96119,270314
2264,techwolf139,3,0.00111,94508,34.96230,270314
2265,tejaschumbalkar,3,0.00111,94511,34.96341,270314
2266,tekumara,3,0.00111,94514,34.96452,270314
2267,TheTravellingSalesman,3,0.00111,94517,34.96563,270314
2268,tiansiyuan,3,0.00111,94520,34.96674,270314
2269,Tilyp,3,0.00111,94523,34.96785,270314
2270,timothysu,3,0.00111,94526,34.96896,270314
2271,tktest1234,3,0.00111,94529,34.97007,270314
2272,Tlaloc-Es,3,0.00111,94532,34.97118,270314
2273,tleewongjaro-agoda,3,0.00111,94535,34.97229,270314
2274,tmielika,3,0.00111,94538,34.97340,270314
2275,Tomer23,3,0.00111,94541,34.97451,270314
2276,torbre16,3,0.00111,94544,34.97562,270314
2277,TosinAina,3,0.00111,94547,34.97673,270314
2278,true-source,3,0.00111,94550,34.97784,270314
2279,twitchax,3,0.00111,94553,34.97895,270314
2280,twolffpiggott,3,0.00111,94556,34.98006,270314
2281,vabshere,3,0.00111,94559,34.98117,270314
2282,varinic,3,0.00111,94562,34.98228,270314
2283,Vasuji,3,0.00111,94565,34.98339,270314
2284,vcarnogu,3,0.00111,94568,34.98450,270314
2285,vditya,3,0.00111,94571,34.98561,270314
2286,vegoutha,3,0.00111,94574,34.98672,270314
2287,vemqar,3,0.00111,94577,34.98783,270314
2288,venci6,3,0.00111,94580,34.98894,270314
2289,verhoek,3,0.00111,94583,34.99005,270314
2290,vgmartinez,3,0.00111,94586,34.99116,270314
2291,VilmaZubak,3,0.00111,94589,34.99227,270314
2292,vinhngx,3,0.00111,94592,34.99338,270314
2293,vipul-sharma20,3,0.00111,94595,34.99449,270314
2294,vladhc,3,0.00111,94598,34.99560,270314
2295,vmolina,3,0.00111,94601,34.99671,270314
2296,wallarug,3,0.00111,94604,34.99782,270314
2297,wallies,3,0.00111,94607,34.99893,270314
2298,WangAooa,3,0.00111,94610,35.00004,270314
2299,wangdian,3,0.00111,94613,35.00115,270314
2300,wangpf09,3,0.00111,94616,35.00226,270314
2301,wanvincent,3,0.00111,94619,35.00337,270314
2302,wenboown,3,0.00111,94622,35.00448,270314
2303,Wenshiqi222,3,0.00111,94625,35.00559,270314
2304,wfg314,3,0.00111,94628,35.00670,270314
2305,wjentner,3,0.00111,94631,35.00781,270314
2306,wkeifenheim,3,0.00111,94634,35.00892,270314
2307,Writtic,3,0.00111,94637,35.01003,270314
2308,wzxJayce,3,0.00111,94640,35.01114,270314
2309,Xiaoaier-Z-L,3,0.00111,94643,35.01225,270314
2310,xiaowei-zillow,3,0.00111,94646,35.01335,270314
2311,yangwenhuan,3,0.00111,94649,35.01446,270314
2312,ycheng,3,0.00111,94652,35.01557,270314
2313,yehiyam,3,0.00111,94655,35.01668,270314
2314,ykevinc,3,0.00111,94658,35.01779,270314
2315,YogeshSomawar,3,0.00111,94661,35.01890,270314
2316,younkun,3,0.00111,94664,35.02001,270314
2317,yribeiro,3,0.00111,94667,35.02112,270314
2318,yuefengz,3,0.00111,94670,35.02223,270314
2319,yuval-yaari,3,0.00111,94673,35.02334,270314
2320,yuzhaojing,3,0.00111,94676,35.02445,270314
2321,zanelliriccardo,3,0.00111,94679,35.02556,270314
2322,ZA-NVG,3,0.00111,94682,35.02667,270314
2323,Zashino,3,0.00111,94685,35.02778,270314
2324,zeb-stephen-downs,3,0.00111,94688,35.02889,270314
2325,zhang87492,3,0.00111,94691,35.03000,270314
2326,zhangle-java,3,0.00111,94694,35.03111,270314
2327,zhangzewen,3,0.00111,94697,35.03222,270314
2328,zhcf,3,0.00111,94700,35.03333,270314
2329,ZhengJuCn,3,0.00111,94703,35.03444,270314
2330,zhiyxu,3,0.00111,94706,35.03555,270314
2331,zhyon404,3,0.00111,94709,35.03666,270314
2332,zhzhang,3,0.00111,94712,35.03777,270314
2333,zm274310577,3,0.00111,94715,35.03888,270314
2334,zqz-net,3,0.00111,94718,35.03999,270314
2335,ZxMYS,3,0.00111,94721,35.04110,270314
2336,zzha2941,3,0.00111,94724,35.04221,270314
2337,11mhg,2,0.00074,94726,35.04295,270314
2338,52tt,2,0.00074,94728,35.04369,270314
2339,Aakash1822,2,0.00074,94730,35.04443,270314
2340,aaronsssya,2,0.00074,94732,35.04517,270314
2341,aashish-sheshadri,2,0.00074,94734,35.04591,270314
2342,aba-ca-xi,2,0.00074,94736,35.04665,270314
2343,abdullin,2,0.00074,94738,35.04739,270314
2344,abimur-123,2,0.00074,94740,35.04813,270314
2345,abishek-murali,2,0.00074,94742,35.04887,270314
2346,abramovi,2,0.00074,94744,35.04961,270314
2347,abrarmajeedi,2,0.00074,94746,35.05035,270314
2348,abreu4,2,0.00074,94748,35.05109,270314
2349,ace-gabriel,2,0.00074,94750,35.05183,270314
2350,achal-wwt,2,0.00074,94752,35.05257,270314
2351,adhaene-noimos,2,0.00074,94754,35.05331,270314
2352,AdityaSoni19031997,2,0.00074,94756,35.05405,270314
2353,adiwijaya,2,0.00074,94758,35.05479,270314
2354,adrshm91,2,0.00074,94760,35.05553,270314
2355,adux6991,2,0.00074,94762,35.05627,270314
2356,adyachok,2,0.00074,94764,35.05701,270314
2357,afilcheff,2,0.00074,94766,35.05775,270314
2358,agnim25,2,0.00074,94768,35.05849,270314
2359,agoblet,2,0.00074,94770,35.05923,270314
2360,ahmed1alqulayti,2,0.00074,94772,35.05997,270314
2361,aicdp1010,2,0.00074,94774,35.06071,270314
2362,AiDataSciencer,2,0.00074,94776,35.06145,270314
2363,aka-toxa,2,0.00074,94778,35.06219,270314
2364,akhimji,2,0.00074,94780,35.06293,270314
2365,akravacyber,2,0.00074,94782,35.06367,270314
2366,akshatgit,2,0.00074,94784,35.06441,270314
2367,aku134,2,0.00074,94786,35.06515,270314
2368,Al4DIN,2,0.00074,94788,35.06589,270314
2369,alanhughes,2,0.00074,94790,35.06663,270314
2370,AldusLorde,2,0.00074,94792,35.06737,270314
2371,alekseyolg,2,0.00074,94794,35.06811,270314
2372,AlexanderCHarrington,2,0.00074,94796,35.06885,270314
2373,AlexChenSkyBlue,2,0.00074,94798,35.06959,270314
2374,alexcoca,2,0.00074,94800,35.07033,270314
2375,alexmirrington,2,0.00074,94802,35.07107,270314
2376,alexw994,2,0.00074,94804,35.07181,270314
2377,Alienfeel,2,0.00074,94806,35.07255,270314
2378,alok-raj,2,0.00074,94808,35.07329,270314
2379,amalow,2,0.00074,94810,35.07403,270314
2380,ameya-parab,2,0.00074,94812,35.07476,270314
2381,Amishakumari544,2,0.00074,94814,35.07550,270314
2382,amitchnick,2,0.00074,94816,35.07624,270314
2383,ammubharatram,2,0.00074,94818,35.07698,270314
2384,amosaini,2,0.00074,94820,35.07772,270314
2385,amostech,2,0.00074,94822,35.07846,270314
2386,andersonvc,2,0.00074,94824,35.07920,270314
2387,andong0323,2,0.00074,94826,35.07994,270314
2388,andradron,2,0.00074,94828,35.08068,270314
2389,andreas-schliebitz,2,0.00074,94830,35.08142,270314
2390,andrewcantos,2,0.00074,94832,35.08216,270314
2391,andyk,2,0.00074,94834,35.08290,270314
2392,andyswift,2,0.00074,94836,35.08364,270314
2393,andyzheung,2,0.00074,94838,35.08438,270314
2394,anhuaxiang,2,0.00074,94840,35.08512,270314
2395,animesh-agarwal,2,0.00074,94842,35.08586,270314
2396,AnnaYue,2,0.00074,94844,35.08660,270314
2397,anshuman-cg,2,0.00074,94846,35.08734,270314
2398,anyingl,2,0.00074,94848,35.08808,270314
2399,aoighost,2,0.00074,94850,35.08882,270314
2400,apshoemaker,2,0.00074,94852,35.08956,270314
2401,apurva3000,2,0.00074,94854,35.09030,270314
2402,arashd,2,0.00074,94856,35.09104,270314
2403,Archa91,2,0.00074,94858,35.09178,270314
2404,aresa7796,2,0.00074,94860,35.09252,270314
2405,arianpasquali,2,0.00074,94862,35.09326,270314
2406,arinto,2,0.00074,94864,35.09400,270314
2407,arjun921,2,0.00074,94866,35.09474,270314
2408,arlofaria,2,0.00074,94868,35.09548,270314
2409,asaydin,2,0.00074,94870,35.09622,270314
2410,Aschwinvo,2,0.00074,94872,35.09696,270314
2411,Ashish-Bhau,2,0.00074,94874,35.09770,270314
2412,ashokbalaraman,2,0.00074,94876,35.09844,270314
2413,ashokramadass,2,0.00074,94878,35.09918,270314
2414,asif001,2,0.00074,94880,35.09992,270314
2415,asmod3us,2,0.00074,94882,35.10066,270314
2416,atamahjoubfar,2,0.00074,94884,35.10140,270314
2417,atbraoy,2,0.00074,94886,35.10214,270314
2418,athensofamerica,2,0.00074,94888,35.10288,270314
2419,at-machine-user,2,0.00074,94890,35.10362,270314
2420,Attila111111,2,0.00074,94892,35.10436,270314
2421,avik-taranis,2,0.00074,94894,35.10510,270314
2422,awl-ext-hoangtml,2,0.00074,94896,35.10584,270314
2423,AxdorphCoder,2,0.00074,94898,35.10658,270314
2424,ayushkr04,2,0.00074,94900,35.10732,270314
2425,ayushpandeyemotionrx,2,0.00074,94902,35.10806,270314
2426,banderlog,2,0.00074,94904,35.10880,270314
2427,bankentan,2,0.00074,94906,35.10954,270314
2428,Barteus,2,0.00074,94908,35.11028,270314
2429,bcebere,2,0.00074,94910,35.11102,270314
2430,bdlb77,2,0.00074,94912,35.11176,270314
2431,bearrito,2,0.00074,94914,35.11250,270314
2432,Benjamin-Etheredge,2,0.00074,94916,35.11324,270314
2433,bertinma,2,0.00074,94918,35.11398,270314
2434,beyersito,2,0.00074,94920,35.11472,270314
2435,bgpatel,2,0.00074,94922,35.11546,270314
2436,bhupc,2,0.00074,94924,35.11620,270314
2437,bigflood,2,0.00074,94926,35.11694,270314
2438,bioshazard,2,0.00074,94928,35.11768,270314
2439,bjmrevilla,2,0.00074,94930,35.11842,270314
2440,bkhuong,2,0.00074,94932,35.11916,270314
2441,blacky-i,2,0.00074,94934,35.11990,270314
2442,BlodwenZ,2,0.00074,94936,35.12064,270314
2443,bmopuri,2,0.00074,94938,35.12138,270314
2444,bobmerevel,2,0.00074,94940,35.12212,270314
2445,BOBO-ZzB,2,0.00074,94942,35.12286,270314
2446,Bonbonbg,2,0.00074,94944,35.12360,270314
2447,bonclay,2,0.00074,94946,35.12434,270314
2448,borremosch,2,0.00074,94948,35.12508,270314
2449,bradleykcardwell,2,0.00074,94950,35.12582,270314
2450,brendanobra,2,0.00074,94952,35.12656,270314
2451,brianmartin,2,0.00074,94954,35.12730,270314
2452,brness,2,0.00074,94956,35.12804,270314
2453,BroderPeters,2,0.00074,94958,35.12878,270314
2454,brucearctor,2,0.00074,94960,35.12952,270314
2455,brunoalreis,2,0.00074,94962,35.13026,270314
2456,brussell757,2,0.00074,94964,35.13100,270314
2457,bryanye97,2,0.00074,94966,35.13174,270314
2458,bug-developer021,2,0.00074,94968,35.13248,270314
2459,buluba89,2,0.00074,94970,35.13322,270314
2460,ByronHsu,2,0.00074,94972,35.13396,270314
2461,byronyi,2,0.00074,94974,35.13470,270314
2462,caiyuanji,2,0.00074,94976,35.13544,270314
2463,calebmoss,2,0.00074,94978,35.13617,270314
2464,CaNignEX,2,0.00074,94980,35.13691,270314
2465,carmat88,2,0.00074,94982,35.13765,270314
2466,Cas-pian,2,0.00074,94984,35.13839,270314
2467,cavepopo,2,0.00074,94986,35.13913,270314
2468,cchung100m,2,0.00074,94988,35.13987,270314
2469,cdraper-CS,2,0.00074,94990,35.14061,270314
2470,cdyangzhenyu,2,0.00074,94992,35.14135,270314
2471,cells2numbers,2,0.00074,94994,35.14209,270314
2472,cgparkinson,2,0.00074,94996,35.14283,270314
2473,chanansh,2,0.00074,94998,35.14357,270314
2474,charlesmelby,2,0.00074,95000,35.14431,270314
2475,Charlie-L-K,2,0.00074,95002,35.14505,270314
2476,chen98,2,0.00074,95004,35.14579,270314
2477,chenglinzhang,2,0.00074,95006,35.14653,270314
2478,chenhan1218,2,0.00074,95008,35.14727,270314
2479,chenmay0921,2,0.00074,95010,35.14801,270314
2480,chennupushkar,2,0.00074,95012,35.14875,270314
2481,Chenxs1122,2,0.00074,95014,35.14949,270314
2482,chienfuchen32,2,0.00074,95016,35.15023,270314
2483,chlun1,2,0.00074,95018,35.15097,270314
2484,choismn00,2,0.00074,95020,35.15171,270314
2485,chpmoreno,2,0.00074,95022,35.15245,270314
2486,chris-andrasick,2,0.00074,95024,35.15319,270314
2487,ChrisMagnuson,2,0.00074,95026,35.15393,270314
2488,chrisstockton,2,0.00074,95028,35.15467,270314
2489,chriswu99aaa,2,0.00074,95030,35.15541,270314
2490,chunyang-wen,2,0.00074,95032,35.15615,270314
2491,ChusMoyano,2,0.00074,95034,35.15689,270314
2492,chwonghk01,2,0.00074,95036,35.15763,270314
2493,cjidboon94,2,0.00074,95038,35.15837,270314
2494,clarizzafern,2,0.00074,95040,35.15911,270314
2495,cm185255,2,0.00074,95042,35.15985,270314
2496,C-nit,2,0.00074,95044,35.16059,270314
2497,constanton,2,0.00074,95046,35.16133,270314
2498,Corezcy,2,0.00074,95048,35.16207,270314
2499,cornleaf,2,0.00074,95050,35.16281,270314
2500,corvin-quodai,2,0.00074,95052,35.16355,270314
2501,CreatorSky,2,0.00074,95054,35.16429,270314
2502,crogers923,2,0.00074,95056,35.16503,270314
2503,CRSilkworth,2,0.00074,95058,35.16577,270314
2504,cruxyoung,2,0.00074,95060,35.16651,270314
2505,cupdike,2,0.00074,95062,35.16725,270314
2506,custom8,2,0.00074,95064,35.16799,270314
2507,cyfdecyf,2,0.00074,95066,35.16873,270314
2508,D1o0g9s,2,0.00074,95068,35.16947,270314
2509,daisuke834,2,0.00074,95070,35.17021,270314
2510,dalxds,2,0.00074,95072,35.17095,270314
2511,danielrs,2,0.00074,95074,35.17169,270314
2512,daniel-woolworths,2,0.00074,95076,35.17243,270314
2513,DanMcInerney,2,0.00074,95078,35.17317,270314
2514,dardanbekteshi,2,0.00074,95080,35.17391,270314
2515,DarioBernardo,2,0.00074,95082,35.17465,270314
2516,darkopevec,2,0.00074,95084,35.17539,270314
2517,darthveda-ai,2,0.00074,95086,35.17613,270314
2518,davemaung,2,0.00074,95088,35.17687,270314
2519,davidgao7,2,0.00074,95090,35.17761,270314
2520,DavidGeW,2,0.00074,95092,35.17835,270314
2521,davidggz,2,0.00074,95094,35.17909,270314
2522,davidtwomey,2,0.00074,95096,35.17983,270314
2523,dawu76,2,0.00074,95098,35.18057,270314
2524,DDDDDDDDDDDDLANG,2,0.00074,95100,35.18131,270314
2525,DDFaller,2,0.00074,95102,35.18205,270314
2526,Deancup,2,0.00074,95104,35.18279,270314
2527,derekwyatt,2,0.00074,95106,35.18353,270314
2528,DeshuaiWang,2,0.00074,95108,35.18427,270314
2529,DesmondH0,2,0.00074,95110,35.18501,270314
2530,devenjarvis,2,0.00074,95112,35.18575,270314
2531,devil-cyber,2,0.00074,95114,35.18649,270314
2532,devoftheweb,2,0.00074,95116,35.18723,270314
2533,dewnull,2,0.00074,95118,35.18797,270314
2534,dgess,2,0.00074,95120,35.18871,270314
2535,DHolmanCoding,2,0.00074,95122,35.18945,270314
2536,diazidabagus,2,0.00074,95124,35.19019,270314
2537,DimaKav,2,0.00074,95126,35.19093,270314
2538,d-kavaliou,2,0.00074,95128,35.19167,270314
2539,dmrub,2,0.00074,95130,35.19241,270314
2540,doctorai-in,2,0.00074,95132,35.19315,270314
2541,doepking,2,0.00074,95134,35.19389,270314
2542,dogukanutuna,2,0.00074,95136,35.19463,270314
2543,DorotheaKal,2,0.00074,95138,35.19537,270314
2544,dragonwarp,2,0.00074,95140,35.19611,270314
2545,dredwilliams,2,0.00074,95142,35.19685,270314
2546,drobison-deloitte,2,0.00074,95144,35.19759,270314
2547,dsblank,2,0.00074,95146,35.19832,270314
2548,dshen51,2,0.00074,95148,35.19906,270314
2549,duoduo-ai,2,0.00074,95150,35.19980,270314
2550,durch,2,0.00074,95152,35.20054,270314
2551,duttab49,2,0.00074,95154,35.20128,270314
2552,dvdbisong,2,0.00074,95156,35.20202,270314
2553,Dylan-Rich,2,0.00074,95158,35.20276,270314
2554,e-compagno,2,0.00074,95160,35.20350,270314
2555,ediphy-azorab,2,0.00074,95162,35.20424,270314
2556,EdMorrell,2,0.00074,95164,35.20498,270314
2557,edowson,2,0.00074,95166,35.20572,270314
2558,Efthymios-Stathakis,2,0.00074,95168,35.20646,270314
2559,Eliasecchi,2,0.00074,95170,35.20720,270314
2560,EricBentoML,2,0.00074,95172,35.20794,270314
2561,Eshan-Agarwal,2,0.00074,95174,35.20868,270314
2562,eshiroma,2,0.00074,95176,35.20942,270314
2563,espears1,2,0.00074,95178,35.21016,270314
2564,etracer65,2,0.00074,95180,35.21090,270314
2565,eugenesiow,2,0.00074,95182,35.21164,270314
2566,ev4isthos,2,0.00074,95184,35.21238,270314
2567,Evanto,2,0.00074,95186,35.21312,270314
2568,ever-cheng,2,0.00074,95188,35.21386,270314
2569,ey00,2,0.00074,95190,35.21460,270314
2570,eykanal,2,0.00074,95192,35.21534,270314
2571,f6wbl6,2,0.00074,95194,35.21608,270314
2572,falcocoris,2,0.00074,95196,35.21682,270314
2573,Faraz743,2,0.00074,95198,35.21756,270314
2574,farazmujtaba,2,0.00074,95200,35.21830,270314
2575,farshadsm,2,0.00074,95202,35.21904,270314
2576,fberanizo,2,0.00074,95204,35.21978,270314
2577,felixhuangau,2,0.00074,95206,35.22052,270314
2578,ferpitol,2,0.00074,95208,35.22126,270314
2579,FGXZ2JO,2,0.00074,95210,35.22200,270314
2580,Findlazyfriend,2,0.00074,95212,35.22274,270314
2581,Fizmath,2,0.00074,95214,35.22348,270314
2582,FKSI,2,0.00074,95216,35.22422,270314
2583,floleuerer,2,0.00074,95218,35.22496,270314
2584,Franco8888,2,0.00074,95220,35.22570,270314
2585,gajanankulkarni-18,2,0.00074,95222,35.22644,270314
2586,GarrettMooney,2,0.00074,95224,35.22718,270314
2587,garrettwong,2,0.00074,95226,35.22792,270314
2588,geoantony9,2,0.00074,95228,35.22866,270314
2589,GeorgeLeePatterson,2,0.00074,95230,35.22940,270314
2590,Geoyi,2,0.00074,95232,35.23014,270314
2591,gerrith3,2,0.00074,95234,35.23088,270314
2592,Gevorg-Minasyan,2,0.00074,95236,35.23162,270314
2593,gfyulx,2,0.00074,95238,35.23236,270314
2594,giogit,2,0.00074,95240,35.23310,270314
2595,GitHub007Dra,2,0.00074,95242,35.23384,270314
2596,glong1997,2,0.00074,95244,35.23458,270314
2597,goofy-z,2,0.00074,95246,35.23532,270314
2598,graykode,2,0.00074,95248,35.23606,270314
2599,greggdonovan,2,0.00074,95250,35.23680,270314
2600,guykhazma,2,0.00074,95252,35.23754,270314
2601,GytisBraz,2,0.00074,95254,35.23828,270314
2602,hahamark1,2,0.00074,95256,35.23902,270314
2603,hahns0lo,2,0.00074,95258,35.23976,270314
2604,hanan9m,2,0.00074,95260,35.24050,270314
2605,harish422,2,0.00074,95262,35.24124,270314
2606,Harishkrishna17,2,0.00074,95264,35.24198,270314
2607,harmeet-singh-discovery,2,0.00074,95266,35.24272,270314
2608,hasansalimkanmaz,2,0.00074,95268,35.24346,270314
2609,hchiuzhuo,2,0.00074,95270,35.24420,270314
2610,hegand,2,0.00074,95272,35.24494,270314
2611,heilerich,2,0.00074,95274,35.24568,270314
2612,hemangjoshi37a,2,0.00074,95276,35.24642,270314
2613,HenryW95,2,0.00074,95278,35.24716,270314
2614,hexiaoliangRick,2,0.00074,95280,35.24790,270314
2615,hfarooqui,2,0.00074,95282,35.24864,270314
2616,hfwen0502,2,0.00074,95284,35.24938,270314
2617,hhji,2,0.00074,95286,35.25012,270314
2618,hideto0710,2,0.00074,95288,35.25086,270314
2619,hikoz,2,0.00074,95290,35.25160,270314
2620,himkt,2,0.00074,95292,35.25234,270314
2621,hkair,2,0.00074,95294,35.25308,270314
2622,hlngaiSam,2,0.00074,95296,35.25382,270314
2623,hoangtnm,2,0.00074,95298,35.25456,270314
2624,holadepo,2,0.00074,95300,35.25530,270314
2625,hongyonggan,2,0.00074,95302,35.25604,270314
2626,hossein-rasi,2,0.00074,95304,35.25678,270314
2627,huang06,2,0.00074,95306,35.25752,270314
2628,huboqiang,2,0.00074,95308,35.25826,270314
2629,Huy199,2,0.00074,95310,35.25900,270314
2630,HVKHCM,2,0.00074,95312,35.25973,270314
2631,hwang9u,2,0.00074,95314,35.26047,270314
2632,hwHans,2,0.00074,95316,35.26121,270314
2633,hyperparameters,2,0.00074,95318,35.26195,270314
2634,i-chvets,2,0.00074,95320,35.26269,270314
2635,idahoakl,2,0.00074,95322,35.26343,270314
2636,idibidiart,2,0.00074,95324,35.26417,270314
2637,iedmrc,2,0.00074,95326,35.26491,270314
2638,ihorby,2,0.00074,95328,35.26565,270314
2639,II-VSB-II,2,0.00074,95330,35.26639,270314
2640,ilchemla,2,0.00074,95332,35.26713,270314
2641,ilovecomet,2,0.00074,95334,35.26787,270314
2642,ImadEddineBek,2,0.00074,95336,35.26861,270314
2643,imagr-pat,2,0.00074,95338,35.26935,270314
2644,indranilr,2,0.00074,95340,35.27009,270314
2645,isaacmg,2,0.00074,95342,35.27083,270314
2646,isaranto,2,0.00074,95344,35.27157,270314
2647,IsraelAbebe,2,0.00074,95346,35.27231,270314
2648,isuyyy,2,0.00074,95348,35.27305,270314
2649,Itfly,2,0.00074,95350,35.27379,270314
2650,IvanAlejandro888,2,0.00074,95352,35.27453,270314
2651,ivanjacobsec,2,0.00074,95354,35.27527,270314
2652,ivryan,2,0.00074,95356,35.27601,270314
2653,Jabbo16,2,0.00074,95358,35.27675,270314
2654,JackDallas,2,0.00074,95360,35.27749,270314
2655,jacklu2016,2,0.00074,95362,35.27823,270314
2656,jaggaer-mtrninic,2,0.00074,95364,35.27897,270314
2657,Jalmeida1994,2,0.00074,95366,35.27971,270314
2658,jamesandres,2,0.00074,95368,35.28045,270314
2659,jamessandy,2,0.00074,95370,35.28119,270314
2660,jammingyu9,2,0.00074,95372,35.28193,270314
2661,JasonPad19,2,0.00074,95374,35.28267,270314
2662,javiroman,2,0.00074,95376,35.28341,270314
2663,jayaprasadt,2,0.00074,95378,35.28415,270314
2664,jaystary,2,0.00074,95380,35.28489,270314
2665,jcRisch,2,0.00074,95382,35.28563,270314
2666,JCzz,2,0.00074,95384,35.28637,270314
2667,jdavis34265,2,0.00074,95386,35.28711,270314
2668,jdurago,2,0.00074,95388,35.28785,270314
2669,JebasinghLuccas,2,0.00074,95390,35.28859,270314
2670,JeffersonH44,2,0.00074,95392,35.28933,270314
2671,jentrialgo,2,0.00074,95394,35.29007,270314
2672,Jetafull,2,0.00074,95396,35.29081,270314
2673,jhamet93,2,0.00074,95398,35.29155,270314
2674,jhebelerDS,2,0.00074,95400,35.29229,270314
2675,jhs0318,2,0.00074,95402,35.29303,270314
2676,jimenan-iguazio,2,0.00074,95404,35.29377,270314
2677,jimspohrer,2,0.00074,95406,35.29451,270314
2678,jinseonlee1215,2,0.00074,95408,35.29525,270314
2679,jithinvalsalan,2,0.00074,95410,35.29599,270314
2680,jiujiang,2,0.00074,95412,35.29673,270314
2681,jkchang,2,0.00074,95414,35.29747,270314
2682,jnmaomao,2,0.00074,95416,35.29821,270314
2683,joal-zb,2,0.00074,95418,35.29895,270314
2684,joesan,2,0.00074,95420,35.29969,270314
2685,johnchenghk01,2,0.00074,95422,35.30043,270314
2686,joinal-ahmed,2,0.00074,95424,35.30117,270314
2687,jonathanglima,2,0.00074,95426,35.30191,270314
2688,jonathangold,2,0.00074,95428,35.30265,270314
2689,JonChanGit,2,0.00074,95430,35.30339,270314
2690,jonghyunho,2,0.00074,95432,35.30413,270314
2691,Jooho,2,0.00074,95434,35.30487,270314
2692,josete89,2,0.00074,95436,35.30561,270314
2693,jpic,2,0.00074,95438,35.30635,270314
2694,JP-MRPhys,2,0.00074,95440,35.30709,270314
2695,jpvandervelden,2,0.00074,95442,35.30783,270314
2696,jrabary,2,0.00074,95444,35.30857,270314
2697,jrabiah,2,0.00074,95446,35.30931,270314
2698,jszendre,2,0.00074,95448,35.31005,270314
2699,JuanPabloSebey,2,0.00074,95450,35.31079,270314
2700,juan-sv,2,0.00074,95452,35.31153,270314
2701,juhyeon-cha,2,0.00074,95454,35.31227,270314
2702,junggeh,2,0.00074,95456,35.31301,270314
2703,jusingh,2,0.00074,95458,35.31375,270314
2704,JustinReboullot,2,0.00074,95460,35.31449,270314
2705,j-wezel,2,0.00074,95462,35.31523,270314
2706,JyothsnaPendyala,2,0.00074,95464,35.31597,270314
2707,jzonthemtn,2,0.00074,95466,35.31671,270314
2708,kaikun213,2,0.00074,95468,35.31745,270314
2709,kamal24111991,2,0.00074,95470,35.31819,270314
2710,kanwaljitkhurmi,2,0.00074,95472,35.31893,270314
2711,karkumar,2,0.00074,95474,35.31967,270314
2712,karmicdude,2,0.00074,95476,35.32041,270314
2713,KatyaRuth,2,0.00074,95478,35.32115,270314
2714,kcturner123,2,0.00074,95480,35.32188,270314
2715,kenhktsui,2,0.00074,95482,35.32262,270314
2716,kenugraha,2,0.00074,95484,35.32336,270314
2717,kenwoodjw,2,0.00074,95486,35.32410,270314
2718,kevincasadodsc,2,0.00074,95488,35.32484,270314
2719,khangtrantri,2,0.00074,95490,35.32558,270314
2720,khsibr,2,0.00074,95492,35.32632,270314
2721,ki-arie,2,0.00074,95494,35.32706,270314
2722,kikko,2,0.00074,95496,35.32780,270314
2723,Kiza,2,0.00074,95498,35.32854,270314
2724,k-jeon,2,0.00074,95500,35.32928,270314
2725,klaus82,2,0.00074,95502,35.33002,270314
2726,Klein-Hu,2,0.00074,95504,35.33076,270314
2727,kmathiou,2,0.00074,95506,35.33150,270314
2728,KMFidom,2,0.00074,95508,35.33224,270314
2729,koenmtb1,2,0.00074,95510,35.33298,270314
2730,kolakows,2,0.00074,95512,35.33372,270314
2731,KonstantinosAnd,2,0.00074,95514,35.33446,270314
2732,koseoyoung,2,0.00074,95516,35.33520,270314
2733,kpeters,2,0.00074,95518,35.33594,270314
2734,kslin,2,0.00074,95520,35.33668,270314
2735,kstory8,2,0.00074,95522,35.33742,270314
2736,kubeflow-examples,2,0.00074,95524,35.33816,270314
2737,kuldeepjain,2,0.00074,95526,35.33890,270314
2738,kunalpatel1793,2,0.00074,95528,35.33964,270314
2739,kylegc,2,0.00074,95530,35.34038,270314
2740,kzh,2,0.00074,95532,35.34112,270314
2741,lambertsbennett,2,0.00074,95534,35.34186,270314
2742,Lance410247,2,0.00074,95536,35.34260,270314
2743,larry-lu-lu,2,0.00074,95538,35.34334,270314
2744,larsderidder,2,0.00074,95540,35.34408,270314
2745,LasalJayawardena,2,0.00074,95542,35.34482,270314
2746,laurentbastien,2,0.00074,95544,35.34556,270314
2747,lawdpls,2,0.00074,95546,35.34630,270314
2748,lbatteau,2,0.00074,95548,35.34704,270314
2749,lc-billyfung,2,0.00074,95550,35.34778,270314
2750,LeBoyOrion,2,0.00074,95552,35.34852,270314
2751,leeqleeqleeq,2,0.00074,95554,35.34926,270314
2752,leorleor,2,0.00074,95556,35.35000,270314
2753,lfloeer,2,0.00074,95558,35.35074,270314
2754,lightingghost,2,0.00074,95560,35.35148,270314
2755,limotkl,2,0.00074,95562,35.35222,270314
2756,liu431,2,0.00074,95564,35.35296,270314
2757,liuchintao,2,0.00074,95566,35.35370,270314
2758,liujun121533,2,0.00074,95568,35.35444,270314
2759,liusy182,2,0.00074,95570,35.35518,270314
2760,LiuZhiYuan123456,2,0.00074,95572,35.35592,270314
2761,lixianfa,2,0.00074,95574,35.35666,270314
2762,lizzy220,2,0.00074,95576,35.35740,270314
2763,llKetanll,2,0.00074,95578,35.35814,270314
2764,Longwelwind,2,0.00074,95580,35.35888,270314
2765,Lord-V15,2,0.00074,95582,35.35962,270314
2766,Louanes1,2,0.00074,95584,35.36036,270314
2767,LouNauSRC,2,0.00074,95586,35.36110,270314
2768,lppsuixn,2,0.00074,95588,35.36184,270314
2769,ltomes,2,0.00074,95590,35.36258,270314
2770,lucaseo90,2,0.00074,95592,35.36332,270314
2771,lucien-kejl,2,0.00074,95594,35.36406,270314
2772,ludans,2,0.00074,95596,35.36480,270314
2773,luigicr1965,2,0.00074,95598,35.36554,270314
2774,lukeogg,2,0.00074,95600,35.36628,270314
2775,lukkiddd,2,0.00074,95602,35.36702,270314
2776,LutzWeischerFujitsu,2,0.00074,95604,35.36776,270314
2777,lvbaouu,2,0.00074,95606,35.36850,270314
2778,Lyken17,2,0.00074,95608,35.36924,270314
2779,lynochka,2,0.00074,95610,35.36998,270314
2780,m10913044,2,0.00074,95612,35.37072,270314
2781,m1ghtym0,2,0.00074,95614,35.37146,270314
2782,magdalenakuhn,2,0.00074,95616,35.37220,270314
2783,mannuscript,2,0.00074,95618,35.37294,270314
2784,manolis-andr,2,0.00074,95620,35.37368,270314
2785,maorzalt,2,0.00074,95622,35.37442,270314
2786,mapdegree,2,0.00074,95624,35.37516,270314
2787,mareksuscak,2,0.00074,95626,35.37590,270314
2788,markbeierl,2,0.00074,95628,35.37664,270314
2789,marlow-h,2,0.00074,95630,35.37738,270314
2790,marsupialtail,2,0.00074,95632,35.37812,270314
2791,martinbomio,2,0.00074,95634,35.37886,270314
2792,martin-gorner,2,0.00074,95636,35.37960,270314
2793,martin-liu,2,0.00074,95638,35.38034,270314
2794,mat0pad,2,0.00074,95640,35.38108,270314
2795,math-sasso,2,0.00074,95642,35.38182,270314
2796,mattcallanan,2,0.00074,95644,35.38256,270314
2797,mattdornfeld,2,0.00074,95646,35.38329,270314
2798,MatteoFelici,2,0.00074,95648,35.38403,270314
2799,matthiasfalk,2,0.00074,95650,35.38477,270314
2800,mattiasliljenzin,2,0.00074,95652,35.38551,270314
2801,mattmcclean,2,0.00074,95654,35.38625,270314
2802,maurizio-vitale,2,0.00074,95656,35.38699,270314
2803,mdruby,2,0.00074,95658,35.38773,270314
2804,mehrdadnd,2,0.00074,95660,35.38847,270314
2805,meneal,2,0.00074,95662,35.38921,270314
2806,mengxi-ascent,2,0.00074,95664,35.38995,270314
2807,merryzhou,2,0.00074,95666,35.39069,270314
2808,mfabdrabou,2,0.00074,95668,35.39143,270314
2809,mgr2178,2,0.00074,95670,35.39217,270314
2810,micahjsmith,2,0.00074,95672,35.39291,270314
2811,michael-balint,2,0.00074,95674,35.39365,270314
2812,MiHess,2,0.00074,95676,35.39439,270314
2813,Minyus,2,0.00074,95678,35.39513,270314
2814,misohu,2,0.00074,95680,35.39587,270314
2815,misteliy,2,0.00074,95682,35.39661,270314
2816,MJ-Amway,2,0.00074,95684,35.39735,270314
2817,mjgrav2001,2,0.00074,95686,35.39809,270314
2818,ml6-liam,2,0.00074,95688,35.39883,270314
2819,Mlawrence95,2,0.00074,95690,35.39957,270314
2820,mmalviya,2,0.00074,95692,35.40031,270314
2821,mohamadmansourX,2,0.00074,95694,35.40105,270314
2822,mohamedFaris47,2,0.00074,95696,35.40179,270314
2823,monil536,2,0.00074,95698,35.40253,270314
2824,montanier,2,0.00074,95700,35.40327,270314
2825,mouradmourafiq,2,0.00074,95702,35.40401,270314
2826,mparkhe,2,0.00074,95704,35.40475,270314
2827,mrjgamble,2,0.00074,95706,35.40549,270314
2828,mrudulan,2,0.00074,95708,35.40623,270314
2829,mshyeon,2,0.00074,95710,35.40697,270314
2830,msteiner-google,2,0.00074,95712,35.40771,270314
2831,mukul-mehta,2,0.00074,95714,35.40845,270314
2832,Mullefa,2,0.00074,95716,35.40919,270314
2833,muscovitebob,2,0.00074,95718,35.40993,270314
2834,mwarzynski,2,0.00074,95720,35.41067,270314
2835,Mykolaichenko,2,0.00074,95722,35.41141,270314
2836,n3011,2,0.00074,95724,35.41215,270314
2837,nabsabraham,2,0.00074,95726,35.41289,270314
2838,Naegionn,2,0.00074,95728,35.41363,270314
2839,namespace-io,2,0.00074,95730,35.41437,270314
2840,Nancy-Badran,2,0.00074,95732,35.41511,270314
2841,Nancylsell,2,0.00074,95734,35.41585,270314
2842,natalytvinova,2,0.00074,95736,35.41659,270314
2843,NateRoiger,2,0.00074,95738,35.41733,270314
2844,NathanDeMaria,2,0.00074,95740,35.41807,270314
2845,nathanwong91,2,0.00074,95742,35.41881,270314
2846,NeerajGulia,2,0.00074,95744,35.41955,270314
2847,neofarm473,2,0.00074,95746,35.42029,270314
2848,nephenthe,2,0.00074,95748,35.42103,270314
2849,nexemjail,2,0.00074,95750,35.42177,270314
2850,nicexxact,2,0.00074,95752,35.42251,270314
2851,nicholas-fwang,2,0.00074,95754,35.42325,270314
2852,nickiegk,2,0.00074,95756,35.42399,270314
2853,NickJasonLv,2,0.00074,95758,35.42473,270314
2854,nicosac97,2,0.00074,95760,35.42547,270314
2855,Nidhidamodaran,2,0.00074,95762,35.42621,270314
2856,nikan1996,2,0.00074,95764,35.42695,270314
2857,nikhil-dce,2,0.00074,95766,35.42769,270314
2858,Niko32,2,0.00074,95768,35.42843,270314
2859,nirmalsinghania2008,2,0.00074,95770,35.42917,270314
2860,niteshldd,2,0.00074,95772,35.42991,270314
2861,Nivedita-V,2,0.00074,95774,35.43065,270314
2862,nlaanait,2,0.00074,95776,35.43139,270314
2863,nowenL,2,0.00074,95778,35.43213,270314
2864,nphilou,2,0.00074,95780,35.43287,270314
2865,nschenone,2,0.00074,95782,35.43361,270314
2866,ns-jman,2,0.00074,95784,35.43435,270314
2867,oakkas,2,0.00074,95786,35.43509,270314
2868,ocdkube,2,0.00074,95788,35.43583,270314
2869,OfTheThorn,2,0.00074,95790,35.43657,270314
2870,oguzhanoyan,2,0.00074,95792,35.43731,270314
2871,omerfsen-gsnd,2,0.00074,95794,35.43805,270314
2872,OnionSmile,2,0.00074,95796,35.43879,270314
2873,ooverandout,2,0.00074,95798,35.43953,270314
2874,OrenLeung,2,0.00074,95800,35.44027,270314
2875,osabobo,2,0.00074,95802,35.44101,270314
2876,owmasch,2,0.00074,95804,35.44175,270314
2877,ozora-ogino,2,0.00074,95806,35.44249,270314
2878,pablogsal,2,0.00074,95808,35.44323,270314
2879,pankajxyz,2,0.00074,95810,35.44397,270314
2880,parthasarathi-pm,2,0.00074,95812,35.44471,270314
2881,patelmm79,2,0.00074,95814,35.44544,270314
2882,patrickmead,2,0.00074,95816,35.44618,270314
2883,paxinos,2,0.00074,95818,35.44692,270314
2884,pedrocwb,2,0.00074,95820,35.44766,270314
2885,peteboothroyd,2,0.00074,95822,35.44840,270314
2886,phejimlin,2,0.00074,95824,35.44914,270314
2887,philipebuka,2,0.00074,95826,35.44988,270314
2888,PhilippeBarb,2,0.00074,95828,35.45062,270314
2889,philmln,2,0.00074,95830,35.45136,270314
2890,phonaylin,2,0.00074,95832,35.45210,270314
2891,piernikR,2,0.00074,95834,35.45284,270314
2892,PierrickPochelu,2,0.00074,95836,35.45358,270314
2893,piyushcse29,2,0.00074,95838,35.45432,270314
2894,pjsudharshan,2,0.00074,95840,35.45506,270314
2895,pkamath,2,0.00074,95842,35.45580,270314
2896,pkasson-ascena,2,0.00074,95844,35.45654,270314
2897,pmangg,2,0.00074,95846,35.45728,270314
2898,polsm91,2,0.00074,95848,35.45802,270314
2899,porterdarby,2,0.00074,95850,35.45876,270314
2900,pragadeeshraju,2,0.00074,95852,35.45950,270314
2901,pranasblk,2,0.00074,95854,35.46024,270314
2902,prateek1192,2,0.00074,95856,35.46098,270314
2903,psc-dlt,2,0.00074,95858,35.46172,270314
2904,pshegde,2,0.00074,95860,35.46246,270314
2905,psisoft,2,0.00074,95862,35.46320,270314
2906,pupilye,2,0.00074,95864,35.46394,270314
2907,pymia,2,0.00074,95866,35.46468,270314
2908,qinshuaihua,2,0.00074,95868,35.46542,270314
2909,radics93,2,0.00074,95870,35.46616,270314
2910,rafaascensao,2,0.00074,95872,35.46690,270314
2911,rafaelnovello,2,0.00074,95874,35.46764,270314
2912,rafalk0,2,0.00074,95876,35.46838,270314
2913,rairithesh123,2,0.00074,95878,35.46912,270314
2914,rajib76,2,0.00074,95880,35.46986,270314
2915,rami3e,2,0.00074,95882,35.47060,270314
2916,raphaelTrench,2,0.00074,95884,35.47134,270314
2917,Ravenp87,2,0.00074,95886,35.47208,270314
2918,rayan-roy,2,0.00074,95888,35.47282,270314
2919,rayymlai,2,0.00074,95890,35.47356,270314
2920,rcillavicomtech,2,0.00074,95892,35.47430,270314
2921,rculbertson,2,0.00074,95894,35.47504,270314
2922,rebeccamcfadden,2,0.00074,95896,35.47578,270314
2923,reed9999,2,0.00074,95898,35.47652,270314
2924,remyLarroye,2,0.00074,95900,35.47726,270314
2925,rexshang,2,0.00074,95902,35.47800,270314
2926,richardliaw,2,0.00074,95904,35.47874,270314
2927,ricpet,2,0.00074,95906,35.47948,270314
2928,ritabanchowdhury319,2,0.00074,95908,35.48022,270314
2929,robin5540,2,0.00074,95910,35.48096,270314
2930,robscc,2,0.00074,95912,35.48170,270314
2931,rochageorge,2,0.00074,95914,35.48244,270314
2932,RochanMehrotra,2,0.00074,95916,35.48318,270314
2933,rohitsroch,2,0.00074,95918,35.48392,270314
2934,RonsenbergVI,2,0.00074,95920,35.48466,270314
2935,RoterDL,2,0.00074,95922,35.48540,270314
2936,rs9899,2,0.00074,95924,35.48614,270314
2937,rtkshahwar,2,0.00074,95926,35.48688,270314
2938,Rubiel1,2,0.00074,95928,35.48762,270314
2939,rujual,2,0.00074,95930,35.48836,270314
2940,ruoyu90,2,0.00074,95932,35.48910,270314
2941,ryan-ally,2,0.00074,95934,35.48984,270314
2942,sachdevayash1910,2,0.00074,95936,35.49058,270314
2943,saemaromoon,2,0.00074,95938,35.49132,270314
2944,sagarshrestha24,2,0.00074,95940,35.49206,270314
2945,sahilprasad,2,0.00074,95942,35.49280,270314
2946,saintyun,2,0.00074,95944,35.49354,270314
2947,saisona,2,0.00074,95946,35.49428,270314
2948,sajid-moinuddin,2,0.00074,95948,35.49502,270314
2949,samuda2019,2,0.00074,95950,35.49576,270314
2950,sasi-patha,2,0.00074,95952,35.49650,270314
2951,sathishvj,2,0.00074,95954,35.49724,270314
2952,satish-dops94,2,0.00074,95956,35.49798,270314
2953,sav116,2,0.00074,95958,35.49872,270314
2954,sciai-ai,2,0.00074,95960,35.49946,270314
2955,sculd,2,0.00074,95962,35.50020,270314
2956,seekyiyi,2,0.00074,95964,35.50094,270314
2957,Sergiodiaz53-Dedalus,2,0.00074,95966,35.50168,270314
2958,sethjones,2,0.00074,95968,35.50242,270314
2959,sethjuarez,2,0.00074,95970,35.50316,270314
2960,sfc-gh-adlee,2,0.00074,95972,35.50390,270314
2961,ShahNewazKhan,2,0.00074,95974,35.50464,270314
2962,shankyz,2,0.00074,95976,35.50538,270314
2963,shivakumargowda12,2,0.00074,95978,35.50612,270314
2964,shreya-verma19,2,0.00074,95980,35.50685,270314
2965,shubamsharma,2,0.00074,95982,35.50759,270314
2966,shuiqiangchen,2,0.00074,95984,35.50833,270314
2967,Sillians,2,0.00074,95986,35.50907,270314
2968,simdynamic,2,0.00074,95988,35.50981,270314
2969,sinban04,2,0.00074,95990,35.51055,270314
2970,sindhudeloitte,2,0.00074,95992,35.51129,270314
2971,SirBubbls,2,0.00074,95994,35.51203,270314
2972,sirkkalap,2,0.00074,95996,35.51277,270314
2973,siva2k16,2,0.00074,95998,35.51351,270314
2974,skliarpawlo,2,0.00074,96000,35.51425,270314
2975,Sliceco,2,0.00074,96002,35.51499,270314
2976,smalhot9464,2,0.00074,96004,35.51573,270314
2977,smandrell-ec,2,0.00074,96006,35.51647,270314
2978,smathalikunnel,2,0.00074,96008,35.51721,270314
2979,Smlight,2,0.00074,96010,35.51795,270314
2980,snekkalapudi,2,0.00074,96012,35.51869,270314
2981,Sobolvitya,2,0.00074,96014,35.51943,270314
2982,soogui,2,0.00074,96016,35.52017,270314
2983,sravi999,2,0.00074,96018,35.52091,270314
2984,SrinivasGuntupalli,2,0.00074,96020,35.52165,270314
2985,srmeier,2,0.00074,96022,35.52239,270314
2986,ssbagalkar,2,0.00074,96024,35.52313,270314
2987,sssyyw,2,0.00074,96026,35.52387,270314
2988,stalamoni,2,0.00074,96028,35.52461,270314
2989,stevemanavalan,2,0.00074,96030,35.52535,270314
2990,stevencasey,2,0.00074,96032,35.52609,270314
2991,stewartadam,2,0.00074,96034,35.52683,270314
2992,strump,2,0.00074,96036,35.52757,270314
2993,subrnath,2,0.00074,96038,35.52831,270314
2994,subsid,2,0.00074,96040,35.52905,270314
2995,suluner,2,0.00074,96042,35.52979,270314
2996,sumanassarmathg,2,0.00074,96044,35.53053,270314
2997,suminb,2,0.00074,96046,35.53127,270314
2998,Sundragon1993,2,0.00074,96048,35.53201,270314
2999,supernan1994,2,0.00074,96050,35.53275,270314
3000,surajphulara,2,0.00074,96052,35.53349,270314
3001,svnoesis,2,0.00074,96054,35.53423,270314
3002,svz77,2,0.00074,96056,35.53497,270314
3003,swarajoturkar,2,0.00074,96058,35.53571,270314
3004,swartz-k,2,0.00074,96060,35.53645,270314
3005,sxbfundi,2,0.00074,96062,35.53719,270314
3006,syd-quant,2,0.00074,96064,35.53793,270314
3007,taffarel-gaivota,2,0.00074,96066,35.53867,270314
3008,tahesse,2,0.00074,96068,35.53941,270314
3009,TahirHayat,2,0.00074,96070,35.54015,270314
3010,talk2jaydip,2,0.00074,96072,35.54089,270314
3011,TanjaDuPlessis,2,0.00074,96074,35.54163,270314
3012,tanken,2,0.00074,96076,35.54237,270314
3013,TarunJana,2,0.00074,96078,35.54311,270314
3014,tautrimas,2,0.00074,96080,35.54385,270314
3015,taylanates24,2,0.00074,96082,35.54459,270314
3016,tchaton,2,0.00074,96084,35.54533,270314
3017,TDehaene,2,0.00074,96086,35.54607,270314
3018,techjacker,2,0.00074,96088,35.54681,270314
3019,telpirion,2,0.00074,96090,35.54755,270314
3020,tereketeketitaka,2,0.00074,96092,35.54829,270314
3021,thameemk612,2,0.00074,96094,35.54903,270314
3022,thanhpt55,2,0.00074,96096,35.54977,270314
3023,theathibm,2,0.00074,96098,35.55051,270314
3024,TheDutchDevil,2,0.00074,96100,35.55125,270314
3025,themummy,2,0.00074,96102,35.55199,270314
3026,Tieriko,2,0.00074,96104,35.55273,270314
3027,tim5chneider,2,0.00074,96106,35.55347,270314
3028,timofal,2,0.00074,96108,35.55421,270314
3029,tingzhang-ming,2,0.00074,96110,35.55495,270314
3030,tinkerer,2,0.00074,96112,35.55569,270314
3031,tirkarthi,2,0.00074,96114,35.55643,270314
3032,tjmonsi,2,0.00074,96116,35.55717,270314
3033,TKorr,2,0.00074,96118,35.55791,270314
3034,tmerrittsmith,2,0.00074,96120,35.55865,270314
3035,tomaszstachera,2,0.00074,96122,35.55939,270314
3036,tom-dd,2,0.00074,96124,35.56013,270314
3037,TomVanWemmel,2,0.00074,96126,35.56087,270314
3038,tonykim-moloco,2,0.00074,96128,35.56161,270314
3039,tonywang-sh,2,0.00074,96130,35.56235,270314
3040,TonyZZhang,2,0.00074,96132,35.56309,270314
3041,trieuat,2,0.00074,96134,35.56383,270314
3042,TRINHHOANGANH,2,0.00074,96136,35.56457,270314
3043,trmbdevops,2,0.00074,96138,35.56531,270314
3044,tulsi0523,2,0.00074,96140,35.56605,270314
3045,Tutj,2,0.00074,96142,35.56679,270314
3046,tvkpz,2,0.00074,96144,35.56753,270314
3047,tvtv511,2,0.00074,96146,35.56827,270314
3048,UllasShanthakumar,2,0.00074,96148,35.56900,270314
3049,unagaraju88,2,0.00074,96150,35.56974,270314
3050,unix-way,2,0.00074,96152,35.57048,270314
3051,unnown,2,0.00074,96154,35.57122,270314
3052,urekalion,2,0.00074,96156,35.57196,270314
3053,vahidtz,2,0.00074,96158,35.57270,270314
3054,ValentinVerkhohliad,2,0.00074,96160,35.57344,270314
3055,vamshikrishna9505,2,0.00074,96162,35.57418,270314
3056,Vaskozl,2,0.00074,96164,35.57492,270314
3057,veiii,2,0.00074,96166,35.57566,270314
3058,victoriavilasb,2,0.00074,96168,35.57640,270314
3059,vietanhdev,2,0.00074,96170,35.57714,270314
3060,vigneshsolution,2,0.00074,96172,35.57788,270314
3061,vijayreddybo,2,0.00074,96174,35.57862,270314
3062,vikashg,2,0.00074,96176,35.57936,270314
3063,viktoriaas,2,0.00074,96178,35.58010,270314
3064,vimalkansal,2,0.00074,96180,35.58084,270314
3065,vishalsantv,2,0.00074,96182,35.58158,270314
3066,vivekjainmaiet,2,0.00074,96184,35.58232,270314
3067,vivekpd15,2,0.00074,96186,35.58306,270314
3068,vlordier,2,0.00074,96188,35.58380,270314
3069,v-loves-avocados,2,0.00074,96190,35.58454,270314
3070,vmarkovtsev,2,0.00074,96192,35.58528,270314
3071,vovawed,2,0.00074,96194,35.58602,270314
3072,vulong3896,2,0.00074,96196,35.58676,270314
3073,waelCh,2,0.00074,96198,35.58750,270314
3074,WalidMustapha,2,0.00074,96200,35.58824,270314
3075,walkerjian,2,0.00074,96202,35.58898,270314
3076,wallwind,2,0.00074,96204,35.58972,270314
3077,walterhuangio,2,0.00074,96206,35.59046,270314
3078,wangjun1974,2,0.00074,96208,35.59120,270314
3079,wangli1426,2,0.00074,96210,35.59194,270314
3080,wangpengfei984597422,2,0.00074,96212,35.59268,270314
3081,wangzy0327,2,0.00074,96214,35.59342,270314
3082,Wesley-Miller,2,0.00074,96216,35.59416,270314
3083,wfangchi,2,0.00074,96218,35.59490,270314
3084,whigy,2,0.00074,96220,35.59564,270314
3085,whycircle,2,0.00074,96222,35.59638,270314
3086,wiktorof,2,0.00074,96224,35.59712,270314
3087,wildermuthn,2,0.00074,96226,35.59786,270314
3088,will-gerard,2,0.00074,96228,35.59860,270314
3089,williamyeh,2,0.00074,96230,35.59934,270314
3090,windkit,2,0.00074,96232,35.60008,270314
3091,wlongxiang,2,0.00074,96234,35.60082,270314
3092,wuchen03,2,0.00074,96236,35.60156,270314
3093,wujie1993,2,0.00074,96238,35.60230,270314
3094,wuyinzhenjun,2,0.00074,96240,35.60304,270314
3095,wxyzyu,2,0.00074,96242,35.60378,270314
3096,WyattGorman,2,0.00074,96244,35.60452,270314
3097,wybaron,2,0.00074,96246,35.60526,270314
3098,wzamazon,2,0.00074,96248,35.60600,270314
3099,wzhou18,2,0.00074,96250,35.60674,270314
3100,xiaopang1001,2,0.00074,96252,35.60748,270314
3101,xujingyissa,2,0.00074,96254,35.60822,270314
3102,yaboo-oyabu,2,0.00074,96256,35.60896,270314
3103,yadavvij,2,0.00074,96258,35.60970,270314
3104,yannhowe,2,0.00074,96260,35.61044,270314
3105,yanspirit,2,0.00074,96262,35.61118,270314
3106,yanwu2014,2,0.00074,96264,35.61192,270314
3107,yaobaiwei,2,0.00074,96266,35.61266,270314
3108,yaser-hameed,2,0.00074,96268,35.61340,270314
3109,yasersakkaf,2,0.00074,96270,35.61414,270314
3110,yingfeng,2,0.00074,96272,35.61488,270314
3111,youngMan4,2,0.00074,96274,35.61562,270314
3112,yousefis,2,0.00074,96276,35.61636,270314
3113,YousefRabi,2,0.00074,96278,35.61710,270314
3114,youxingtian,2,0.00074,96280,35.61784,270314
3115,yshalabi,2,0.00074,96282,35.61858,270314
3116,yuezhilanyi,2,0.00074,96284,35.61932,270314
3117,Yu-Wang-Datatonic,2,0.00074,96286,35.62006,270314
3118,yuyue9284,2,0.00074,96288,35.62080,270314
3119,yves-altaml,2,0.00074,96290,35.62154,270314
3120,YY007H,2,0.00074,96292,35.62228,270314
3121,YYStreet,2,0.00074,96294,35.62302,270314
3122,yzhangswingman,2,0.00074,96296,35.62376,270314
3123,zclyne,2,0.00074,96298,35.62450,270314
3124,zeeros,2,0.00074,96300,35.62524,270314
3125,zehni,2,0.00074,96302,35.62598,270314
3126,zeldebro,2,0.00074,96304,35.62672,270314
3127,zemarx,2,0.00074,96306,35.62746,270314
3128,ZhangYuguo,2,0.00074,96308,35.62820,270314
3129,Zhiyuancheng,2,0.00074,96310,35.62894,270314
3130,zrlaida,2,0.00074,96312,35.62968,270314
3131,zyxcambridge,2,0.00074,96314,35.63041,270314
3132,zzvara,2,0.00074,96316,35.63115,270314
3133,1202zhyl,1,0.00037,96317,35.63152,270314
3134,12DReflections,1,0.00037,96318,35.63189,270314
3135,15379180,1,0.00037,96319,35.63226,270314
3136,1920853199,1,0.00037,96320,35.63263,270314
3137,360DigiTMG-Training,1,0.00037,96321,35.63300,270314
3138,3Xpl0it3r,1,0.00037,96322,35.63337,270314
3139,4j4y,1,0.00037,96323,35.63374,270314
3140,4vik,1,0.00037,96324,35.63411,270314
3141,535727234,1,0.00037,96325,35.63448,270314
3142,5HAD0W-P1R4T3,1,0.00037,96326,35.63485,270314
3143,626626cdllp,1,0.00037,96327,35.63522,270314
3144,636,1,0.00037,96328,35.63559,270314
3145,912988434,1,0.00037,96329,35.63596,270314
3146,916264367,1,0.00037,96330,35.63633,270314
3147,980956031,1,0.00037,96331,35.63670,270314
3148,a097253,1,0.00037,96332,35.63707,270314
3149,Aachunella,1,0.00037,96333,35.63744,270314
3150,aadityak33,1,0.00037,96334,35.63781,270314
3151,aaron-nall,1,0.00037,96335,35.63818,270314
3152,AaronUST,1,0.00037,96336,35.63855,270314
3153,aarthipa,1,0.00037,96337,35.63892,270314
3154,AbdallahAboelela,1,0.00037,96338,35.63929,270314
3155,abdulari,1,0.00037,96339,35.63966,270314
3156,abdullah-saal,1,0.00037,96340,35.64003,270314
3157,abhijeetchauhan,1,0.00037,96341,35.64040,270314
3158,abhijitk123,1,0.00037,96342,35.64077,270314
3159,abhishekchakladar-tc,1,0.00037,96343,35.64114,270314
3160,abhishek-tyagi87,1,0.00037,96344,35.64151,270314
3161,abhishekvermasg,1,0.00037,96345,35.64188,270314
3162,abieler,1,0.00037,96346,35.64225,270314
3163,abinthomasonline,1,0.00037,96347,35.64262,270314
3164,AboorvaDevarajan,1,0.00037,96348,35.64299,270314
3165,ACAVJW4H,1,0.00037,96349,35.64336,270314
3166,accraze,1,0.00037,96350,35.64373,270314
3167,achikars,1,0.00037,96351,35.64410,270314
3168,achoreim,1,0.00037,96352,35.64447,270314
3169,ACodingfreak,1,0.00037,96353,35.64484,270314
3170,adam-burns,1,0.00037,96354,35.64521,270314
3171,adampilz,1,0.00037,96355,35.64558,270314
3172,adam-wasserman,1,0.00037,96356,35.64595,270314
3173,Adedolapo-Akin,1,0.00037,96357,35.64632,270314
3174,AdeshKhandait,1,0.00037,96358,35.64669,270314
3175,aditipatil0711,1,0.00037,96359,35.64706,270314
3176,adobemomo,1,0.00037,96360,35.64743,270314
3177,adollar,1,0.00037,96361,35.64780,270314
3178,adrianchia,1,0.00037,96362,35.64817,270314
3179,afk42,1,0.00037,96363,35.64854,270314
3180,ag2-debug,1,0.00037,96364,35.64891,270314
3181,aganesan94,1,0.00037,96365,35.64928,270314
3182,AGrzes,1,0.00037,96366,35.64965,270314
3183,ahmedelmahy,1,0.00037,96367,35.65002,270314
3184,Ahsansyed713,1,0.00037,96368,35.65039,270314
3185,aidangomez,1,0.00037,96369,35.65076,270314
3186,aii-shanker-jj,1,0.00037,96370,35.65113,270314
3187,aikow,1,0.00037,96371,35.65150,270314
3188,aimldl,1,0.00037,96372,35.65187,270314
3189,aishwary09,1,0.00037,96373,35.65224,270314
3190,aivanou,1,0.00037,96374,35.65261,270314
3191,ajaykamal3,1,0.00037,96375,35.65298,270314
3192,ajpotts,1,0.00037,96376,35.65335,270314
3193,akangst,1,0.00037,96377,35.65372,270314
3194,akbari-ali,1,0.00037,96378,35.65409,270314
3195,akhilvinvent,1,0.00037,96379,35.65446,270314
3196,akilman,1,0.00037,96380,35.65483,270314
3197,akkolwalkar,1,0.00037,96381,35.65520,270314
3198,Akmazad,1,0.00037,96382,35.65557,270314
3199,akonneker,1,0.00037,96383,35.65594,270314
3200,akramIOT,1,0.00037,96384,35.65631,270314
3201,Aksh97,1,0.00037,96385,35.65668,270314
3202,akshayc11,1,0.00037,96386,35.65705,270314
3203,akulkailwoo,1,0.00037,96387,35.65742,270314
3204,alangordon258,1,0.00037,96388,35.65779,270314
3205,AlanHau,1,0.00037,96389,35.65816,270314
3206,alasdairtran,1,0.00037,96390,35.65853,270314
3207,albertshx,1,0.00037,96391,35.65890,270314
3208,Alec-Zebrick,1,0.00037,96392,35.65927,270314
3209,AlendeGeraldo,1,0.00037,96393,35.65964,270314
3210,Alessthana,1,0.00037,96394,35.66001,270314
3211,alexanderDoria,1,0.00037,96395,35.66038,270314
3212,Alexander-Rogin,1,0.00037,96396,35.66075,270314
3213,AlexBulankou,1,0.00037,96397,35.66112,270314
3214,alexchenfeng,1,0.00037,96398,35.66149,270314
3215,alexchrisramos,1,0.00037,96399,35.66186,270314
3216,AlexLuya,1,0.00037,96400,35.66223,270314
3217,AlexZhangHF,1,0.00037,96401,35.66260,270314
3218,alexZsss,1,0.00037,96402,35.66297,270314
3219,alf-icc,1,0.00037,96403,35.66334,270314
3220,algermissen,1,0.00037,96404,35.66371,270314
3221,Ali771025,1,0.00037,96405,35.66408,270314
3222,aliasmee,1,0.00037,96406,35.66445,270314
3223,alikhurram42000,1,0.00037,96407,35.66482,270314
3224,alirezaahmadibeni,1,0.00037,96408,35.66519,270314
3225,alka-roy,1,0.00037,96409,35.66556,270314
3226,Altair3,1,0.00037,96410,35.66593,270314
3227,Alvin4550,1,0.00037,96411,35.66630,270314
3228,alvisememo,1,0.00037,96412,35.66667,270314
3229,AlwaysLearningMore,1,0.00037,96413,35.66704,270314
3230,Amaan5624,1,0.00037,96414,35.66741,270314
3231,amclay,1,0.00037,96415,35.66778,270314
3232,amercier-twt,1,0.00037,96416,35.66815,270314
3233,amigniox,1,0.00037,96417,35.66852,270314
3234,AmineHosni,1,0.00037,96418,35.66889,270314
3235,amitk75,1,0.00037,96419,35.66926,270314
3236,amitnjha,1,0.00037,96420,35.66963,270314
3237,amitza,1,0.00037,96421,35.67000,270314
3238,amorenocb,1,0.00037,96422,35.67037,270314
3239,a-m-thomas,1,0.00037,96423,35.67074,270314
3240,analyticalmonk,1,0.00037,96424,35.67111,270314
3241,AndersonML,1,0.00037,96425,35.67148,270314
3242,andjedani,1,0.00037,96426,35.67185,270314
3243,andodet,1,0.00037,96427,35.67222,270314
3244,andrejlukic,1,0.00037,96428,35.67259,270314
3245,Andreluizfc,1,0.00037,96429,35.67296,270314
3246,AndrewAlscher,1,0.00037,96430,35.67333,270314
3247,andrewcheny,1,0.00037,96431,35.67370,270314
3248,andrewisplinghoff,1,0.00037,96432,35.67407,270314
3249,andrewmorrison-sky,1,0.00037,96433,35.67444,270314
3250,andrewrreed,1,0.00037,96434,35.67481,270314
3251,andrew-veriga,1,0.00037,96435,35.67518,270314
3252,Andy546,1,0.00037,96436,35.67555,270314
3253,andytwigg,1,0.00037,96437,35.67592,270314
3254,andyz168,1,0.00037,96438,35.67629,270314
3255,aneeshc-c,1,0.00037,96439,35.67666,270314
3256,Anh-BK,1,0.00037,96440,35.67703,270314
3257,anil-pandey-mpf,1,0.00037,96441,35.67740,270314
3258,anirbanlahiri2017,1,0.00037,96442,35.67777,270314
3259,anirudhkm,1,0.00037,96443,35.67814,270314
3260,anitaokoh,1,0.00037,96444,35.67851,270314
3261,AnixPasBesoin,1,0.00037,96445,35.67888,270314
3262,AnkilP,1,0.00037,96446,35.67925,270314
3263,ankita4AI,1,0.00037,96447,35.67962,270314
3264,ankitaggarwal011,1,0.00037,96448,35.67999,270314
3265,ankitsingi,1,0.00037,96449,35.68036,270314
3266,Ankk98,1,0.00037,96450,35.68073,270314
3267,ankur6ue,1,0.00037,96451,35.68110,270314
3268,Anshuljh,1,0.00037,96452,35.68147,270314
3269,anskanwe,1,0.00037,96453,35.68184,270314
3270,Ans-pro,1,0.00037,96454,35.68221,270314
3271,answer3y,1,0.00037,96455,35.68258,270314
3272,anthonydillon,1,0.00037,96456,35.68295,270314
3273,antnsi,1,0.00037,96457,35.68332,270314
3274,anton-wundeman,1,0.00037,96458,35.68369,270314
3275,anupamag,1,0.00037,96459,35.68406,270314
3276,anyname2,1,0.00037,96460,35.68443,270314
3277,aoen,1,0.00037,96461,35.68480,270314
3278,aoliu95,1,0.00037,96462,35.68517,270314
3279,apeccaud,1,0.00037,96463,35.68554,270314
3280,ApoorvaSuresh-Audi,1,0.00037,96464,35.68591,270314
3281,A-Pot,1,0.00037,96465,35.68628,270314
3282,AppleHolic,1,0.00037,96466,35.68665,270314
3283,Aqdashashmii,1,0.00037,96467,35.68702,270314
3284,Aravinviju,1,0.00037,96468,35.68739,270314
3285,archanainapudi,1,0.00037,96469,35.68776,270314
3286,areiner-novetta,1,0.00037,96470,35.68813,270314
3287,arpitsharma-hexad,1,0.00037,96471,35.68850,270314
3288,arshsidana98,1,0.00037,96472,35.68887,270314
3289,arturnn,1,0.00037,96473,35.68924,270314
3290,ArunRamakani,1,0.00037,96474,35.68961,270314
3291,arviCV,1,0.00037,96475,35.68998,270314
3292,arya-oss,1,0.00037,96476,35.69035,270314
3293,As20075,1,0.00037,96477,35.69072,270314
3294,asaff1,1,0.00037,96478,35.69109,270314
3295,ashishbhatnagar02,1,0.00037,96479,35.69146,270314
3296,ashishML,1,0.00037,96480,35.69183,270314
3297,AshutoshDongare,1,0.00037,96481,35.69220,270314
3298,ashvinmoro,1,0.00037,96482,35.69256,270314
3299,Ashwin-Ramesh2607,1,0.00037,96483,35.69293,270314
3300,asiricml,1,0.00037,96484,35.69330,270314
3301,askaupup,1,0.00037,96485,35.69367,270314
3302,astanzys-vinted,1,0.00037,96486,35.69404,270314
3303,atch841,1,0.00037,96487,35.69441,270314
3304,atharva-18,1,0.00037,96488,35.69478,270314
3305,atrakriv,1,0.00037,96489,35.69515,270314
3306,Atreus-Technologies,1,0.00037,96490,35.69552,270314
3307,atsuik,1,0.00037,96491,35.69589,270314
3308,attackordie,1,0.00037,96492,35.69626,270314
3309,AtulKhomane,1,0.00037,96493,35.69663,270314
3310,atulyadavtech,1,0.00037,96494,35.69700,270314
3311,augustogb,1,0.00037,96495,35.69737,270314
3312,authenticfake,1,0.00037,96496,35.69774,270314
3313,avanish-chaubey,1,0.00037,96497,35.69811,270314
3314,averagua,1,0.00037,96498,35.69848,270314
3315,a-vinod,1,0.00037,96499,35.69885,270314
3316,avishniakov,1,0.00037,96500,35.69922,270314
3317,avizmil,1,0.00037,96501,35.69959,270314
3318,avloss,1,0.00037,96502,35.69996,270314
3319,AVShukshin,1,0.00037,96503,35.70033,270314
3320,awakia,1,0.00037,96504,35.70070,270314
3321,AxeZhan,1,0.00037,96505,35.70107,270314
3322,Axxxlllll,1,0.00037,96506,35.70144,270314
3323,ayoubelmimouni,1,0.00037,96507,35.70181,270314
3324,aytuns,1,0.00037,96508,35.70218,270314
3325,AzdinKab,1,0.00037,96509,35.70255,270314
3326,azelezni,1,0.00037,96510,35.70292,270314
3327,AzevedoB,1,0.00037,96511,35.70329,270314
3328,azuredevopsguy,1,0.00037,96512,35.70366,270314
3329,azurelysium,1,0.00037,96513,35.70403,270314
3330,b02202050,1,0.00037,96514,35.70440,270314
3331,babu-selector,1,0.00037,96515,35.70477,270314
3332,BabycolaYang,1,0.00037,96516,35.70514,270314
3333,backyes,1,0.00037,96517,35.70551,270314
3334,BACtaki,1,0.00037,96518,35.70588,270314
3335,BaisKasep012,1,0.00037,96519,35.70625,270314
3336,bandi900811,1,0.00037,96520,35.70662,270314
3337,bandurin-strike,1,0.00037,96521,35.70699,270314
3338,bansal01yash,1,0.00037,96522,35.70736,270314
3339,Basirkhanofficial34,1,0.00037,96523,35.70773,270314
3340,bassel-z,1,0.00037,96524,35.70810,270314
3341,bassplay3r,1,0.00037,96525,35.70847,270314
3342,basti-j,1,0.00037,96526,35.70884,270314
3343,batigooal,1,0.00037,96527,35.70921,270314
3344,bauagonzo,1,0.00037,96528,35.70958,270314
3345,baxteran,1,0.00037,96529,35.70995,270314
3346,bd12,1,0.00037,96530,35.71032,270314
3347,Bear1110,1,0.00037,96531,35.71069,270314
3348,bellship24,1,0.00037,96532,35.71106,270314
3349,beltelml,1,0.00037,96533,35.71143,270314
3350,benbouillet,1,0.00037,96534,35.71180,270314
3351,benhamner,1,0.00037,96535,35.71217,270314
3352,benhyy,1,0.00037,96536,35.71254,270314
3353,benlaor38,1,0.00037,96537,35.71291,270314
3354,benmathes,1,0.00037,96538,35.71328,270314
3355,berglh,1,0.00037,96539,35.71365,270314
3356,bgossey,1,0.00037,96540,35.71402,270314
3357,bharathkkb,1,0.00037,96541,35.71439,270314
3358,bigdatamlai,1,0.00037,96542,35.71476,270314
3359,bigdimple,1,0.00037,96543,35.71513,270314
3360,bitcqs,1,0.00037,96544,35.71550,270314
3361,bix709,1,0.00037,96545,35.71587,270314
3362,bjones325,1,0.00037,96546,35.71624,270314
3363,blaisethom,1,0.00037,96547,35.71661,270314
3364,blancsw,1,0.00037,96548,35.71698,270314
3365,blazickjoe,1,0.00037,96549,35.71735,270314
3366,bligching512,1,0.00037,96550,35.71772,270314
3367,bmccord2,1,0.00037,96551,35.71809,270314
3368,bmorphism,1,0.00037,96552,35.71846,270314
3369,bmv3cg,1,0.00037,96553,35.71883,270314
3370,boczekbartek,1,0.00037,96554,35.71920,270314
3371,boersmamarcel,1,0.00037,96555,35.71957,270314
3372,BoHuang2018,1,0.00037,96556,35.71994,270314
3373,Boimkimi,1,0.00037,96557,35.72031,270314
3374,BonavincciAI2020,1,0.00037,96558,35.72068,270314
3375,Borda,1,0.00037,96559,35.72105,270314
3376,boriskovalev,1,0.00037,96560,35.72142,270314
3377,botasb,1,0.00037,96561,35.72179,270314
3378,botingw,1,0.00037,96562,35.72216,270314
3379,bottumjosh,1,0.00037,96563,35.72253,270314
3380,boufleur,1,0.00037,96564,35.72290,270314
3381,bpoti,1,0.00037,96565,35.72327,270314
3382,BrandonLiang,1,0.00037,96566,35.72364,270314
3383,brendangadd,1,0.00037,96567,35.72401,270314
3384,briandrutledge,1,0.00037,96568,35.72438,270314
3385,brightlee6,1,0.00037,96569,35.72475,270314
3386,brilhana,1,0.00037,96570,35.72512,270314
3387,brt-timseries,1,0.00037,96571,35.72549,270314
3388,bruceche11,1,0.00037,96572,35.72586,270314
3389,bruceding,1,0.00037,96573,35.72623,270314
3390,BrunoChauvet,1,0.00037,96574,35.72660,270314
3391,bryant-rh,1,0.00037,96575,35.72697,270314
3392,bsingarayan,1,0.00037,96576,35.72734,270314
3393,Bud-ds,1,0.00037,96577,35.72771,270314
3394,buildlackey,1,0.00037,96578,35.72808,270314
3395,bumberboy,1,0.00037,96579,35.72845,270314
3396,burtenshaw,1,0.00037,96580,35.72882,270314
3397,bybatkhuu,1,0.00037,96581,35.72919,270314
3398,caijimin,1,0.00037,96582,35.72956,270314
3399,calvin11ung,1,0.00037,96583,35.72993,270314
3400,calvin-is-seksy,1,0.00037,96584,35.73030,270314
3401,carlose2108,1,0.00037,96585,35.73067,270314
3402,carloVentrella,1,0.00037,96586,35.73104,270314
3403,caseware66,1,0.00037,96587,35.73141,270314
3404,casperyap,1,0.00037,96588,35.73178,270314
3405,Cass0n,1,0.00037,96589,35.73215,270314
3406,cateto,1,0.00037,96590,35.73252,270314
3407,cbbba18,1,0.00037,96591,35.73289,270314
3408,cbchouinard,1,0.00037,96592,35.73326,270314
3409,ccastro-pedro,1,0.00037,96593,35.73363,270314
3410,ccdefreitas,1,0.00037,96594,35.73400,270314
3411,cenkbircanoglu,1,0.00037,96595,35.73437,270314
3412,cestum,1,0.00037,96596,35.73474,270314
3413,cf-chiang,1,0.00037,96597,35.73511,270314
3414,cfloressuazo,1,0.00037,96598,35.73548,270314
3415,cgawron1,1,0.00037,96599,35.73585,270314
3416,chadg818,1,0.00037,96600,35.73622,270314
3417,chajath,1,0.00037,96601,35.73659,270314
3418,championjared,1,0.00037,96602,35.73696,270314
3419,chandukotagiri1992,1,0.00037,96603,35.73733,270314
3420,chandurreddy91,1,0.00037,96604,35.73770,270314
3421,changchuming,1,0.00037,96605,35.73807,270314
3422,changhoekim,1,0.00037,96606,35.73844,270314
3423,changqing,1,0.00037,96607,35.73881,270314
3424,chanhz,1,0.00037,96608,35.73918,270314
3425,charlesccychen,1,0.00037,96609,35.73955,270314
3426,charlieyang1557,1,0.00037,96610,35.73992,270314
3427,chboudry,1,0.00037,96611,35.74029,270314
3428,cheesev,1,0.00037,96612,35.74066,270314
3429,chelomontilla,1,0.00037,96613,35.74103,270314
3430,chengleqi,1,0.00037,96614,35.74140,270314
3431,chengsky-NTU,1,0.00037,96615,35.74177,270314
3432,chenjr0719,1,0.00037,96616,35.74214,270314
3433,chenwenyan,1,0.00037,96617,35.74251,270314
3434,cheny-alf,1,0.00037,96618,35.74288,270314
3435,chenyuzhi459,1,0.00037,96619,35.74325,270314
3436,chepkoyallan,1,0.00037,96620,35.74362,270314
3437,cheungringo,1,0.00037,96621,35.74399,270314
3438,chinaboy007,1,0.00037,96622,35.74436,270314
3439,chitravsnair,1,0.00037,96623,35.74473,270314
3440,chmielas,1,0.00037,96624,35.74510,270314
3441,chongkong,1,0.00037,96625,35.74547,270314
3442,chongwangcc,1,0.00037,96626,35.74584,270314
3443,chrisalbon,1,0.00037,96627,35.74621,270314
3444,chrishmorris,1,0.00037,96628,35.74658,270314
3445,chrisrana,1,0.00037,96629,35.74695,270314
3446,Christian-Jansen,1,0.00037,96630,35.74732,270314
3447,Christina-Young,1,0.00037,96631,35.74769,270314
3448,chris-zen,1,0.00037,96632,35.74806,270314
3449,chunfengzhao1,1,0.00037,96633,35.74843,270314
3450,chunjieChang,1,0.00037,96634,35.74880,270314
3451,ciderkim,1,0.00037,96635,35.74917,270314
3452,Ciro-Taranto,1,0.00037,96636,35.74954,270314
3453,ciscoai-prowbot,1,0.00037,96637,35.74991,270314
3454,cjjain813,1,0.00037,96638,35.75028,270314
3455,closerforever,1,0.00037,96639,35.75065,270314
3456,cmhkjuwan,1,0.00037,96640,35.75102,270314
3457,cnegron-nv,1,0.00037,96641,35.75139,270314
3458,coalindiax,1,0.00037,96642,35.75176,270314
3459,codebeard1,1,0.00037,96643,35.75213,270314
3460,codebreach,1,0.00037,96644,35.75250,270314
3461,CodeLingoTeam,1,0.00037,96645,35.75287,270314
3462,coldtomatojuice,1,0.00037,96646,35.75324,270314
3463,colinfindlay-nz,1,0.00037,96647,35.75361,270314
3464,Collinbrown95,1,0.00037,96648,35.75398,270314
3465,colmantse,1,0.00037,96649,35.75434,270314
3466,ColmBhandal,1,0.00037,96650,35.75471,270314
3467,conchitagoogle,1,0.00037,96651,35.75508,270314
3468,connor-swanson,1,0.00037,96652,35.75545,270314
3469,cottrell,1,0.00037,96653,35.75582,270314
3470,cpcgoogle,1,0.00037,96654,35.75619,270314
3471,Cplo,1,0.00037,96655,35.75656,270314
3472,cquptEthan,1,0.00037,96656,35.75693,270314
3473,CR1SceNT,1,0.00037,96657,35.75730,270314
3474,craigjmidwinter,1,0.00037,96658,35.75767,270314
3475,creddy123,1,0.00037,96659,35.75804,270314
3476,cromagnonninja,1,0.00037,96660,35.75841,270314
3477,crsawyer314,1,0.00037,96661,35.75878,270314
3478,CSberger,1,0.00037,96662,35.75915,270314
3479,cschieberle,1,0.00037,96663,35.75952,270314
3480,cslovell,1,0.00037,96664,35.75989,270314
3481,CSP197,1,0.00037,96665,35.76026,270314
3482,cutiechi,1,0.00037,96666,35.76063,270314
3483,cutlass90,1,0.00037,96667,35.76100,270314
3484,cwu24,1,0.00037,96668,35.76137,270314
3485,cy89,1,0.00037,96669,35.76174,270314
3486,CybervisionVolodymyrPogorelov,1,0.00037,96670,35.76211,270314
3487,cyliu0204,1,0.00037,96671,35.76248,270314
3488,cymarechal-devoteam,1,0.00037,96672,35.76285,270314
3489,cyniczhi,1,0.00037,96673,35.76322,270314
3490,cyprnose,1,0.00037,96674,35.76359,270314
3491,cyrano5614,1,0.00037,96675,35.76396,270314
3492,czz2018,1,0.00037,96676,35.76433,270314
3493,daanyalmalik,1,0.00037,96677,35.76470,270314
3494,daenuprobst,1,0.00037,96678,35.76507,270314
3495,daftping,1,0.00037,96679,35.76544,270314
3496,dagilgon,1,0.00037,96680,35.76581,270314
3497,dailong,1,0.00037,96681,35.76618,270314
3498,DaleSin,1,0.00037,96682,35.76655,270314
3499,dalvarezsmiet,1,0.00037,96683,35.76692,270314
3500,damien75,1,0.00037,96684,35.76729,270314
3501,damngamerz,1,0.00037,96685,35.76766,270314
3502,danasaur,1,0.00037,96686,35.76803,270314
3503,daniel985,1,0.00037,96687,35.76840,270314
3504,daniel-bejarano,1,0.00037,96688,35.76877,270314
3505,danielbraun89,1,0.00037,96689,35.76914,270314
3506,danielecordano,1,0.00037,96690,35.76951,270314
3507,danielmhair,1,0.00037,96691,35.76988,270314
3508,DanielSCon40,1,0.00037,96692,35.77025,270314
3509,danrzs,1,0.00037,96693,35.77062,270314
3510,danvaida,1,0.00037,96694,35.77099,270314
3511,darack1234,1,0.00037,96695,35.77136,270314
3512,darthkabelo,1,0.00037,96696,35.77173,270314
3513,datafuel,1,0.00037,96697,35.77210,270314
3514,data-infra,1,0.00037,96698,35.77247,270314
3515,datasciencedani,1,0.00037,96699,35.77284,270314
3516,davidawad,1,0.00037,96700,35.77321,270314
3517,davidbellemare,1,0.00037,96701,35.77358,270314
3518,David-Bess,1,0.00037,96702,35.77395,270314
3519,David-LiCause,1,0.00037,96703,35.77432,270314
3520,davidparks21,1,0.00037,96704,35.77469,270314
3521,dbuades,1,0.00037,96705,35.77506,270314
3522,debmalya4,1,0.00037,96706,35.77543,270314
3523,deeco,1,0.00037,96707,35.77580,270314
3524,deepakpate07,1,0.00037,96708,35.77617,270314
3525,DeepFlame-JR,1,0.00037,96709,35.77654,270314
3526,deepika-cpml,1,0.00037,96710,35.77691,270314
3527,DeepTalk19,1,0.00037,96711,35.77728,270314
3528,deinal,1,0.00037,96712,35.77765,270314
3529,dellelce,1,0.00037,96713,35.77802,270314
3530,denfromufa,1,0.00037,96714,35.77839,270314
3531,dengpanyin,1,0.00037,96715,35.77876,270314
3532,denispeyrusaubes,1,0.00037,96716,35.77913,270314
3533,denisvorotyntsevunity,1,0.00037,96717,35.77950,270314
3534,dennisTGC,1,0.00037,96718,35.77987,270314
3535,derenrich,1,0.00037,96719,35.78024,270314
3536,Deseram,1,0.00037,96720,35.78061,270314
3537,devilmetal,1,0.00037,96721,35.78098,270314
3538,devlp121,1,0.00037,96722,35.78135,270314
3539,devrivne,1,0.00037,96723,35.78172,270314
3540,dfeldell,1,0.00037,96724,35.78209,270314
3541,dfisk,1,0.00037,96725,35.78246,270314
3542,dg424,1,0.00037,96726,35.78283,270314
3543,dgrahn,1,0.00037,96727,35.78320,270314
3544,DhanunjayElluri,1,0.00037,96728,35.78357,270314
3545,dhfromkorea,1,0.00037,96729,35.78394,270314
3546,dhirschfeld,1,0.00037,96730,35.78431,270314
3547,dholmesreed,1,0.00037,96731,35.78468,270314
3548,dhruvilmehta,1,0.00037,96732,35.78505,270314
3549,dhruvpratapsingh,1,0.00037,96733,35.78542,270314
3550,Dhull442,1,0.00037,96734,35.78579,270314
3551,dianeo-mit,1,0.00037,96735,35.78616,270314
3552,Dibel,1,0.00037,96736,35.78653,270314
3553,diegolovison,1,0.00037,96737,35.78690,270314
3554,dirtyValera,1,0.00037,96738,35.78727,270314
3555,dithyrambe,1,0.00037,96739,35.78764,270314
3556,divjyotsinghanzx,1,0.00037,96740,35.78801,270314
3557,divyank000,1,0.00037,96741,35.78838,270314
3558,divyaprabha123,1,0.00037,96742,35.78875,270314
3559,divya-r-kamat,1,0.00037,96743,35.78912,270314
3560,Djmcflush,1,0.00037,96744,35.78949,270314
3561,djmcgreal,1,0.00037,96745,35.78986,270314
3562,djmcgreal-cc,1,0.00037,96746,35.79023,270314
3563,dkmiller,1,0.00037,96747,35.79060,270314
3564,dkowsley,1,0.00037,96748,35.79097,270314
3565,dlkaai,1,0.00037,96749,35.79134,270314
3566,dmerz75,1,0.00037,96750,35.79171,270314
3567,dmonson,1,0.00037,96751,35.79208,270314
3568,dmytro212,1,0.00037,96752,35.79245,270314
3569,dobrinsky,1,0.00037,96753,35.79282,270314
3570,dojoeisuke,1,0.00037,96754,35.79319,270314
3571,DomenicoCostantino,1,0.00037,96755,35.79356,270314
3572,dommgifer,1,0.00037,96756,35.79393,270314
3573,dongzaimatou,1,0.00037,96757,35.79430,270314
3574,donnyv12,1,0.00037,96758,35.79467,270314
3575,dontmint,1,0.00037,96759,35.79504,270314
3576,DontWorry33,1,0.00037,96760,35.79541,270314
3577,dotnetpiper,1,0.00037,96761,35.79578,270314
3578,dping1,1,0.00037,96762,35.79615,270314
3579,dragonofac,1,0.00037,96763,35.79652,270314
3580,dragonsongohan,1,0.00037,96764,35.79689,270314
3581,drsagitn,1,0.00037,96765,35.79726,270314
3582,drzl386,1,0.00037,96766,35.79763,270314
3583,dss77,1,0.00037,96767,35.79800,270314
3584,dt21e8,1,0.00037,96768,35.79837,270314
3585,dublincrow2020,1,0.00037,96769,35.79874,270314
3586,ducminhnguyen,1,0.00037,96770,35.79911,270314
3587,dumbjarvis,1,0.00037,96771,35.79948,270314
3588,Duske,1,0.00037,96772,35.79985,270314
3589,dvgopal,1,0.00037,96773,35.80022,270314
3590,dwhdai,1,0.00037,96774,35.80059,270314
3591,dwojcik92,1,0.00037,96775,35.80096,270314
3592,dwu926,1,0.00037,96776,35.80133,270314
3593,EALAAKH,1,0.00037,96777,35.80170,270314
3594,easadler,1,0.00037,96778,35.80207,270314
3595,easkerov,1,0.00037,96779,35.80244,270314
3596,echorocket,1,0.00037,96780,35.80281,270314
3597,edacostacambioupgrade,1,0.00037,96781,35.80318,270314
3598,edday1,1,0.00037,96782,35.80355,270314
3599,eddynelson,1,0.00037,96783,35.80392,270314
3600,edikmkoyan,1,0.00037,96784,35.80429,270314
3601,edmeister,1,0.00037,96785,35.80466,270314
3602,eduardchai,1,0.00037,96786,35.80503,270314
3603,EduardFazliev,1,0.00037,96787,35.80540,270314
3604,eduardovelludo,1,0.00037,96788,35.80577,270314
3605,edusporto,1,0.00037,96789,35.80614,270314
3606,edwardfung123,1,0.00037,96790,35.80651,270314
3607,edwardhuanghz,1,0.00037,96791,35.80688,270314
3608,edwardspc,1,0.00037,96792,35.80725,270314
3609,egkiastas,1,0.00037,96793,35.80762,270314
3610,ehudyonasi,1,0.00037,96794,35.80799,270314
3611,elamaran11,1,0.00037,96795,35.80836,270314
3612,elanv,1,0.00037,96796,35.80873,270314
3613,elegendre3,1,0.00037,96797,35.80910,270314
3614,ElijahMingLiu,1,0.00037,96798,35.80947,270314
3615,elilienstein,1,0.00037,96799,35.80984,270314
3616,elizgarcia5,1,0.00037,96800,35.81021,270314
3617,elsud,1,0.00037,96801,35.81058,270314
3618,elvinzhusiyu,1,0.00037,96802,35.81095,270314
3619,Ema93sh,1,0.00037,96803,35.81132,270314
3620,EMCP,1,0.00037,96804,35.81169,270314
3621,emilecaron,1,0.00037,96805,35.81206,270314
3622,emilyyujieli,1,0.00037,96806,35.81243,270314
3623,em-pe,1,0.00037,96807,35.81280,270314
3624,EnasBasset,1,0.00037,96808,35.81317,270314
3625,endurancetest20380119,1,0.00037,96809,35.81354,270314
3626,engineeryashsaxena,1,0.00037,96810,35.81391,270314
3627,entrpn,1,0.00037,96811,35.81428,270314
3628,erik78se,1,0.00037,96812,35.81465,270314
3629,eriklincoln,1,0.00037,96813,35.81502,270314
3630,Erikzzz,1,0.00037,96814,35.81539,270314
3631,Erin-Servian,1,0.00037,96815,35.81576,270314
3632,esantix,1,0.00037,96816,35.81612,270314
3633,eslerm,1,0.00037,96817,35.81649,270314
3634,estelleaf,1,0.00037,96818,35.81686,270314
3635,estrellafelipe,1,0.00037,96819,35.81723,270314
3636,ethanscho,1,0.00037,96820,35.81760,270314
3637,ethanyanjiali,1,0.00037,96821,35.81797,270314
3638,eugenebnd,1,0.00037,96822,35.81834,270314
3639,eumentis-pawan,1,0.00037,96823,35.81871,270314
3640,eunjilee,1,0.00037,96824,35.81908,270314
3641,evan9637,1,0.00037,96825,35.81945,270314
3642,evandekieft,1,0.00037,96826,35.81982,270314
3643,ever1022,1,0.00037,96827,35.82019,270314
3644,everettvody,1,0.00037,96828,35.82056,270314
3645,ewasserman,1,0.00037,96829,35.82093,270314
3646,Excelight,1,0.00037,96830,35.82130,270314
3647,F36,1,0.00037,96831,35.82167,270314
3648,fafa92,1,0.00037,96832,35.82204,270314
3649,fahdrazavi,1,0.00037,96833,35.82241,270314
3650,fajaryanw,1,0.00037,96834,35.82278,270314
3651,Fan-SJ,1,0.00037,96835,35.82315,270314
3652,fanzhe328,1,0.00037,96836,35.82352,270314
3653,FarshadMovahed-REISys,1,0.00037,96837,35.82389,270314
3654,FatalLin,1,0.00037,96838,35.82426,270314
3655,fatihkorhan,1,0.00037,96839,35.82463,270314
3656,fatkun,1,0.00037,96840,35.82500,270314
3657,fbraza,1,0.00037,96841,35.82537,270314
3658,fedeesku,1,0.00037,96842,35.82574,270314
3659,felix-exel,1,0.00037,96843,35.82611,270314
3660,FelixGruener,1,0.00037,96844,35.82648,270314
3661,FellowNico,1,0.00037,96845,35.82685,270314
3662,fenghejingchi,1,0.00037,96846,35.82722,270314
3663,fengpinghu,1,0.00037,96847,35.82759,270314
3664,ferenc-hechler,1,0.00037,96848,35.82796,270314
3665,fhirschmann,1,0.00037,96849,35.82833,270314
3666,filipe-cantarelli,1,0.00037,96850,35.82870,270314
3667,finallyRaunak,1,0.00037,96851,35.82907,270314
3668,fireproofsocks,1,0.00037,96852,35.82944,270314
3669,FishJoey,1,0.00037,96853,35.82981,270314
3670,flacombe,1,0.00037,96854,35.83018,270314
3671,fojtami1,1,0.00037,96855,35.83055,270314
3672,fooozhe,1,0.00037,96856,35.83092,270314
3673,francisfuzz,1,0.00037,96857,35.83129,270314
3674,francoisserra,1,0.00037,96858,35.83166,270314
3675,FranCorsini,1,0.00037,96859,35.83203,270314
3676,Franky12,1,0.00037,96860,35.83240,270314
3677,frederikfab,1,0.00037,96861,35.83277,270314
3678,Freezaa9,1,0.00037,96862,35.83314,270314
3679,fryzhykau,1,0.00037,96863,35.83351,270314
3680,FullDataAlchemist,1,0.00037,96864,35.83388,270314
3681,fullprocess,1,0.00037,96865,35.83425,270314
3682,futeng,1,0.00037,96866,35.83462,270314
3683,futurexskill,1,0.00037,96867,35.83499,270314
3684,Fvegini,1,0.00037,96868,35.83536,270314
3685,fzhurd,1,0.00037,96869,35.83573,270314
3686,gabrielgcbs,1,0.00037,96870,35.83610,270314
3687,gabriellemadden,1,0.00037,96871,35.83647,270314
3688,gabrielmbmb,1,0.00037,96872,35.83684,270314
3689,Gajendran27,1,0.00037,96873,35.83721,270314
3690,galebm1004,1,0.00037,96874,35.83758,270314
3691,GaneshHulyal,1,0.00037,96875,35.83795,270314
3692,GarethLewin,1,0.00037,96876,35.83832,270314
3693,gauravpawar13,1,0.00037,96877,35.83869,270314
3694,GayatriNair229,1,0.00037,96878,35.83906,270314
3695,gbark13,1,0.00037,96879,35.83943,270314
3696,GDegrove,1,0.00037,96880,35.83980,270314
3697,geier,1,0.00037,96881,35.84017,270314
3698,Gekho457,1,0.00037,96882,35.84054,270314
3699,geooff,1,0.00037,96883,35.84091,270314
3700,GeorgeGeng,1,0.00037,96884,35.84128,270314
3701,get2prab,1,0.00037,96885,35.84165,270314
3702,GezimSejdiu,1,0.00037,96886,35.84202,270314
3703,GG-yuki,1,0.00037,96887,35.84239,270314
3704,giladwa1,1,0.00037,96888,35.84276,270314
3705,GilGonong,1,0.00037,96889,35.84313,270314
3706,githubwua,1,0.00037,96890,35.84350,270314
3707,GiuliaMassimetti,1,0.00037,96891,35.84387,270314
3708,glotzerhotze,1,0.00037,96892,35.84424,270314
3709,gmatev,1,0.00037,96893,35.84461,270314
3710,gmjonker,1,0.00037,96894,35.84498,270314
3711,gniewus,1,0.00037,96895,35.84535,270314
3712,gnsantos,1,0.00037,96896,35.84572,270314
3713,goanto,1,0.00037,96897,35.84609,270314
3714,gokhancetinkaya,1,0.00037,96898,35.84646,270314
3715,goldenberg,1,0.00037,96899,35.84683,270314
3716,goloxxly,1,0.00037,96900,35.84720,270314
3717,gooddayforever,1,0.00037,96901,35.84757,270314
3718,gorinars,1,0.00037,96902,35.84794,270314
3719,gpfvic,1,0.00037,96903,35.84831,270314
3720,gpoulin-hopper,1,0.00037,96904,35.84868,270314
3721,greg-liner,1,0.00037,96905,35.84905,270314
3722,gringParis,1,0.00037,96906,35.84942,270314
3723,grmoktan,1,0.00037,96907,35.84979,270314
3724,Gross613,1,0.00037,96908,35.85016,270314
3725,gs-sam,1,0.00037,96909,35.85053,270314
3726,gstoner,1,0.00037,96910,35.85090,270314
3727,gtoullier,1,0.00037,96911,35.85127,270314
3728,guanghui0607,1,0.00037,96912,35.85164,270314
3729,guo897654050,1,0.00037,96913,35.85201,270314
3730,gyant,1,0.00037,96914,35.85238,270314
3731,h4gen,1,0.00037,96915,35.85275,270314
3732,habmat,1,0.00037,96916,35.85312,270314
3733,hacktmz,1,0.00037,96917,35.85349,270314
3734,hade94,1,0.00037,96918,35.85386,270314
3735,haifeng-jin,1,0.00037,96919,35.85423,270314
3736,haim-co-moonactive,1,0.00037,96920,35.85460,270314
3737,hakimliang,1,0.00037,96921,35.85497,270314
3738,halegreen,1,0.00037,96922,35.85534,270314
3739,HaloKim,1,0.00037,96923,35.85571,270314
3740,Hamidmsa,1,0.00037,96924,35.85608,270314
3741,hamko,1,0.00037,96925,35.85645,270314
3742,hanakawamomo,1,0.00037,96926,35.85682,270314
3743,hancelpv,1,0.00037,96927,35.85719,270314
3744,hank6086,1,0.00037,96928,35.85756,270314
3745,haohao667788,1,0.00037,96929,35.85793,270314
3746,HaoWangDL,1,0.00037,96930,35.85830,270314
3747,HarborZeng,1,0.00037,96931,35.85867,270314
3748,harchali,1,0.00037,96932,35.85904,270314
3749,haresh-chudgar,1,0.00037,96933,35.85941,270314
3750,HarryCaveMan,1,0.00037,96934,35.85978,270314
3751,harryliu123,1,0.00037,96935,35.86015,270314
3752,harshalkwagh,1,0.00037,96936,35.86052,270314
3753,harshalmittal4,1,0.00037,96937,35.86089,270314
3754,HassaanAkbar,1,0.00037,96938,35.86126,270314
3755,hassanzia32,1,0.00037,96939,35.86163,270314
3756,hayato-maki,1,0.00037,96940,35.86200,270314
3757,Hayyk,1,0.00037,96941,35.86237,270314
3758,hbarrington,1,0.00037,96942,35.86274,270314
3759,Hedingber,1,0.00037,96943,35.86311,270314
3760,hejiahuan1412,1,0.00037,96944,35.86348,270314
3761,HelenCousins,1,0.00037,96945,35.86385,270314
3762,helkhalfi,1,0.00037,96946,35.86422,270314
3763,Hellekin87,1,0.00037,96947,35.86459,270314
3764,helloxjade,1,0.00037,96948,35.86496,270314
3765,heqinw,1,0.00037,96949,35.86533,270314
3766,hexerei,1,0.00037,96950,35.86570,270314
3767,heyawhite,1,0.00037,96951,35.86607,270314
3768,hfurkanvural,1,0.00037,96952,35.86644,270314
3769,hhhyunwoo,1,0.00037,96953,35.86681,270314
3770,hienqnguyen,1,0.00037,96954,35.86718,270314
3771,HilbertSpecs,1,0.00037,96955,35.86755,270314
3772,himanshu238,1,0.00037,96956,35.86792,270314
3773,Hirosora,1,0.00037,96957,35.86829,270314
3774,hjyoite,1,0.00037,96958,35.86866,270314
3775,hlld3344,1,0.00037,96959,35.86903,270314
3776,hmdsatoshi,1,0.00037,96960,35.86940,270314
3777,hnakagawa,1,0.00037,96961,35.86977,270314
3778,hollyhutson,1,0.00037,96962,35.87014,270314
3779,hongzhao-signifyd,1,0.00037,96963,35.87051,270314
3780,horatiu-negutoiu,1,0.00037,96964,35.87088,270314
3781,Houyon,1,0.00037,96965,35.87125,270314
3782,hpspringboy,1,0.00037,96966,35.87162,270314
3783,Hrishkesh,1,0.00037,96967,35.87199,270314
3784,huangjiasingle,1,0.00037,96968,35.87236,270314
3785,hubchub,1,0.00037,96969,35.87273,270314
3786,hubertg1122,1,0.00037,96970,35.87310,270314
3787,hubrix,1,0.00037,96971,35.87347,270314
3788,hughmiao,1,0.00037,96972,35.87384,270314
3789,hugovk,1,0.00037,96973,35.87421,270314
3790,huihuang2015,1,0.00037,96974,35.87458,270314
3791,humantargetjoe,1,0.00037,96975,35.87495,270314
3792,hungrysushi,1,0.00037,96976,35.87532,270314
3793,hydeta,1,0.00037,96977,35.87569,270314
3794,hylick,1,0.00037,96978,35.87606,270314
3795,hyoseon-agile,1,0.00037,96979,35.87643,270314
3796,hzy001,1,0.00037,96980,35.87680,270314
3797,iant04128591,1,0.00037,96981,35.87717,270314
3798,ianycxu,1,0.00037,96982,35.87754,270314
3799,iassenegal221,1,0.00037,96983,35.87790,270314
3800,ibnummuhammad,1,0.00037,96984,35.87827,270314
3801,ICDS-Offering,1,0.00037,96985,35.87864,270314
3802,ichbinjakes,1,0.00037,96986,35.87901,270314
3803,ido-trumer,1,0.00037,96987,35.87938,270314
3804,ifs-imaddjelaili,1,0.00037,96988,35.87975,270314
3805,igmik,1,0.00037,96989,35.88012,270314
3806,igorvalko,1,0.00037,96990,35.88049,270314
3807,IgorZan,1,0.00037,96991,35.88086,270314
3808,ilaria-speranza,1,0.00037,96992,35.88123,270314
3809,ilkelma,1,0.00037,96993,35.88160,270314
3810,ILLUM1N0X,1,0.00037,96994,35.88197,270314
3811,ilyinon,1,0.00037,96995,35.88234,270314
3812,imamika,1,0.00037,96996,35.88271,270314
3813,imantha-a,1,0.00037,96997,35.88308,270314
3814,imilos,1,0.00037,96998,35.88345,270314
3815,imnotaqtpie,1,0.00037,96999,35.88382,270314
3816,impravin22,1,0.00037,97000,35.88419,270314
3817,imrehg,1,0.00037,97001,35.88456,270314
3818,imsazzad,1,0.00037,97002,35.88493,270314
3819,Imsurajkr,1,0.00037,97003,35.88530,270314
3820,InsertCoolNameHere,1,0.00037,97004,35.88567,270314
3821,inspurasc,1,0.00037,97005,35.88604,270314
3822,ipal0,1,0.00037,97006,35.88641,270314
3823,is185089,1,0.00037,97007,35.88678,270314
3824,Isaacwhyuenac,1,0.00037,97008,35.88715,270314
3825,itmwiw,1,0.00037,97009,35.88752,270314
3826,itshevtsov,1,0.00037,97010,35.88789,270314
3827,itsymbol,1,0.00037,97011,35.88826,270314
3828,IvySong2016,1,0.00037,97012,35.88863,270314
3829,izhaomeng,1,0.00037,97013,35.88900,270314
3830,j0hnL,1,0.00037,97014,35.88937,270314
3831,jackhawa,1,0.00037,97015,35.88974,270314
3832,jackielyc,1,0.00037,97016,35.89011,270314
3833,jackychow,1,0.00037,97017,35.89048,270314
3834,jackyin68,1,0.00037,97018,35.89085,270314
3835,jacquev6,1,0.00037,97019,35.89122,270314
3836,jaejuning,1,0.00037,97020,35.89159,270314
3837,jagan120,1,0.00037,97021,35.89196,270314
3838,jagusztinl,1,0.00037,97022,35.89233,270314
3839,jaKjH101,1,0.00037,97023,35.89270,270314
3840,jamesdhope,1,0.00037,97024,35.89307,270314
3841,jamylak,1,0.00037,97025,35.89344,270314
3842,jarednielsen,1,0.00037,97026,35.89381,270314
3843,jariolehtonen,1,0.00037,97027,35.89418,270314
3844,JasonChen86899,1,0.00037,97028,35.89455,270314
3845,jasongrout,1,0.00037,97029,35.89492,270314
3846,JasonLee925,1,0.00037,97030,35.89529,270314
3847,JasonTam,1,0.00037,97031,35.89566,270314
3848,jay-manday,1,0.00037,97032,35.89603,270314
3849,jbx,1,0.00037,97033,35.89640,270314
3850,jchaudari,1,0.00037,97034,35.89677,270314
3851,jchavezar,1,0.00037,97035,35.89714,270314
3852,jckwon,1,0.00037,97036,35.89751,270314
3853,jdstrand,1,0.00037,97037,35.89788,270314
3854,jenoOvchi,1,0.00037,97038,35.89825,270314
3855,Jenya95,1,0.00037,97039,35.89862,270314
3856,jeremiahkellick,1,0.00037,97040,35.89899,270314
3857,JeremyKeusters,1,0.00037,97041,35.89936,270314
3858,jerriezhou,1,0.00037,97042,35.89973,270314
3859,jerrygb,1,0.00037,97043,35.90010,270314
3860,jetmuffin,1,0.00037,97044,35.90047,270314
3861,jfantell,1,0.00037,97045,35.90084,270314
3862,jgerardsimcock,1,0.00037,97046,35.90121,270314
3863,JGoo1,1,0.00037,97047,35.90158,270314
3864,jgoodman8,1,0.00037,97048,35.90195,270314
3865,jhdxr,1,0.00037,97049,35.90232,270314
3866,jhisse,1,0.00037,97050,35.90269,270314
3867,jhkcia,1,0.00037,97051,35.90306,270314
3868,jhs2jhs,1,0.00037,97052,35.90343,270314
3869,jhtobigs,1,0.00037,97053,35.90380,270314
3870,jianwu-github,1,0.00037,97054,35.90417,270314
3871,JiaxuanYang,1,0.00037,97055,35.90454,270314
3872,jie8357IOII,1,0.00037,97056,35.90491,270314
3873,JIElite,1,0.00037,97057,35.90528,270314
3874,jieunchoi1120,1,0.00037,97058,35.90565,270314
3875,jimmyguerrero,1,0.00037,97059,35.90602,270314
3876,jingong2105,1,0.00037,97060,35.90639,270314
3877,jinoobaek-qz,1,0.00037,97061,35.90676,270314
3878,jintojose72,1,0.00037,97062,35.90713,270314
3879,jiuchen1986,1,0.00037,97063,35.90750,270314
3880,jj-794,1,0.00037,97064,35.90787,270314
3881,jjhursey,1,0.00037,97065,35.90824,270314
3882,jkeen871,1,0.00037,97066,35.90861,270314
3883,jkl0898,1,0.00037,97067,35.90898,270314
3884,jkwak3,1,0.00037,97068,35.90935,270314
3885,jlu1202,1,0.00037,97069,35.90972,270314
3886,jlzhang93,1,0.00037,97070,35.91009,270314
3887,jmsmkn,1,0.00037,97071,35.91046,270314
3888,jmurphs14,1,0.00037,97072,35.91083,270314
3889,jocelynbaduria,1,0.00037,97073,35.91120,270314
3890,jocieA,1,0.00037,97074,35.91157,270314
3891,jodavis-suse,1,0.00037,97075,35.91194,270314
3892,Jodo-skywalker,1,0.00037,97076,35.91231,270314
3893,joeatlas007,1,0.00037,97077,35.91268,270314
3894,joemal1234,1,0.00037,97078,35.91305,270314
3895,joeyaza,1,0.00037,97079,35.91342,270314
3896,JohnMBrandt,1,0.00037,97080,35.91379,270314
3897,John-Tate,1,0.00037,97081,35.91416,270314
3898,johnzhou2011,1,0.00037,97082,35.91453,270314
3899,joinalahmed,1,0.00037,97083,35.91490,270314
3900,jojomomo88754,1,0.00037,97084,35.91527,270314
3901,jonashartwig,1,0.00037,97085,35.91564,270314
3902,JonasTischer,1,0.00037,97086,35.91601,270314
3903,jonathan1920,1,0.00037,97087,35.91638,270314
3904,jonathan-bendov,1,0.00037,97088,35.91675,270314
3905,jondoering,1,0.00037,97089,35.91712,270314
3906,joneepenk,1,0.00037,97090,35.91749,270314
3907,jonf78,1,0.00037,97091,35.91786,270314
3908,joostgp,1,0.00037,97092,35.91823,270314
3909,Joostrothweiler,1,0.00037,97093,35.91860,270314
3910,jordwalke,1,0.00037,97094,35.91897,270314
3911,jordyantunes,1,0.00037,97095,35.91934,270314
3912,journey-wang,1,0.00037,97096,35.91971,270314
3913,jppgks,1,0.00037,97097,35.92008,270314
3914,jramos,1,0.00037,97098,35.92045,270314
3915,jrgirona,1,0.00037,97099,35.92082,270314
3916,jsga,1,0.00037,97100,35.92119,270314
3917,jtanios,1,0.00037,97101,35.92156,270314
3918,Juandavi1,1,0.00037,97102,35.92193,270314
3919,judyliou,1,0.00037,97103,35.92230,270314
3920,JulesBelveze,1,0.00037,97104,35.92267,270314
3921,julianmack,1,0.00037,97105,35.92304,270314
3922,Julian-Mata,1,0.00037,97106,35.92341,270314
3923,Juntai,1,0.00037,97107,35.92378,270314
3924,just-an-intern,1,0.00037,97108,35.92415,270314
3925,Justin-Blau,1,0.00037,97109,35.92452,270314
3926,jwkim912,1,0.00037,97110,35.92489,270314
3927,jynx10,1,0.00037,97111,35.92526,270314
3928,Jyonn,1,0.00037,97112,35.92563,270314
3929,Jyothipyxis,1,0.00037,97113,35.92600,270314
3930,jzf2101,1,0.00037,97114,35.92637,270314
3931,k1m743hyun,1,0.00037,97115,35.92674,270314
3932,k3aibot,1,0.00037,97116,35.92711,270314
3933,kaben,1,0.00037,97117,35.92748,270314
3934,kachris,1,0.00037,97118,35.92785,270314
3935,kai910120,1,0.00037,97119,35.92822,270314
3936,kaiwaehner,1,0.00037,97120,35.92859,270314
3937,Kaka1127,1,0.00037,97121,35.92896,270314
3938,KakarotSonGokuShenron,1,0.00037,97122,35.92933,270314
3939,KannanThiru,1,0.00037,97123,35.92970,270314
3940,kant,1,0.00037,97124,35.93007,270314
3941,kaoutar55,1,0.00037,97125,35.93044,270314
3942,Kapalov,1,0.00037,97126,35.93081,270314
3943,KaranKhirsariya,1,0.00037,97127,35.93118,270314
3944,karan-kumar-by,1,0.00037,97128,35.93155,270314
3945,KarolisKont,1,0.00037,97129,35.93192,270314
3946,Katherinechenlove,1,0.00037,97130,35.93229,270314
3947,katherinez22,1,0.00037,97131,35.93266,270314
3948,katsiapis,1,0.00037,97132,35.93303,270314
3949,katylava,1,0.00037,97133,35.93340,270314
3950,KaulitzGuimaraes,1,0.00037,97134,35.93377,270314
3951,kavanshukla,1,0.00037,97135,35.93414,270314
3952,Kavee30,1,0.00037,97136,35.93451,270314
3953,KaviyaPeriyasamy,1,0.00037,97137,35.93488,270314
3954,kawai-kobold,1,0.00037,97138,35.93525,270314
3955,kawo123,1,0.00037,97139,35.93562,270314
3956,ka-zo,1,0.00037,97140,35.93599,270314
3957,kbd2011,1,0.00037,97141,35.93636,270314
3958,kbegiedza,1,0.00037,97142,35.93673,270314
3959,kciy,1,0.00037,97143,35.93710,270314
3960,kdecyllene,1,0.00037,97144,35.93747,270314
3961,kdrivas,1,0.00037,97145,35.93784,270314
3962,kdunee,1,0.00037,97146,35.93821,270314
3963,kedarX,1,0.00037,97147,35.93858,270314
3964,keeyzar,1,0.00037,97148,35.93895,270314
3965,keiichiroy,1,0.00037,97149,35.93932,270314
3966,keisuke-umezawa,1,0.00037,97150,35.93968,270314
3967,keithpij,1,0.00037,97151,35.94005,270314
3968,kellen,1,0.00037,97152,35.94042,270314
3969,kenlmf,1,0.00037,97153,35.94079,270314
3970,keremgocen,1,0.00037,97154,35.94116,270314
3971,k-e-r-n-e-l-p-a-n-i-c,1,0.00037,97155,35.94153,270314
3972,kevin2107,1,0.00037,97156,35.94190,270314
3973,kevin-bates,1,0.00037,97157,35.94227,270314
3974,kevinleewy,1,0.00037,97158,35.94264,270314
3975,kfkelvinng,1,0.00037,97159,35.94301,270314
3976,khoward,1,0.00037,97160,35.94338,270314
3977,kiddie92,1,0.00037,97161,35.94375,270314
3978,kilmarnock,1,0.00037,97162,35.94412,270314
3979,KION-ThomasMay,1,0.00037,97163,35.94449,270314
3980,KIShaoKIS,1,0.00037,97164,35.94486,270314
3981,kitamura-tetsuo,1,0.00037,97165,35.94523,270314
3982,kjaugustin,1,0.00037,97166,35.94560,270314
3983,kkumar137,1,0.00037,97167,35.94597,270314
3984,klaimane,1,0.00037,97168,35.94634,270314
3985,klee989,1,0.00037,97169,35.94671,270314
3986,klentabistado,1,0.00037,97170,35.94708,270314
3987,klolos,1,0.00037,97171,35.94745,270314
3988,knjk04,1,0.00037,97172,35.94782,270314
3989,knlp,1,0.00037,97173,35.94819,270314
3990,kong62,1,0.00037,97174,35.94856,270314
3991,kozhukalov,1,0.00037,97175,35.94893,270314
3992,Kr0n0,1,0.00037,97176,35.94930,270314
3993,krish7919,1,0.00037,97177,35.94967,270314
3994,Krishanu2001,1,0.00037,97178,35.95004,270314
3995,krishnakarra,1,0.00037,97179,35.95041,270314
3996,ksheerasagar17,1,0.00037,97180,35.95078,270314
3997,kudla,1,0.00037,97181,35.95115,270314
3998,kujon,1,0.00037,97182,35.95152,270314
3999,kujyp,1,0.00037,97183,35.95189,270314
4000,kungfuchicken,1,0.00037,97184,35.95226,270314
4001,kuromt,1,0.00037,97185,35.95263,270314
4002,kusirajiv,1,0.00037,97186,35.95300,270314
4003,kylebeni,1,0.00037,97187,35.95337,270314
4004,kyzy540,1,0.00037,97188,35.95374,270314
4005,kzygmans,1,0.00037,97189,35.95411,270314
4006,laibruce,1,0.00037,97190,35.95448,270314
4007,lamberta,1,0.00037,97191,35.95485,270314
4008,LamoraHolmes,1,0.00037,97192,35.95522,270314
4009,LaoLiulaoliu,1,0.00037,97193,35.95559,270314
4010,laurenskz,1,0.00037,97194,35.95596,270314
4011,laurentgrangeau,1,0.00037,97195,35.95633,270314
4012,l-baker,1,0.00037,97196,35.95670,270314
4013,leafmulch,1,0.00037,97197,35.95707,270314
4014,LeBaronDean,1,0.00037,97198,35.95744,270314
4015,lebiathan,1,0.00037,97199,35.95781,270314
4016,lenaherrmann-dfki,1,0.00037,97200,35.95818,270314
4017,leoliang1988,1,0.00037,97201,35.95855,270314
4018,leomzhong,1,0.00037,97202,35.95892,270314
4019,LeonardoEssence,1,0.00037,97203,35.95929,270314
4020,LetaoCh,1,0.00037,97204,35.95966,270314
4021,levitomer,1,0.00037,97205,35.96003,270314
4022,Lewiky,1,0.00037,97206,35.96040,270314
4023,lgarithm,1,0.00037,97207,35.96077,270314
4024,lhkkk,1,0.00037,97208,35.96114,270314
4025,liangxibing,1,0.00037,97209,35.96151,270314
4026,liaosiyang,1,0.00037,97210,35.96188,270314
4027,libgy8zli,1,0.00037,97211,35.96225,270314
4028,lifeandrew80,1,0.00037,97212,35.96262,270314
4029,liguodongiot,1,0.00037,97213,35.96299,270314
4030,liguodongIOT,1,0.00037,97214,35.96336,270314
4031,lildonpancho,1,0.00037,97215,35.96373,270314
4032,limbuu,1,0.00037,97216,35.96410,270314
4033,lions1988,1,0.00037,97217,35.96447,270314
4034,liudongqing,1,0.00037,97218,35.96484,270314
4035,liuyl,1,0.00037,97219,35.96521,270314
4036,livegenic-akyrychek,1,0.00037,97220,35.96558,270314
4037,ljstrnadiii,1,0.00037,97221,35.96595,270314
4038,lkr2des,1,0.00037,97222,35.96632,270314
4039,llhuii,1,0.00037,97223,35.96669,270314
4040,lokeshjain279,1,0.00037,97224,35.96706,270314
4041,lonnix,1,0.00037,97225,35.96743,270314
4042,lostangel556,1,0.00037,97226,35.96780,270314
4043,LoveQSYang,1,0.00037,97227,35.96817,270314
4044,loveunk,1,0.00037,97228,35.96854,270314
4045,lsh2366254,1,0.00037,97229,35.96891,270314
4046,ltdo111,1,0.00037,97230,35.96928,270314
4047,lucasc896,1,0.00037,97231,35.96965,270314
4048,lucastan5596,1,0.00037,97232,35.97002,270314
4049,lucastheis,1,0.00037,97233,35.97039,270314
4050,lucasvbalves,1,0.00037,97234,35.97076,270314
4051,luckyops,1,0.00037,97235,35.97113,270314
4052,luistrange,1,0.00037,97236,35.97150,270314
4053,lukepfister,1,0.00037,97237,35.97187,270314
4054,lukeyan2023,1,0.00037,97238,35.97224,270314
4055,lumi-docs,1,0.00037,97239,35.97261,270314
4056,luoxiaoxun,1,0.00037,97240,35.97298,270314
4057,m0hit-aggarwal,1,0.00037,97241,35.97335,270314
4058,m3at,1,0.00037,97242,35.97372,270314
4059,maartenpants,1,0.00037,97243,35.97409,270314
4060,Mack-y,1,0.00037,97244,35.97446,270314
4061,madfrog,1,0.00037,97245,35.97483,270314
4062,MadsAdrian,1,0.00037,97246,35.97520,270314
4063,mageru,1,0.00037,97247,35.97557,270314
4064,maggiemhanna,1,0.00037,97248,35.97594,270314
4065,magreenberg,1,0.00037,97249,35.97631,270314
4066,maiconmattos,1,0.00037,97250,35.97668,270314
4067,maitra100,1,0.00037,97251,35.97705,270314
4068,manishsingh003,1,0.00037,97252,35.97742,270314
4069,manojb7,1,0.00037,97253,35.97779,270314
4070,mapsacosta,1,0.00037,97254,35.97816,270314
4071,MarcandreBoulon,1,0.00037,97255,35.97853,270314
4072,marciojv,1,0.00037,97256,35.97890,270314
4073,marcossony,1,0.00037,97257,35.97927,270314
4074,markbluhm,1,0.00037,97258,35.97964,270314
4075,markcberman,1,0.00037,97259,35.98001,270314
4076,markellos-orfanos,1,0.00037,97260,35.98038,270314
4077,Markfelixm,1,0.00037,97261,35.98075,270314
4078,MarkusThill,1,0.00037,97262,35.98112,270314
4079,marlonmBoti,1,0.00037,97263,35.98149,270314
4080,martfl,1,0.00037,97264,35.98186,270314
4081,masapasa,1,0.00037,97265,35.98223,270314
4082,masoumi76,1,0.00037,97266,35.98260,270314
4083,massih10,1,0.00037,97267,35.98297,270314
4084,MasterofBisaster,1,0.00037,97268,35.98334,270314
4085,mat-ej,1,0.00037,97269,35.98371,270314
4086,mateusz-szczesny,1,0.00037,97270,35.98408,270314
4087,mathetes87,1,0.00037,97271,35.98445,270314
4088,matheusjerico,1,0.00037,97272,35.98482,270314
4089,MatheusPush,1,0.00037,97273,35.98519,270314
4090,mathis-marcotte,1,0.00037,97274,35.98556,270314
4091,matphilippe,1,0.00037,97275,35.98593,270314
4092,MatthewTafazoli,1,0.00037,97276,35.98630,270314
4093,Matthias-Winkeler-Fluke,1,0.00037,97277,35.98667,270314
4094,MauGeo,1,0.00037,97278,35.98704,270314
4095,maurogonzalez,1,0.00037,97279,35.98741,270314
4096,MaxBlanck,1,0.00037,97280,35.98778,270314
4097,MaxGdr,1,0.00037,97281,35.98815,270314
4098,maximmold,1,0.00037,97282,35.98852,270314
4099,MaximumQuasar,1,0.00037,97283,35.98889,270314
4100,maxisawesome,1,0.00037,97284,35.98926,270314
4101,maxjacu,1,0.00037,97285,35.98963,270314
4102,maxkaustav,1,0.00037,97286,35.99000,270314
4103,maxspanning,1,0.00037,97287,35.99037,270314
4104,maxtaq,1,0.00037,97288,35.99074,270314
4105,Mayuraggarwal1992,1,0.00037,97289,35.99111,270314
4106,Mayurji,1,0.00037,97290,35.99148,270314
4107,mbellphd,1,0.00037,97291,35.99185,270314
4108,mbittmann,1,0.00037,97292,35.99222,270314
4109,MBKraus,1,0.00037,97293,35.99259,270314
4110,mcberma,1,0.00037,97294,35.99296,270314
4111,MDARBAAJ,1,0.00037,97295,35.99333,270314
4112,mdemiy,1,0.00037,97296,35.99370,270314
4113,MedhaCS1010,1,0.00037,97297,35.99407,270314
4114,Meet-Vaishnav,1,0.00037,97298,35.99444,270314
4115,megawidget,1,0.00037,97299,35.99481,270314
4116,mehdiasefi,1,0.00037,97300,35.99518,270314
4117,mehul1811,1,0.00037,97301,35.99555,270314
4118,MeisterUrian,1,0.00037,97302,35.99592,270314
4119,meken,1,0.00037,97303,35.99629,270314
4120,melih-sqsp,1,0.00037,97304,35.99666,270314
4121,MEllis-github,1,0.00037,97305,35.99703,270314
4122,metafeather,1,0.00037,97306,35.99740,270314
4123,Metal-joker,1,0.00037,97307,35.99777,270314
4124,metanouvelle,1,0.00037,97308,35.99814,270314
4125,mFat7y,1,0.00037,97309,35.99851,270314
4126,mf-lit,1,0.00037,97310,35.99888,270314
4127,MGSousa,1,0.00037,97311,35.99925,270314
4128,mhh12121,1,0.00037,97312,35.99962,270314
4129,michael-EIP,1,0.00037,97313,35.99999,270314
4130,miguelalba96,1,0.00037,97314,36.00036,270314
4131,miguelvcsoares,1,0.00037,97315,36.00073,270314
4132,mihuross,1,0.00037,97316,36.00110,270314
4133,mikeaadd,1,0.00037,97317,36.00146,270314
4134,Mikedu1988,1,0.00037,97318,36.00183,270314
4135,mikeedjones,1,0.00037,97319,36.00220,270314
4136,Mike-no,1,0.00037,97320,36.00257,270314
4137,mikezuniga,1,0.00037,97321,36.00294,270314
4138,millstx,1,0.00037,97322,36.00331,270314
4139,minaadel,1,0.00037,97323,36.00368,270314
4140,minchang,1,0.00037,97324,36.00405,270314
4141,mingnet,1,0.00037,97325,36.00442,270314
4142,mingweiLIU,1,0.00037,97326,36.00479,270314
4143,mingyyy,1,0.00037,97327,36.00516,270314
4144,MingzhouZhou,1,0.00037,97328,36.00553,270314
4145,minhdang241,1,0.00037,97329,36.00590,270314
4146,MinhManPham,1,0.00037,97330,36.00627,270314
4147,missedone,1,0.00037,97331,36.00664,270314
4148,mistadrumma,1,0.00037,97332,36.00701,270314
4149,mitsuan,1,0.00037,97333,36.00738,270314
4150,miutamihai,1,0.00037,97334,36.00775,270314
4151,mjw2194,1,0.00037,97335,36.00812,270314
4152,mkrakow,1,0.00037,97336,36.00849,270314
4153,MLOpsWC,1,0.00037,97337,36.00886,270314
4154,mlu4679,1,0.00037,97338,36.00923,270314
4155,mlujan-strive,1,0.00037,97339,36.00960,270314
4156,mmlmahesh,1,0.00037,97340,36.00997,270314
4157,MoAmrYehia,1,0.00037,97341,36.01034,270314
4158,mobin102,1,0.00037,97342,36.01071,270314
4159,mohakamg,1,0.00037,97343,36.01108,270314
4160,mohamedakelportfolio,1,0.00037,97344,36.01145,270314
4161,mohamed-fazil-saleem,1,0.00037,97345,36.01182,270314
4162,mohamedniyaz1996,1,0.00037,97346,36.01219,270314
4163,mohandeepzumen,1,0.00037,97347,36.01256,270314
4164,mohdashifkhan,1,0.00037,97348,36.01293,270314
4165,momomobinx,1,0.00037,97349,36.01330,270314
4166,mongoose54,1,0.00037,97350,36.01367,270314
4167,monicatao,1,0.00037,97351,36.01404,270314
4168,MonikaVen,1,0.00037,97352,36.01441,270314
4169,moose007,1,0.00037,97353,36.01478,270314
4170,morelen17,1,0.00037,97354,36.01515,270314
4171,morningcloud,1,0.00037,97355,36.01552,270314
4172,mortezaalizadeh,1,0.00037,97356,36.01589,270314
4173,mostafabayat,1,0.00037,97357,36.01626,270314
4174,MotoRZR,1,0.00037,97358,36.01663,270314
4175,mpietrzy,1,0.00037,97359,36.01700,270314
4176,mpsapps,1,0.00037,97360,36.01737,270314
4177,MrMwalker2,1,0.00037,97361,36.01774,270314
4178,mro-aaskandani,1,0.00037,97362,36.01811,270314
4179,mrslnv,1,0.00037,97363,36.01848,270314
4180,msalehiNV,1,0.00037,97364,36.01885,270314
4181,msalvaris,1,0.00037,97365,36.01922,270314
4182,MSchauperl,1,0.00037,97366,36.01959,270314
4183,msiegler-google,1,0.00037,97367,36.01996,270314
4184,msinghg123,1,0.00037,97368,36.02033,270314
4185,msmendoza,1,0.00037,97369,36.02070,270314
4186,msteffen,1,0.00037,97370,36.02107,270314
4187,MStopa,1,0.00037,97371,36.02144,270314
4188,MTD-Telus,1,0.00037,97372,36.02181,270314
4189,mtoslalibu,1,0.00037,97373,36.02218,270314
4190,munro,1,0.00037,97374,36.02255,270314
4191,murilommen,1,0.00037,97375,36.02292,270314
4192,muyajil,1,0.00037,97376,36.02329,270314
4193,muzhi1991,1,0.00037,97377,36.02366,270314
4194,mygulamali,1,0.00037,97378,36.02403,270314
4195,myoshimu,1,0.00037,97379,36.02440,270314
4196,nadamakram,1,0.00037,97380,36.02477,270314
4197,nagautier,1,0.00037,97381,36.02514,270314
4198,naimadg,1,0.00037,97382,36.02551,270314
4199,nandita853,1,0.00037,97383,36.02588,270314
4200,nanliu,1,0.00037,97384,36.02625,270314
4201,naresh4u-gitrepo,1,0.00037,97385,36.02662,270314
4202,narfian,1,0.00037,97386,36.02699,270314
4203,narijeong,1,0.00037,97387,36.02736,270314
4204,natalian98,1,0.00037,97388,36.02773,270314
4205,Nateyo,1,0.00037,97389,36.02810,270314
4206,NathanNZ,1,0.00037,97390,36.02847,270314
4207,Nathicanaa,1,0.00037,97391,36.02884,270314
4208,navado,1,0.00037,97392,36.02921,270314
4209,Naveen-Jayaram,1,0.00037,97393,36.02958,270314
4210,Naveenkhasyap,1,0.00037,97394,36.02995,270314
4211,Naveenlbg,1,0.00037,97395,36.03032,270314
4212,navinger,1,0.00037,97396,36.03069,270314
4213,navneetkrc-aj,1,0.00037,97397,36.03106,270314
4214,naz19,1,0.00037,97398,36.03143,270314
4215,n-batalha,1,0.00037,97399,36.03180,270314
4216,neeharika4,1,0.00037,97400,36.03217,270314
4217,neelasha-09,1,0.00037,97401,36.03254,270314
4218,neerajkaushik,1,0.00037,97402,36.03291,270314
4219,nehakapila94,1,0.00037,97403,36.03328,270314
4220,nehal3731,1,0.00037,97404,36.03365,270314
4221,nelson2000,1,0.00037,97405,36.03402,270314
4222,Nenrikido,1,0.00037,97406,36.03439,270314
4223,nicbillen,1,0.00037,97407,36.03476,270314
4224,nichoio,1,0.00037,97408,36.03513,270314
4225,nicklausZJF,1,0.00037,97409,36.03550,270314
4226,niderhoff,1,0.00037,97410,36.03587,270314
4227,nieksand,1,0.00037,97411,36.03624,270314
4228,nielsdewulf,1,0.00037,97412,36.03661,270314
4229,nielsuit227,1,0.00037,97413,36.03698,270314
4230,NieRonghua,1,0.00037,97414,36.03735,270314
4231,nikhilbandi,1,0.00037,97415,36.03772,270314
4232,nikhil-das-katonic,1,0.00037,97416,36.03809,270314
4233,NikhilKanda,1,0.00037,97417,36.03846,270314
4234,nikitosl,1,0.00037,97418,36.03883,270314
4235,nilanjana2015,1,0.00037,97419,36.03920,270314
4236,ninja-tester,1,0.00037,97420,36.03957,270314
4237,Nintorac,1,0.00037,97421,36.03994,270314
4238,NiravSo,1,0.00037,97422,36.04031,270314
4239,nishi-t,1,0.00037,97423,36.04068,270314
4240,nithinkanil1,1,0.00037,97424,36.04105,270314
4241,nitishkrishna,1,0.00037,97425,36.04142,270314
4242,niuqg,1,0.00037,97426,36.04179,270314
4243,njriasan,1,0.00037,97427,36.04216,270314
4244,nlin-kobold,1,0.00037,97428,36.04253,270314
4245,nm2107,1,0.00037,97429,36.04290,270314
4246,NonStatic2014,1,0.00037,97430,36.04327,270314
4247,nsshah1288,1,0.00037,97431,36.04364,270314
4248,n-stout,1,0.00037,97432,36.04401,270314
4249,ntakouris,1,0.00037,97433,36.04438,270314
4250,ntenenz,1,0.00037,97434,36.04475,270314
4251,nturner-maritz,1,0.00037,97435,36.04512,270314
4252,Nuniemsis,1,0.00037,97436,36.04549,270314
4253,NurFaizin,1,0.00037,97437,36.04586,270314
4254,nurvenur12,1,0.00037,97438,36.04623,270314
4255,nyejon,1,0.00037,97439,36.04660,270314
4256,nzhang0430,1,0.00037,97440,36.04697,270314
4257,oak-tree,1,0.00037,97441,36.04734,270314
4258,odovad,1,0.00037,97442,36.04771,270314
4259,okeynikky,1,0.00037,97443,36.04808,270314
4260,okonmarcin,1,0.00037,97444,36.04845,270314
4261,olicantin,1,0.00037,97445,36.04882,270314
4262,oluies,1,0.00037,97446,36.04919,270314
4263,omar16100,1,0.00037,97447,36.04956,270314
4264,OmGraja,1,0.00037,97448,36.04993,270314
4265,ommmid,1,0.00037,97449,36.05030,270314
4266,OnTheRicky,1,0.00037,97450,36.05067,270314
4267,OonjuoO,1,0.00037,97451,36.05104,270314
4268,openrory,1,0.00037,97452,36.05141,270314
4269,opensrn,1,0.00037,97453,36.05178,270314
4270,openthings,1,0.00037,97454,36.05215,270314
4271,oquere,1,0.00037,97455,36.05252,270314
4272,Oranst,1,0.00037,97456,36.05289,270314
4273,OrrAvrech,1,0.00037,97457,36.05326,270314
4274,OscarLlorente,1,0.00037,97458,36.05363,270314
4275,oscarvilla,1,0.00037,97459,36.05400,270314
4276,oskar-j,1,0.00037,97460,36.05437,270314
4277,ottodolfo,1,0.00037,97461,36.05474,270314
4278,ovarene,1,0.00037,97462,36.05511,270314
4279,o-vexler,1,0.00037,97463,36.05548,270314
4280,ozen,1,0.00037,97464,36.05585,270314
4281,ozert,1,0.00037,97465,36.05622,270314
4282,ozturkosu,1,0.00037,97466,36.05659,270314
4283,pa8mm,1,0.00037,97467,36.05696,270314
4284,padrian,1,0.00037,97468,36.05733,270314
4285,pangiann,1,0.00037,97469,36.05770,270314
4286,pantelis,1,0.00037,97470,36.05807,270314
4287,parakhjain,1,0.00037,97471,36.05844,270314
4288,parallelo,1,0.00037,97472,36.05881,270314
4289,patel-om,1,0.00037,97473,36.05918,270314
4290,patsadow2,1,0.00037,97474,36.05955,270314
4291,paulbehrisch,1,0.00037,97475,36.05992,270314
4292,paulcrowley,1,0.00037,97476,36.06029,270314
4293,paulk8s,1,0.00037,97477,36.06066,270314
4294,paulkarayan,1,0.00037,97478,36.06103,270314
4295,paulomach,1,0.00037,97479,36.06140,270314
4296,PaulQbFeng,1,0.00037,97480,36.06177,270314
4297,pavelzhurov,1,0.00037,97481,36.06214,270314
4298,pcdas,1,0.00037,97482,36.06251,270314
4299,pencilerazzer,1,0.00037,97483,36.06288,270314
4300,peng09,1,0.00037,97484,36.06324,270314
4301,perdurabo93,1,0.00037,97485,36.06361,270314
4302,perseusyang1997,1,0.00037,97486,36.06398,270314
4303,peterbarty,1,0.00037,97487,36.06435,270314
4304,phatlast96,1,0.00037,97488,36.06472,270314
4305,Phelan164,1,0.00037,97489,36.06509,270314
4306,phiamazon,1,0.00037,97490,36.06546,270314
4307,PhilippeMarcotte,1,0.00037,97491,36.06583,270314
4308,philtremblay,1,0.00037,97492,36.06620,270314
4309,PhoenixLuo2,1,0.00037,97493,36.06657,270314
4310,piaobeizu,1,0.00037,97494,36.06694,270314
4311,pikadef,1,0.00037,97495,36.06731,270314
4312,piyongze,1,0.00037,97496,36.06768,270314
4313,pjh4993,1,0.00037,97497,36.06805,270314
4314,Planck0591,1,0.00037,97498,36.06842,270314
4315,plankthom,1,0.00037,97499,36.06879,270314
4316,Plataformaalgoritmica,1,0.00037,97500,36.06916,270314
4317,PLeusmann,1,0.00037,97501,36.06953,270314
4318,Poggecci,1,0.00037,97502,36.06990,270314
4319,porimol,1,0.00037,97503,36.07027,270314
4320,porimolchandro,1,0.00037,97504,36.07064,270314
4321,PouriaNikvand,1,0.00037,97505,36.07101,270314
4322,pourquoi42,1,0.00037,97506,36.07138,270314
4323,ppkube,1,0.00037,97507,36.07175,270314
4324,prabhat04011998,1,0.00037,97508,36.07212,270314
4325,prabhatsharma,1,0.00037,97509,36.07249,270314
4326,prabhu,1,0.00037,97510,36.07286,270314
4327,pradeepbhadani,1,0.00037,97511,36.07323,270314
4328,pradnyaborkar900,1,0.00037,97512,36.07360,270314
4329,prakashsingh21,1,0.00037,97513,36.07397,270314
4330,pranavaninadam,1,0.00037,97514,36.07434,270314
4331,pranay-ar,1,0.00037,97515,36.07471,270314
4332,pranaysawant,1,0.00037,97516,36.07508,270314
4333,prasannakumar-coupa,1,0.00037,97517,36.07545,270314
4334,prasannavj,1,0.00037,97518,36.07582,270314
4335,prashant2402,1,0.00037,97519,36.07619,270314
4336,pratikgujjar,1,0.00037,97520,36.07656,270314
4337,PratikStar,1,0.00037,97521,36.07693,270314
4338,pratyushpanda,1,0.00037,97522,36.07730,270314
4339,preska,1,0.00037,97523,36.07767,270314
4340,Priapos1004,1,0.00037,97524,36.07804,270314
4341,PrincewillIroka,1,0.00037,97525,36.07841,270314
4342,Priyanka4pc,1,0.00037,97526,36.07878,270314
4343,prutkin,1,0.00037,97527,36.07915,270314
4344,PsHughes,1,0.00037,97528,36.07952,270314
4345,pskindel,1,0.00037,97529,36.07989,270314
4346,psmoros,1,0.00037,97530,36.08026,270314
4347,psyhtest,1,0.00037,97531,36.08063,270314
4348,psykidellic,1,0.00037,97532,36.08100,270314
4349,ptartan21,1,0.00037,97533,36.08137,270314
4350,pulpo,1,0.00037,97534,36.08174,270314
4351,pushkarv,1,0.00037,97535,36.08211,270314
4352,pyalex,1,0.00037,97536,36.08248,270314
4353,Python35,1,0.00037,97537,36.08285,270314
4354,pyxelr,1,0.00037,97538,36.08322,270314
4355,Qasim-Aziz,1,0.00037,97539,36.08359,270314
4356,qiaqiatic,1,0.00037,97540,36.08396,270314
4357,qijia2045579,1,0.00037,97541,36.08433,270314
4358,Qingwt,1,0.00037,97542,36.08470,270314
4359,QinjieLin-NU,1,0.00037,97543,36.08507,270314
4360,QipengZhou,1,0.00037,97544,36.08544,270314
4361,qlniu,1,0.00037,97545,36.08581,270314
4362,qqsun8819,1,0.00037,97546,36.08618,270314
4363,quan-dang,1,0.00037,97547,36.08655,270314
4364,queguan,1,0.00037,97548,36.08692,270314
4365,QuesarVII,1,0.00037,97549,36.08729,270314
4366,r0mk1,1,0.00037,97550,36.08766,270314
4367,Radhika108,1,0.00037,97551,36.08803,270314
4368,rafaelalou,1,0.00037,97552,36.08840,270314
4369,rafaelalouka-bai,1,0.00037,97553,36.08877,270314
4370,rafaelgildin,1,0.00037,97554,36.08914,270314
4371,raghav20,1,0.00037,97555,36.08951,270314
4372,raghavendramanandi,1,0.00037,97556,36.08988,270314
4373,raghulkrishna,1,0.00037,97557,36.09025,270314
4374,rahcode7,1,0.00037,97558,36.09062,270314
4375,rahul99,1,0.00037,97559,36.09099,270314
4376,rahulkhatry4,1,0.00037,97560,36.09136,270314
4377,rahulunair,1,0.00037,97561,36.09173,270314
4378,Raiyan111,1,0.00037,97562,36.09210,270314
4379,rajanjitenpatel,1,0.00037,97563,36.09247,270314
4380,rajivsam,1,0.00037,97564,36.09284,270314
4381,rajsrujan77,1,0.00037,97565,36.09321,270314
4382,rakshithpai2108,1,0.00037,97566,36.09358,270314
4383,rakshithvsk,1,0.00037,97567,36.09395,270314
4384,ramjinokia,1,0.00037,97568,36.09432,270314
4385,ranajoy-dutta,1,0.00037,97569,36.09469,270314
4386,rand,1,0.00037,97570,36.09506,270314
4387,randomcoww,1,0.00037,97571,36.09543,270314
4388,ranjithmr,1,0.00037,97572,36.09580,270314
4389,RaphPfister,1,0.00037,97573,36.09617,270314
4390,rapuckett,1,0.00037,97574,36.09654,270314
4391,rayuron,1,0.00037,97575,36.09691,270314
4392,raztud,1,0.00037,97576,36.09728,270314
4393,rcarmstrong,1,0.00037,97577,36.09765,270314
4394,rdoume,1,0.00037,97578,36.09802,270314
4395,reach4nk,1,0.00037,97579,36.09839,270314
4396,realsushi-official,1,0.00037,97580,36.09876,270314
4397,redcican,1,0.00037,97581,36.09913,270314
4398,reevelau,1,0.00037,97582,36.09950,270314
4399,reinhouthooft,1,0.00037,97583,36.09987,270314
4400,remde,1,0.00037,97584,36.10024,270314
4401,remoyson,1,0.00037,97585,36.10061,270314
4402,RemyLarroye-o,1,0.00037,97586,36.10098,270314
4403,renat-abbyazov,1,0.00037,97587,36.10135,270314
4404,renqiang2016,1,0.00037,97588,36.10172,270314
4405,RensDimmendaal,1,0.00037,97589,36.10209,270314
4406,renuraj18,1,0.00037,97590,36.10246,270314
4407,RE-Wolfe,1,0.00037,97591,36.10283,270314
4408,rexlow,1,0.00037,97592,36.10320,270314
4409,reyhane1998,1,0.00037,97593,36.10357,270314
4410,rfan-debug,1,0.00037,97594,36.10394,270314
4411,rgupta1234,1,0.00037,97595,36.10431,270314
4412,rguso,1,0.00037,97596,36.10468,270314
4413,rhatol,1,0.00037,97597,36.10505,270314
4414,rhugga,1,0.00037,97598,36.10542,270314
4415,richardburakowski,1,0.00037,97599,36.10579,270314
4416,riibeirogabriel,1,0.00037,97600,36.10616,270314
4417,riteshkarval,1,0.00037,97601,36.10653,270314
4418,riteshpallod,1,0.00037,97602,36.10690,270314
4419,rjEks,1,0.00037,97603,36.10727,270314
4420,rmbrad,1,0.00037,97604,36.10764,270314
4421,rnkhouse,1,0.00037,97605,36.10801,270314
4422,robbiedow,1,0.00037,97606,36.10838,270314
4423,robertofierimonte,1,0.00037,97607,36.10875,270314
4424,robertschweizer,1,0.00037,97608,36.10912,270314
4425,robinvanschaik,1,0.00037,97609,36.10949,270314
4426,robotaref,1,0.00037,97610,36.10986,270314
4427,rock-town-coder,1,0.00037,97611,36.11023,270314
4428,rohitgujral,1,0.00037,97612,36.11060,270314
4429,romanbilenko174,1,0.00037,97613,36.11097,270314
4430,ronsingler,1,0.00037,97614,36.11134,270314
4431,ronytesler,1,0.00037,97615,36.11171,270314
4432,Rory602,1,0.00037,97616,36.11208,270314
4433,rosawant,1,0.00037,97617,36.11245,270314
4434,Roshrini,1,0.00037,97618,36.11282,270314
4435,rovechkin,1,0.00037,97619,36.11319,270314
4436,roy-ht,1,0.00037,97620,36.11356,270314
4437,Roymprog,1,0.00037,97621,36.11393,270314
4438,RoyOsaki,1,0.00037,97622,36.11430,270314
4439,rp4fx12,1,0.00037,97623,36.11467,270314
4440,rsassPwC,1,0.00037,97624,36.11504,270314
4441,rscottwatson,1,0.00037,97625,36.11541,270314
4442,rsepassi,1,0.00037,97626,36.11578,270314
4443,rsinghtc,1,0.00037,97627,36.11615,270314
4444,rsr23,1,0.00037,97628,36.11652,270314
4445,ruanxingbaozi,1,0.00037,97629,36.11689,270314
4446,RubensZimbres,1,0.00037,97630,36.11726,270314
4447,ruodingt,1,0.00037,97631,36.11763,270314
4448,RUOK90,1,0.00037,97632,36.11800,270314
4449,RustamyF,1,0.00037,97633,36.11837,270314
4450,rwathena,1,0.00037,97634,36.11874,270314
4451,ryan-nervana,1,0.00037,97635,36.11911,270314
4452,ryanwcyin,1,0.00037,97636,36.11948,270314
4453,rystadedgaras,1,0.00037,97637,36.11985,270314
4454,RyuSA,1,0.00037,97638,36.12022,270314
4455,rzillerueloatgoogle,1,0.00037,97639,36.12059,270314
4456,sabarikannan-ai,1,0.00037,97640,36.12096,270314
4457,sabarnwal,1,0.00037,97641,36.12133,270314
4458,sabya39,1,0.00037,97642,36.12170,270314
4459,sachin-ac,1,0.00037,97643,36.12207,270314
4460,sadakeita,1,0.00037,97644,36.12244,270314
4461,sai196,1,0.00037,97645,36.12281,270314
4462,saiakhil2012,1,0.00037,97646,36.12318,270314
4463,saidsef,1,0.00037,97647,36.12355,270314
4464,saigirishgilly98,1,0.00037,97648,36.12392,270314
4465,SaiKiranBurle,1,0.00037,97649,36.12429,270314
4466,salexashenko,1,0.00037,97650,36.12466,270314
4467,sallamander,1,0.00037,97651,36.12502,270314
4468,saltazaur,1,0.00037,97652,36.12539,270314
4469,sam360digitmg,1,0.00037,97653,36.12576,270314
4470,samcaetano,1,0.00037,97654,36.12613,270314
4471,sam-h-bean,1,0.00037,97655,36.12650,270314
4472,samithaj,1,0.00037,97656,36.12687,270314
4473,SanderRednas,1,0.00037,97657,36.12724,270314
4474,sanjikasehgal,1,0.00037,97658,36.12761,270314
4475,sanjshres,1,0.00037,97659,36.12798,270314
4476,sanjshrestha,1,0.00037,97660,36.12835,270314
4477,santhosh261190,1,0.00037,97661,36.12872,270314
4478,Santosh1176,1,0.00037,97662,36.12909,270314
4479,SaraSaffari,1,0.00037,97663,36.12946,270314
4480,Sarrouna,1,0.00037,97664,36.12983,270314
4481,sashavcat,1,0.00037,97665,36.13020,270314
4482,sassyn,1,0.00037,97666,36.13057,270314
4483,satata-clgx,1,0.00037,97667,36.13094,270314
4484,satheeshbc,1,0.00037,97668,36.13131,270314
4485,Sathvik777,1,0.00037,97669,36.13168,270314
4486,satriawadhipurusa,1,0.00037,97670,36.13205,270314
4487,saurabh1043,1,0.00037,97671,36.13242,270314
4488,saurav2608,1,0.00037,97672,36.13279,270314
4489,savingoyal,1,0.00037,97673,36.13316,270314
4490,Sayed-Imran,1,0.00037,97674,36.13353,270314
4491,sbko,1,0.00037,97675,36.13390,270314
4492,Scagin,1,0.00037,97676,36.13427,270314
4493,scale-itx,1,0.00037,97677,36.13464,270314
4494,schmidt-jake,1,0.00037,97678,36.13501,270314
4495,scotttam,1,0.00037,97679,36.13538,270314
4496,scttl,1,0.00037,97680,36.13575,270314
4497,sdgs72,1,0.00037,97681,36.13612,270314
4498,seanlin1326,1,0.00037,97682,36.13649,270314
4499,seattleplus,1,0.00037,97683,36.13686,270314
4500,sebastianbarry-sms,1,0.00037,97684,36.13723,270314
4501,seboktamas,1,0.00037,97685,36.13760,270314
4502,SeibertronSSS,1,0.00037,97686,36.13797,270314
4503,seoyeonhwng,1,0.00037,97687,36.13834,270314
4504,SergeyCherman,1,0.00037,97688,36.13871,270314
4505,sethmcagit,1,0.00037,97689,36.13908,270314
4506,sevro,1,0.00037,97690,36.13945,270314
4507,Shabrinath,1,0.00037,97691,36.13982,270314
4508,shadowdsp,1,0.00037,97692,36.14019,270314
4509,shadowmodder,1,0.00037,97693,36.14056,270314
4510,shag123,1,0.00037,97694,36.14093,270314
4511,ShaneZhong,1,0.00037,97695,36.14130,270314
4512,shanisma,1,0.00037,97696,36.14167,270314
4513,shankarpm,1,0.00037,97697,36.14204,270314
4514,Sharat-Innodatatics,1,0.00037,97698,36.14241,270314
4515,sharm294,1,0.00037,97699,36.14278,270314
4516,ShashankBlr,1,0.00037,97700,36.14315,270314
4517,ShaswataJash,1,0.00037,97701,36.14352,270314
4518,shekhar0413,1,0.00037,97702,36.14389,270314
4519,shekhar-ms123,1,0.00037,97703,36.14426,270314
4520,shengkaixuan,1,0.00037,97704,36.14463,270314
4521,shengy90,1,0.00037,97705,36.14500,270314
4522,shengzhou1216,1,0.00037,97706,36.14537,270314
4523,shenkejie15,1,0.00037,97707,36.14574,270314
4524,shikhabitgrit,1,0.00037,97708,36.14611,270314
4525,shilf1,1,0.00037,97709,36.14648,270314
4526,shivam19991,1,0.00037,97710,36.14685,270314
4527,shiyu15,1,0.00037,97711,36.14722,270314
4528,shravspy,1,0.00037,97712,36.14759,270314
4529,ShreyPandit,1,0.00037,97713,36.14796,270314
4530,ShrikanthSingh,1,0.00037,97714,36.14833,270314
4531,shrinidhisuresha,1,0.00037,97715,36.14870,270314
4532,shrivs3,1,0.00037,97716,36.14907,270314
4533,shrutich91,1,0.00037,97717,36.14944,270314
4534,shurain,1,0.00037,97718,36.14981,270314
4535,sibleyd,1,0.00037,97719,36.15018,270314
4536,Siddarth-Pattnaik,1,0.00037,97720,36.15055,270314
4537,siddhant235,1,0.00037,97721,36.15092,270314
4538,Siddika1278,1,0.00037,97722,36.15129,270314
4539,siddsuresh97,1,0.00037,97723,36.15166,270314
4540,Sidebook,1,0.00037,97724,36.15203,270314
4541,sidiksoleman,1,0.00037,97725,36.15240,270314
4542,sidnaik1975,1,0.00037,97726,36.15277,270314
4543,SilDev-zz,1,0.00037,97727,36.15314,270314
4544,simanw304,1,0.00037,97728,36.15351,270314
4545,simanwangSC,1,0.00037,97729,36.15388,270314
4546,Simon-Harris-IBM,1,0.00037,97730,36.15425,270314
4547,Sinba7,1,0.00037,97731,36.15462,270314
4548,sitakantachaudhury,1,0.00037,97732,36.15499,270314
4549,sivachama,1,0.00037,97733,36.15536,270314
4550,sixinshuier,1,0.00037,97734,36.15573,270314
4551,sjaek,1,0.00037,97735,36.15610,270314
4552,sjmccorm1993,1,0.00037,97736,36.15647,270314
4553,sleep-404,1,0.00037,97737,36.15684,270314
4554,slowlove1995,1,0.00037,97738,36.15721,270314
4555,SmartInWhut,1,0.00037,97739,36.15758,270314
4556,smeyer12,1,0.00037,97740,36.15795,270314
4557,smijar,1,0.00037,97741,36.15832,270314
4558,sml0820,1,0.00037,97742,36.15869,270314
4559,smnama,1,0.00037,97743,36.15906,270314
4560,Smokrow,1,0.00037,97744,36.15943,270314
4561,smthpickboy,1,0.00037,97745,36.15980,270314
4562,sneharth37,1,0.00037,97746,36.16017,270314
4563,snowmanbamm,1,0.00037,97747,36.16054,270314
4564,snps-sagarrao,1,0.00037,97748,36.16091,270314
4565,sofam,1,0.00037,97749,36.16128,270314
4566,sofsms,1,0.00037,97750,36.16165,270314
4567,Softsapiens,1,0.00037,97751,36.16202,270314
4568,SoheilSalehian,1,0.00037,97752,36.16239,270314
4569,solomatov,1,0.00037,97753,36.16276,270314
4570,somnath1077,1,0.00037,97754,36.16313,270314
4571,sonfire86,1,0.00037,97755,36.16350,270314
4572,Soonmok,1,0.00037,97756,36.16387,270314
4573,sorowakers,1,0.00037,97757,36.16424,270314
4574,SoujanyaSan,1,0.00037,97758,36.16461,270314
4575,soumith,1,0.00037,97759,36.16498,270314
4576,soumyadipDe,1,0.00037,97760,36.16535,270314
4577,Space-Banana-42,1,0.00037,97761,36.16572,270314
4578,spatre,1,0.00037,97762,36.16609,270314
4579,SpeedCoder5,1,0.00037,97763,36.16646,270314
4580,speg03,1,0.00037,97764,36.16683,270314
4581,spinelsun,1,0.00037,97765,36.16720,270314
4582,sporterman,1,0.00037,97766,36.16757,270314
4583,springcoil,1,0.00037,97767,36.16794,270314
4584,SputnikTea,1,0.00037,97768,36.16831,270314
4585,squaricdot,1,0.00037,97769,36.16868,270314
4586,sramirez,1,0.00037,97770,36.16905,270314
4587,sravanikollipara,1,0.00037,97771,36.16942,270314
4588,sreddybr3,1,0.00037,97772,36.16979,270314
4589,sreenivasmrpivot,1,0.00037,97773,36.17016,270314
4590,sriharikarnam,1,0.00037,97774,36.17053,270314
4591,srikantt,1,0.00037,97775,36.17090,270314
4592,srinivascreddy,1,0.00037,97776,36.17127,270314
4593,srishti0190,1,0.00037,97777,36.17164,270314
4594,ssabat,1,0.00037,97778,36.17201,270314
4595,ssabnis,1,0.00037,97779,36.17238,270314
4596,ssbhat,1,0.00037,97780,36.17275,270314
4597,ssharpe42,1,0.00037,97781,36.17312,270314
4598,StarCoral,1,0.00037,97782,36.17349,270314
4599,staturecrane,1,0.00037,97783,36.17386,270314
4600,stdec,1,0.00037,97784,36.17423,270314
4601,Steboss89,1,0.00037,97785,36.17460,270314
4602,StefanFreshLand,1,0.00037,97786,36.17497,270314
4603,stepanhruda,1,0.00037,97787,36.17534,270314
4604,StephennFernandes,1,0.00037,97788,36.17571,270314
4605,SteveHoggNZ,1,0.00037,97789,36.17608,270314
4606,stevenzhang-support,1,0.00037,97790,36.17645,270314
4607,stevezkw1998,1,0.00037,97791,36.17682,270314
4608,steviecash,1,0.00037,97792,36.17719,270314
4609,stradigi-andres-de-castro,1,0.00037,97793,36.17756,270314
4610,strangemonad,1,0.00037,97794,36.17793,270314
4611,su0625,1,0.00037,97795,36.17830,270314
4612,subramankala,1,0.00037,97796,36.17867,270314
4613,sucanthudu,1,0.00037,97797,36.17904,270314
4614,sumanraja,1,0.00037,97798,36.17941,270314
4615,sumeet1989,1,0.00037,97799,36.17978,270314
4616,Sumenia,1,0.00037,97800,36.18015,270314
4617,sunandosamaddar,1,0.00037,97801,36.18052,270314
4618,SunFromEast,1,0.00037,97802,36.18089,270314
4619,sunshine-zyl,1,0.00037,97803,36.18126,270314
4620,SuperKogito,1,0.00037,97804,36.18163,270314
4621,surabhikannan,1,0.00037,97805,36.18200,270314
4622,suredream,1,0.00037,97806,36.18237,270314
4623,suzusuzu,1,0.00037,97807,36.18274,270314
4624,svilenvul,1,0.00037,97808,36.18311,270314
4625,swapdebarshi,1,0.00037,97809,36.18348,270314
4626,swarnaditya,1,0.00037,97810,36.18385,270314
4627,SwathiAunooru,1,0.00037,97811,36.18422,270314
4628,switchfootsid,1,0.00037,97812,36.18459,270314
4629,swjung94,1,0.00037,97813,36.18496,270314
4630,syeo,1,0.00037,97814,36.18533,270314
4631,Sygyzmundovych,1,0.00037,97815,36.18570,270314
4632,syvlabs,1,0.00037,97816,36.18607,270314
4633,szha,1,0.00037,97817,36.18644,270314
4634,szpnygo,1,0.00037,97818,36.18680,270314
4635,TabbieD,1,0.00037,97819,36.18717,270314
4636,Taehun,1,0.00037,97820,36.18754,270314
4637,taghoutigomycode,1,0.00037,97821,36.18791,270314
4638,talal-sen,1,0.00037,97822,36.18828,270314
4639,talaman,1,0.00037,97823,36.18865,270314
4640,talexander,1,0.00037,97824,36.18902,270314
4641,talgos1,1,0.00037,97825,36.18939,270314
4642,tam0201,1,0.00037,97826,36.18976,270314
4643,tama-biro,1,0.00037,97827,36.19013,270314
4644,tania-python-dev,1,0.00037,97828,36.19050,270314
4645,tanmayv25,1,0.00037,97829,36.19087,270314
4646,tanvithakur94,1,0.00037,97830,36.19124,270314
4647,tanzb33r,1,0.00037,97831,36.19161,270314
4648,tan-z-tan,1,0.00037,97832,36.19198,270314
4649,taoyonggang,1,0.00037,97833,36.19235,270314
4650,TaranSinghania,1,0.00037,97834,36.19272,270314
4651,tarekabouzeid,1,0.00037,97835,36.19309,270314
4652,tarun0,1,0.00037,97836,36.19346,270314
4653,tavinashb,1,0.00037,97837,36.19383,270314
4654,tayritenour,1,0.00037,97838,36.19420,270314
4655,tayyabmaqsood,1,0.00037,97839,36.19457,270314
4656,tbeatty,1,0.00037,97840,36.19494,270314
4657,tboquet,1,0.00037,97841,36.19531,270314
4658,tdevopsottawa,1,0.00037,97842,36.19568,270314
4659,techgnosis,1,0.00037,97843,36.19605,270314
4660,techgopal,1,0.00037,97844,36.19642,270314
4661,techjournalist,1,0.00037,97845,36.19679,270314
4662,Techn0logic,1,0.00037,97846,36.19716,270314
4663,TechR10n,1,0.00037,97847,36.19753,270314
4664,techwithshadab,1,0.00037,97848,36.19790,270314
4665,teetangh,1,0.00037,97849,36.19827,270314
4666,tejashpe,1,0.00037,97850,36.19864,270314
4667,tesla3,1,0.00037,97851,36.19901,270314
4668,testphys,1,0.00037,97852,36.19938,270314
4669,Te-YuanLiu,1,0.00037,97853,36.19975,270314
4670,the5solae,1,0.00037,97854,36.20012,270314
4671,thenovices,1,0.00037,97855,36.20049,270314
4672,Theocrat,1,0.00037,97856,36.20086,270314
4673,TheOtherOsama,1,0.00037,97857,36.20123,270314
4674,thethiny,1,0.00037,97858,36.20160,270314
4675,thetume,1,0.00037,97859,36.20197,270314
4676,thi-low,1,0.00037,97860,36.20234,270314
4677,thirdeye-jarvis,1,0.00037,97861,36.20271,270314
4678,ThisIsANiceName,1,0.00037,97862,36.20308,270314
4679,thkim0022,1,0.00037,97863,36.20345,270314
4680,thms-ngn,1,0.00037,97864,36.20382,270314
4681,tholor,1,0.00037,97865,36.20419,270314
4682,Thomasillo,1,0.00037,97866,36.20456,270314
4683,ThomasRot,1,0.00037,97867,36.20493,270314
4684,thomasSve,1,0.00037,97868,36.20530,270314
4685,thor3333,1,0.00037,97869,36.20567,270314
4686,thunderhill,1,0.00037,97870,36.20604,270314
4687,Tiddl1991,1,0.00037,97871,36.20641,270314
4688,TimCookny,1,0.00037,97872,36.20678,270314
4689,timothy-mugayi,1,0.00037,97873,36.20715,270314
4690,timothymugayi,1,0.00037,97874,36.20752,270314
4691,tinahbu,1,0.00037,97875,36.20789,270314
4692,tiopramayudi,1,0.00037,97876,36.20826,270314
4693,TiraO,1,0.00037,97877,36.20863,270314
4694,tjhgit,1,0.00037,97878,36.20900,270314
4695,tjingrant,1,0.00037,97879,36.20937,270314
4696,tmattio,1,0.00037,97880,36.20974,270314
4697,tmbluth,1,0.00037,97881,36.21011,270314
4698,tmnhat2001,1,0.00037,97882,36.21048,270314
4699,tmreic,1,0.00037,97883,36.21085,270314
4700,tobiasimbus,1,0.00037,97884,36.21122,270314
4701,toddlerds,1,0.00037,97885,36.21159,270314
4702,TomLaMantia,1,0.00037,97886,36.21196,270314
4703,TomReidNZ,1,0.00037,97887,36.21233,270314
4704,tomstockton,1,0.00037,97888,36.21270,270314
4705,Tomxin,1,0.00037,97889,36.21307,270314
4706,tongchao199,1,0.00037,97890,36.21344,270314
4707,tonyaw,1,0.00037,97891,36.21381,270314
4708,TPP2,1,0.00037,97892,36.21418,270314
4709,trackq,1,0.00037,97893,36.21455,270314
4710,traino82,1,0.00037,97894,36.21492,270314
4711,Trezorro,1,0.00037,97895,36.21529,270314
4712,TrieuLe0801,1,0.00037,97896,36.21566,270314
4713,trn84,1,0.00037,97897,36.21603,270314
4714,TrubadurOsman,1,0.00037,97898,36.21640,270314
4715,tsukky67,1,0.00037,97899,36.21677,270314
4716,TT310,1,0.00037,97900,36.21714,270314
4717,tu-infra-tests,1,0.00037,97901,36.21751,270314
4718,tuliodesouza,1,0.00037,97902,36.21788,270314
4719,tuukkasarvi,1,0.00037,97903,36.21825,270314
4720,TylerBrabham,1,0.00037,97904,36.21862,270314
4721,Udayaprasad,1,0.00037,97905,36.21899,270314
4722,Ulov888,1,0.00037,97906,36.21936,270314
4723,unijoy,1,0.00037,97907,36.21973,270314
4724,UnionGlobal,1,0.00037,97908,36.22010,270314
4725,utkrs,1,0.00037,97909,36.22047,270314
4726,Vafilor,1,0.00037,97910,36.22084,270314
4727,vakrat1,1,0.00037,97911,36.22121,270314
4728,valeneiko,1,0.00037,97912,36.22158,270314
4729,valentindbdg,1,0.00037,97913,36.22195,270314
4730,valko073,1,0.00037,97914,36.22232,270314
4731,vanaraj-az,1,0.00037,97915,36.22269,270314
4732,vancromy,1,0.00037,97916,36.22306,270314
4733,Vanithanow,1,0.00037,97917,36.22343,270314
4734,varun111111,1,0.00037,97918,36.22380,270314
4735,varunchandan2,1,0.00037,97919,36.22417,270314
4736,vasco989k,1,0.00037,97920,36.22454,270314
4737,vasireddyvkl,1,0.00037,97921,36.22491,270314
4738,V-Bhadauriya,1,0.00037,97922,36.22528,270314
4739,vbucaj,1,0.00037,97923,36.22565,270314
4740,vdiravka,1,0.00037,97924,36.22602,270314
4741,vecorro,1,0.00037,97925,36.22639,270314
4742,venkatagedda,1,0.00037,97926,36.22676,270314
4743,vfontama,1,0.00037,97927,36.22713,270314
4744,vgopal,1,0.00037,97928,36.22750,270314
4745,viethung1234q,1,0.00037,97929,36.22787,270314
4746,vijayb47,1,0.00037,97930,36.22824,270314
4747,vijaytrainer,1,0.00037,97931,36.22861,270314
4748,vikasmenon,1,0.00037,97932,36.22898,270314
4749,Vikram486,1,0.00037,97933,36.22935,270314
4750,viksharma1987,1,0.00037,97934,36.22972,270314
4751,vinaydel,1,0.00037,97935,36.23009,270314
4752,vinaykumargudi,1,0.00037,97936,36.23046,270314
4753,VindhyaSRajan,1,0.00037,97937,36.23083,270314
4754,vinhdiesal,1,0.00037,97938,36.23120,270314
4755,vipulism,1,0.00037,97939,36.23157,270314
4756,viraja1,1,0.00037,97940,36.23194,270314
4757,ViralParikh22,1,0.00037,97941,36.23231,270314
4758,vishalsmb,1,0.00037,97942,36.23268,270314
4759,vishal-wiai,1,0.00037,97943,36.23305,270314
4760,VithikShah,1,0.00037,97944,36.23342,270314
4761,vivekanandpoojari,1,0.00037,97945,36.23379,270314
4762,vivekbhadouria,1,0.00037,97946,36.23416,270314
4763,vivekkum94,1,0.00037,97947,36.23453,270314
4764,viyer7,1,0.00037,97948,36.23490,270314
4765,vochicong,1,0.00037,97949,36.23527,270314
4766,volkermauel,1,0.00037,97950,36.23564,270314
4767,Volkimd,1,0.00037,97951,36.23601,270314
4768,vovkanaz,1,0.00037,97952,36.23638,270314
4769,vsatpathy,1,0.00037,97953,36.23675,270314
4770,vsriniv-git,1,0.00037,97954,36.23712,270314
4771,vule24,1,0.00037,97955,36.23749,270314
4772,wafaaabdelhafez,1,0.00037,97956,36.23786,270314
4773,wallyworld,1,0.00037,97957,36.23823,270314
4774,WangCHX,1,0.00037,97958,36.23860,270314
4775,WangHexie,1,0.00037,97959,36.23897,270314
4776,Wansh619,1,0.00037,97960,36.23934,270314
4777,waynehsei,1,0.00037,97961,36.23971,270314
4778,wdma,1,0.00037,97962,36.24008,270314
4779,we10710aa,1,0.00037,97963,36.24045,270314
4780,weicheng8626,1,0.00037,97964,36.24082,270314
4781,welcomemandeep,1,0.00037,97965,36.24119,270314
4782,wenjing,1,0.00037,97966,36.24156,270314
4783,wenjinsitu,1,0.00037,97967,36.24193,270314
4784,wenxinax,1,0.00037,97968,36.24230,270314
4785,wfchair,1,0.00037,97969,36.24267,270314
4786,whappybara,1,0.00037,97970,36.24304,270314
4787,William8Work,1,0.00037,97971,36.24341,270314
4788,willturner-gs,1,0.00037,97972,36.24378,270314
4789,willypicard,1,0.00037,97973,36.24415,270314
4790,wing328,1,0.00037,97974,36.24452,270314
4791,wintwoo,1,0.00037,97975,36.24489,270314
4792,wiszniowski-t,1,0.00037,97976,36.24526,270314
4793,wlzzZ,1,0.00037,97977,36.24563,270314
4794,wmikolajczyk,1,0.00037,97978,36.24600,270314
4795,wnowak10,1,0.00037,97979,36.24637,270314
4796,woof,1,0.00037,97980,36.24674,270314
4797,worsecoder,1,0.00037,97981,36.24711,270314
4798,wskinner,1,0.00037,97982,36.24748,270314
4799,wtermini,1,0.00037,97983,36.24785,270314
4800,wufly,1,0.00037,97984,36.24822,270314
4801,wulikai1993,1,0.00037,97985,36.24858,270314
4802,wutianhao910,1,0.00037,97986,36.24895,270314
4803,wuxinglai,1,0.00037,97987,36.24932,270314
4804,wuyexixi,1,0.00037,97988,36.24969,270314
4805,wuzhiye7,1,0.00037,97989,36.25006,270314
4806,xalekx,1,0.00037,97990,36.25043,270314
4807,xcloud-carl,1,0.00037,97991,36.25080,270314
4808,xiangninglyu,1,0.00037,97992,36.25117,270314
4809,xiehaoina,1,0.00037,97993,36.25154,270314
4810,xiezhw3,1,0.00037,97994,36.25191,270314
4811,xinghalo,1,0.00037,97995,36.25228,270314
4812,Xingyuan-Chen,1,0.00037,97996,36.25265,270314
4813,xnoar747,1,0.00037,97997,36.25302,270314
4814,xsatishx,1,0.00037,97998,36.25339,270314
4815,xsqian,1,0.00037,97999,36.25376,270314
4816,xuchenCN,1,0.00037,98000,36.25413,270314
4817,xushaoxiao,1,0.00037,98001,36.25450,270314
4818,xwyangjshb,1,0.00037,98002,36.25487,270314
4819,xxf09th,1,0.00037,98003,36.25524,270314
4820,xxxxiehf,1,0.00037,98004,36.25561,270314
4821,xzy0223,1,0.00037,98005,36.25598,270314
4822,y2kenny,1,0.00037,98006,36.25635,270314
4823,yangaang,1,0.00037,98007,36.25672,270314
4824,yangjinlogic,1,0.00037,98008,36.25709,270314
4825,yangoos57,1,0.00037,98009,36.25746,270314
4826,yangpeng1994,1,0.00037,98010,36.25783,270314
4827,yangSignifyd,1,0.00037,98011,36.25820,270314
4828,yangyu2013,1,0.00037,98012,36.25857,270314
4829,yankunsam,1,0.00037,98013,36.25894,270314
4830,YannisPap,1,0.00037,98014,36.25931,270314
4831,yanyanwang1,1,0.00037,98015,36.25968,270314
4832,yaseenisolated,1,0.00037,98016,36.26005,270314
4833,yczheng0,1,0.00037,98017,36.26042,270314
4834,yecohn,1,0.00037,98018,36.26079,270314
4835,YGuyomar,1,0.00037,98019,36.26116,270314
4836,yike5460,1,0.00037,98020,36.26153,270314
4837,yisampi,1,0.00037,98021,36.26190,270314
4838,yizhexu,1,0.00037,98022,36.26227,270314
4839,ykacer,1,0.00037,98023,36.26264,270314
4840,ykale,1,0.00037,98024,36.26301,270314
4841,yliu989,1,0.00037,98025,36.26338,270314
4842,yonaroze,1,0.00037,98026,36.26375,270314
4843,YongtaoHuang1994,1,0.00037,98027,36.26412,270314
4844,yooki0328,1,0.00037,98028,36.26449,270314
4845,yostao,1,0.00037,98029,36.26486,270314
4846,young-957,1,0.00037,98030,36.26523,270314
4847,YoungjuWang,1,0.00037,98031,36.26560,270314
4848,YPCC,1,0.00037,98032,36.26597,270314
4849,yphanikumar1995,1,0.00037,98033,36.26634,270314
4850,yshimizu37,1,0.00037,98034,36.26671,270314
4851,yuanhunglo,1,0.00037,98035,36.26708,270314
4852,yuanzac,1,0.00037,98036,36.26745,270314
4853,yuc8939,1,0.00037,98037,36.26782,270314
4854,yudiprasetya24,1,0.00037,98038,36.26819,270314
4855,yueno06,1,0.00037,98039,36.26856,270314
4856,yuna878,1,0.00037,98040,36.26893,270314
4857,yurigilf,1,0.00037,98041,36.26930,270314
4858,Yuvraj2300,1,0.00037,98042,36.26967,270314
4859,yyaari,1,0.00037,98043,36.27004,270314
4860,yydzhou,1,0.00037,98044,36.27041,270314
4861,yzc1114,1,0.00037,98045,36.27078,270314
4862,zacharymostowsky,1,0.00037,98046,36.27115,270314
4863,zachgrayio,1,0.00037,98047,36.27152,270314
4864,ZahraEconomist,1,0.00037,98048,36.27189,270314
4865,zdzd123123,1,0.00037,98049,36.27226,270314
4866,ZeeshanAnwar15,1,0.00037,98050,36.27263,270314
4867,zhangnew,1,0.00037,98051,36.27300,270314
4868,zhangxueren9,1,0.00037,98052,36.27337,270314
4869,zhao1157,1,0.00037,98053,36.27374,270314
4870,zhaoxq,1,0.00037,98054,36.27411,270314
4871,zhch12121,1,0.00037,98055,36.27448,270314
4872,zhenlohuang,1,0.00037,98056,36.27485,270314
4873,zhenyulin,1,0.00037,98057,36.27522,270314
4874,Zhihan1996,1,0.00037,98058,36.27559,270314
4875,ZhiqiangWangICT,1,0.00037,98059,36.27596,270314
4876,ZhiqinYang,1,0.00037,98060,36.27633,270314
4877,zhou-harry,1,0.00037,98061,36.27670,270314
4878,zhreshold,1,0.00037,98062,36.27707,270314
4879,zhypku,1,0.00037,98063,36.27744,270314
4880,ziyou987,1,0.00037,98064,36.27781,270314
4881,zmoon111,1,0.00037,98065,36.27818,270314
4882,zoefyz12,1,0.00037,98066,36.27855,270314
4883,ZorkMaster,1,0.00037,98067,36.27892,270314
4884,zorrofox,1,0.00037,98068,36.27929,270314
4885,zqyi,1,0.00037,98069,36.27966,270314
4886,zsatterfield,1,0.00037,98070,36.28003,270314
4887,zuiurs,1,0.00037,98071,36.28040,270314
4888,Zveroloff,1,0.00037,98072,36.28077,270314
4889,zw39125432,1,0.00037,98073,36.28114,270314
4890,zyanichaimaa,1,0.00037,98074,36.28151,270314
4891,zyedManai,1,0.00037,98075,36.28188,270314
4892,zyfzjsc988,1,0.00037,98076,36.28225,270314
4893,zzaareer,1,0.00037,98077,36.28262,270314
4894,zzxvictor,1,0.00037,98078,36.28299,270314
