rank_number,actor,contributions,percent,cumulative_sum,cumulative_percent,all_contributions
1,jlewi,23206,9.35877,23206,9.35877,247960
2,Bobgy,14303,5.76827,37509,15.12704,247960
3,Ark-kun,8383,3.38079,45892,18.50782,247960
4,gaocegege,6287,2.53549,52179,21.04331,247960
5,chensun,5386,2.17212,57565,23.21544,247960
6,sarahmaddox,5291,2.13381,62856,25.34925,247960
7,andreyvelich,5057,2.03944,67913,27.38869,247960
8,yuzisun,4629,1.86683,72542,29.25553,247960
9,Jeffwan,4378,1.76561,76920,31.02113,247960
10,johnugeorge,4291,1.73052,81211,32.75165,247960
11,Tomcli,4095,1.65148,85306,34.40313,247960
12,zijianjoy,3916,1.57929,89222,35.98242,247960
13,IronPan,3761,1.51678,92983,37.49919,247960
14,kimwnasptd,3591,1.44822,96574,38.94741,247960
15,numerology,3197,1.28932,99771,40.23673,247960
16,connor-mccarthy,3159,1.27400,102930,41.51073,247960
17,tenzen-y,3114,1.25585,106044,42.76658,247960
18,lluunn,2867,1.15623,108911,43.92281,247960
19,gaoning777,2551,1.02879,111462,44.95161,247960
20,jinchihe,2502,1.00903,113964,45.96064,247960
21,kunmingg,2386,0.96225,116350,46.92289,247960
22,richardsliu,2365,0.95378,118715,47.87667,247960
23,animeshsingh,2347,0.94652,121062,48.82320,247960
24,terrytangyuan,2284,0.92112,123346,49.74431,247960
25,kkasravi,2246,0.90579,125592,50.65010,247960
26,PatrickXYS,2184,0.88079,127776,51.53089,247960
27,DavidSpek,2136,0.86143,129912,52.39232,247960
28,yanniszark,2115,0.85296,132027,53.24528,247960
29,ellis-bigelow,1984,0.80013,134011,54.04541,247960
30,8bitmp3,1937,0.78117,135948,54.82658,247960
31,hougangliu,1924,0.77593,137872,55.60252,247960
32,thesuperzapper,1733,0.69890,139605,56.30142,247960
33,gabrielwen,1645,0.66341,141250,56.96483,247960
34,neuromage,1625,0.65535,142875,57.62018,247960
35,NikeNano,1469,0.59243,144344,58.21261,247960
36,abhi-g,1375,0.55452,145719,58.76714,247960
37,Linchin,1337,0.53920,147056,59.30634,247960
38,ankushagarwal,1314,0.52992,148370,59.83626,247960
39,jbottum,1282,0.51702,149652,60.35328,247960
40,rmgogogo,1254,0.50573,150906,60.85901,247960
41,gkcalat,1232,0.49685,152138,61.35586,247960
42,joeliedtke,1228,0.49524,153366,61.85111,247960
43,zhenghuiwang,1212,0.48879,154578,62.33989,247960
44,hongye-sun,1181,0.47629,155759,62.81618,247960
45,jingzhang36,1161,0.46822,156920,63.28440,247960
46,cheyang,1116,0.45007,158036,63.73447,247960
47,RFMVasconcelos,1112,0.44846,159148,64.18293,247960
48,capri-xiyue,1090,0.43959,160238,64.62252,247960
49,alculquicondor,1087,0.43838,161325,65.06090,247960
50,krishnadurai,1081,0.43596,162406,65.49685,247960
51,ckadner,1022,0.41216,163428,65.90902,247960
52,swiftdiaries,1018,0.41055,164446,66.31957,247960
53,cliveseldon,1013,0.40853,165459,66.72810,247960
54,avdaredevil,1005,0.40531,166464,67.13341,247960
55,SinaChavoshi,934,0.37667,167398,67.51008,247960
56,pdmack,848,0.34199,168246,67.85207,247960
57,yhwang,840,0.33876,169086,68.19084,247960
58,vicaire,839,0.33836,169925,68.52920,247960
59,hamelsmu,816,0.32909,170741,68.85828,247960
60,surajkota,816,0.32909,171557,69.18737,247960
61,prodonjs,808,0.32586,172365,69.51323,247960
62,juliusvonkohout,795,0.32062,173160,69.83384,247960
63,YujiOshima,762,0.30731,173922,70.14115,247960
64,rileyjbauer,757,0.30529,174679,70.44644,247960
65,jlyaoyuli,753,0.30368,175432,70.75012,247960
66,jtfogarty,746,0.30085,176178,71.05098,247960
67,Arhell,735,0.29642,176913,71.34739,247960
68,pugangxa,735,0.29642,177648,71.64381,247960
69,yebrahim,735,0.29642,178383,71.94023,247960
70,texasmichelle,686,0.27666,179069,72.21689,247960
71,elikatsis,673,0.27141,179742,72.48830,247960
72,rakelkar,629,0.25367,180371,72.74197,247960
73,annajung,617,0.24883,180988,72.99080,247960
74,xyhuang,601,0.24238,181589,73.23318,247960
75,amygdala,574,0.23149,182163,73.46467,247960
76,fenglixa,524,0.21132,182687,73.67600,247960
77,karthikv2k,504,0.20326,183191,73.87925,247960
78,RedbackThomson,491,0.19802,183682,74.07727,247960
79,zw0610,480,0.19358,184162,74.27085,247960
80,anencore94,460,0.18551,184622,74.45636,247960
81,yuzliu,432,0.17422,185054,74.63059,247960
82,TravisBuddy,431,0.17382,185485,74.80440,247960
83,janeman98,428,0.17261,185913,74.97701,247960
84,rongou,409,0.16495,186322,75.14196,247960
85,r2d4,399,0.16091,186721,75.30287,247960
86,james-jwu,394,0.15890,187115,75.46177,247960
87,zabbasi,388,0.15648,187503,75.61824,247960
88,ChanYiLin,372,0.15002,187875,75.76827,247960
89,zpChris,365,0.14720,188240,75.91547,247960
90,ellistarn,363,0.14639,188603,76.06186,247960
91,eterna2,357,0.14397,188960,76.20584,247960
92,ji-yaqi,354,0.14276,189314,76.34860,247960
93,StefanoFioravanzo,348,0.14035,189662,76.48895,247960
94,pvaneck,346,0.13954,190008,76.62849,247960
95,adrian555,325,0.13107,190333,76.75956,247960
96,ajchili,320,0.12905,190653,76.88861,247960
97,ScrapCodes,297,0.11978,190950,77.00839,247960
98,cwbeitel,293,0.11816,191243,77.12655,247960
99,discordianfish,290,0.11695,191533,77.24351,247960
100,ashahba,287,0.11574,191820,77.35925,247960
101,ryandawsonuk,287,0.11574,192107,77.47500,247960
102,rui5i,279,0.11252,192386,77.58751,247960
103,Udiknedormin,276,0.11131,192662,77.69882,247960
104,inc0,275,0.11090,192937,77.80973,247960
105,dushyanthsc,270,0.10889,193207,77.91862,247960
106,merlintang,268,0.10808,193475,78.02670,247960
107,berndverst,264,0.10647,193739,78.13317,247960
108,apo-ger,263,0.10607,194002,78.23923,247960
109,theofpa,261,0.10526,194263,78.34449,247960
110,akartsky,259,0.10445,194522,78.44894,247960
111,ScorpioCPH,255,0.10284,194777,78.55178,247960
112,everpeace,254,0.10244,195031,78.65422,247960
113,kwasi,252,0.10163,195283,78.75585,247960
114,shannonbradshaw,252,0.10163,195535,78.85748,247960
115,chongyouquan,250,0.10082,195785,78.95830,247960
116,drewbutlerbb4,249,0.10042,196034,79.05872,247960
117,holdenk,248,0.10002,196282,79.15874,247960
118,qimingj,245,0.09881,196527,79.25754,247960
119,Iamlovingit,240,0.09679,196767,79.35433,247960
120,shawnzhu,234,0.09437,197001,79.44870,247960
121,aronchick,230,0.09276,197231,79.54146,247960
122,karlschriek,230,0.09276,197461,79.63422,247960
123,activatedgeek,228,0.09195,197689,79.72617,247960
124,theadactyl,227,0.09155,197916,79.81771,247960
125,gyliu513,213,0.08590,198129,79.90361,247960
126,nrchakradhar,210,0.08469,198339,79.98830,247960
127,vpavlin,205,0.08267,198544,80.07098,247960
128,subodh101,197,0.07945,198741,80.15043,247960
129,scottilee,196,0.07905,198937,80.22947,247960
130,Akado2009,194,0.07824,199131,80.30771,247960
131,maganaluis,194,0.07824,199325,80.38595,247960
132,carmark,191,0.07703,199516,80.46298,247960
133,abchoo,185,0.07461,199701,80.53759,247960
134,bhack,184,0.07421,199885,80.61179,247960
135,jose5918,181,0.07300,200066,80.68479,247960
136,droctothorpe,180,0.07259,200246,80.75738,247960
137,sperlingxx,180,0.07259,200426,80.82997,247960
138,wbuchwalter,180,0.07259,200606,80.90256,247960
139,happy2048,179,0.07219,200785,80.97475,247960
140,haoxins,176,0.07098,200961,81.04573,247960
141,elsonrodriguez,174,0.07017,201135,81.11591,247960
142,alexlatchford,168,0.06775,201303,81.18366,247960
143,js-ts,168,0.06775,201471,81.25141,247960
144,Swikar,167,0.06735,201638,81.31876,247960
145,jagadeeshi2i,166,0.06695,201804,81.38571,247960
146,moficodes,166,0.06695,201970,81.45265,247960
147,puneith,163,0.06574,202133,81.51839,247960
148,xauthulei,162,0.06533,202295,81.58372,247960
149,chauhang,160,0.06453,202455,81.64825,247960
150,orfeas-k,160,0.06453,202615,81.71278,247960
151,c-bata,159,0.06412,202774,81.77690,247960
152,Syulin7,159,0.06412,202933,81.84102,247960
153,DomFleischmann,158,0.06372,203091,81.90474,247960
154,difince,154,0.06211,203245,81.96685,247960
155,munagekar,154,0.06211,203399,82.02896,247960
156,nakfour,154,0.06211,203553,82.09106,247960
157,wackxu,151,0.06090,203704,82.15196,247960
158,yeya24,151,0.06090,203855,82.21286,247960
159,JOCSTAA,148,0.05969,204003,82.27254,247960
160,chrisheecho,147,0.05928,204150,82.33183,247960
161,lalithvaka,146,0.05888,204296,82.39071,247960
162,ryansteakley,146,0.05888,204442,82.44959,247960
163,alfsuse,145,0.05848,204587,82.50807,247960
164,ifilonenko,143,0.05767,204730,82.56574,247960
165,jiezhang,143,0.05767,204873,82.62341,247960
166,wsxiaozhang,143,0.05767,205016,82.68108,247960
167,sasha-gitg,141,0.05686,205157,82.73794,247960
168,kevinyu98,137,0.05525,205294,82.79319,247960
169,naveensrinivasan,137,0.05525,205431,82.84844,247960
170,stpabhi,135,0.05444,205566,82.90289,247960
171,mbaijal,134,0.05404,205700,82.95693,247960
172,luotigerlsx,133,0.05364,205833,83.01057,247960
173,amsaha,132,0.05323,205965,83.06380,247960
174,Jimexist,131,0.05283,206096,83.11663,247960
175,MartinForReal,131,0.05283,206227,83.16946,247960
176,ajinkya933,130,0.05243,206357,83.22189,247960
177,jessiezcc,130,0.05243,206487,83.27432,247960
178,zichuan-scott-xu,126,0.05081,206613,83.32513,247960
179,Tabrizian,123,0.04960,206736,83.37474,247960
180,knkski,122,0.04920,206858,83.42394,247960
181,sen-sam,121,0.04880,206979,83.47274,247960
182,kevinbache,120,0.04839,207099,83.52113,247960
183,vkoukis,120,0.04839,207219,83.56953,247960
184,cspavlou,118,0.04759,207337,83.61712,247960
185,tasos-ale,118,0.04759,207455,83.66470,247960
186,elenzio9,117,0.04719,207572,83.71189,247960
187,suleisl2000,117,0.04719,207689,83.75907,247960
188,gautamkmr,115,0.04638,207804,83.80545,247960
189,mameshini,115,0.04638,207919,83.85183,247960
190,paveldournov,115,0.04638,208034,83.89821,247960
191,sudivate,115,0.04638,208149,83.94459,247960
192,kuizhiqing,114,0.04598,208263,83.99056,247960
193,balajismaniam,113,0.04557,208376,84.03613,247960
194,jal06,113,0.04557,208489,84.08171,247960
195,hemantha-kumara,112,0.04517,208601,84.12688,247960
196,MrXinWang,112,0.04517,208713,84.17204,247960
197,ananth102,111,0.04477,208824,84.21681,247960
198,carmine,111,0.04477,208935,84.26157,247960
199,ddutta,111,0.04477,209046,84.30634,247960
200,jian-he,111,0.04477,209157,84.35111,247960
201,rpasricha,109,0.04396,209266,84.39506,247960
202,shrinath-suresh,109,0.04396,209375,84.43902,247960
203,yupbank,106,0.04275,209481,84.48177,247960
204,hamedhsn,105,0.04235,209586,84.52412,247960
205,ConverJens,104,0.04194,209690,84.56606,247960
206,ddysher,102,0.04114,209792,84.60719,247960
207,jc2729,102,0.04114,209894,84.64833,247960
208,k82cn,101,0.04073,209995,84.68906,247960
209,woop,101,0.04073,210096,84.72980,247960
210,casassg,100,0.04033,210196,84.77012,247960
211,DanSanche,100,0.04033,210296,84.81045,247960
212,kbhawkey,100,0.04033,210396,84.85078,247960
213,foxish,99,0.03993,210495,84.89071,247960
214,salanki,99,0.03993,210594,84.93063,247960
215,deepak-muley,98,0.03952,210692,84.97016,247960
216,dsdinter,98,0.03952,210790,85.00968,247960
217,elviraux,98,0.03952,210888,85.04920,247960
218,xaniasd,97,0.03912,210985,85.08832,247960
219,ajayalfred,96,0.03872,211081,85.12704,247960
220,alecglassford,96,0.03872,211177,85.16575,247960
221,JakeTheWise,96,0.03872,211273,85.20447,247960
222,jbrette,94,0.03791,211367,85.24238,247960
223,xieydd,94,0.03791,211461,85.28029,247960
224,abcdefgs0324,93,0.03751,211554,85.31779,247960
225,eedorenko,93,0.03751,211647,85.35530,247960
226,jazzsir,93,0.03751,211740,85.39281,247960
227,ca-scribner,92,0.03710,211832,85.42991,247960
228,alembiewski,91,0.03670,211923,85.46661,247960
229,pablofiumara,91,0.03670,212014,85.50331,247960
230,DnPlas,89,0.03589,212103,85.53920,247960
231,evan-hataishi,88,0.03549,212191,85.57469,247960
232,midhun1998,88,0.03549,212279,85.61018,247960
233,jiaqianjing,87,0.03509,212366,85.64527,247960
234,LaynePeng,87,0.03509,212453,85.68035,247960
235,lynnmatrix,87,0.03509,212540,85.71544,247960
236,NickLoukas,85,0.03428,212625,85.74972,247960
237,SaschaHeyer,84,0.03388,212709,85.78359,247960
238,cyrilthank,83,0.03347,212792,85.81707,247960
239,deepk2u,83,0.03347,212875,85.85054,247960
240,xfate123,83,0.03347,212958,85.88401,247960
241,cvenets,81,0.03267,213039,85.91668,247960
242,dldaisy,81,0.03267,213120,85.94935,247960
243,ewilderj,80,0.03226,213200,85.98161,247960
244,JohanWork,80,0.03226,213280,86.01387,247960
245,parthmishra,80,0.03226,213360,86.04614,247960
246,tduffy000,80,0.03226,213440,86.07840,247960
247,a9p,79,0.03186,213519,86.11026,247960
248,crobby,79,0.03186,213598,86.14212,247960
249,lowang-bh,79,0.03186,213677,86.17398,247960
250,xhejtman,79,0.03186,213756,86.20584,247960
251,zanedurante,79,0.03186,213835,86.23770,247960
252,yashjakhotiya,78,0.03146,213913,86.26916,247960
253,jackwhelpton,77,0.03105,213990,86.30021,247960
254,cheimu,76,0.03065,214066,86.33086,247960
255,wukong1992,76,0.03065,214142,86.36151,247960
256,yilun-msft,76,0.03065,214218,86.39216,247960
257,aniruddhachoudhury,75,0.03025,214293,86.42241,247960
258,jonasdebeukelaer,75,0.03025,214368,86.45265,247960
259,cleveryg,74,0.02984,214442,86.48250,247960
260,mitake,74,0.02984,214516,86.51234,247960
261,rafalbigaj,74,0.02984,214590,86.54218,247960
262,shaowei-su,74,0.02984,214664,86.57203,247960
263,shaikmanu797,73,0.02944,214737,86.60147,247960
264,Svendegroote91,73,0.02944,214810,86.63091,247960
265,dreamryx,72,0.02904,214882,86.65995,247960
266,OfficePop,72,0.02904,214954,86.68898,247960
267,AlexandreBrown,71,0.02863,215025,86.71762,247960
268,derekhh,71,0.02863,215096,86.74625,247960
269,mattnworb,71,0.02863,215167,86.77488,247960
270,shinytang6,71,0.02863,215238,86.80352,247960
271,kd303,70,0.02823,215308,86.83175,247960
272,nagar-ajay,70,0.02823,215378,86.85998,247960
273,mimowo,68,0.02742,215446,86.88740,247960
274,Ajay191191,67,0.02702,215513,86.91442,247960
275,xiaozhouX,67,0.02702,215580,86.94144,247960
276,fediazgon,66,0.02662,215646,86.96806,247960
277,TobiasGoerke,66,0.02662,215712,86.99468,247960
278,willb,66,0.02662,215778,87.02129,247960
279,adriangonz,65,0.02621,215843,87.04751,247960
280,DeeperMind,65,0.02621,215908,87.07372,247960
281,fisherxu,65,0.02621,215973,87.09994,247960
282,iancoffey,65,0.02621,216038,87.12615,247960
283,TheJaySmith,65,0.02621,216103,87.15236,247960
284,tingweiwu,65,0.02621,216168,87.17858,247960
285,toshi-k,65,0.02621,216233,87.20479,247960
286,QxiaoQ,64,0.02581,216297,87.23060,247960
287,sakaia,64,0.02581,216361,87.25641,247960
288,yixinshi,64,0.02581,216425,87.28222,247960
289,d-gol,63,0.02541,216488,87.30763,247960
290,nkashy1,63,0.02541,216551,87.33304,247960
291,castrojo,62,0.02500,216613,87.35804,247960
292,SeibertronSS,62,0.02500,216675,87.38305,247960
293,heluocs,61,0.02460,216736,87.40765,247960
294,pingsutw,61,0.02460,216797,87.43225,247960
295,radcheb,61,0.02460,216858,87.45685,247960
296,ReggieCarey,61,0.02460,216919,87.48145,247960
297,tomalbrecht,61,0.02460,216980,87.50605,247960
298,edi-bice-by,59,0.02379,217039,87.52984,247960
299,AnyISalIn,58,0.02339,217097,87.55323,247960
300,deadeyegoodwin,58,0.02339,217155,87.57663,247960
301,toshiiw,58,0.02339,217213,87.60002,247960
302,asispatra,57,0.02299,217270,87.62300,247960
303,DjangoPeng,57,0.02299,217327,87.64599,247960
304,soolaugust,57,0.02299,217384,87.66898,247960
305,zhangrongguo,57,0.02299,217441,87.69197,247960
306,ArangoGutierrez,56,0.02258,217497,87.71455,247960
307,dwightjl,56,0.02258,217553,87.73714,247960
308,judahrand,56,0.02258,217609,87.75972,247960
309,mofanke,56,0.02258,217665,87.78230,247960
310,rd-pong,56,0.02258,217721,87.80489,247960
311,tiru1930,56,0.02258,217777,87.82747,247960
312,mvoitko,55,0.02218,217832,87.84965,247960
313,raviranjan0309,55,0.02218,217887,87.87183,247960
314,vincent-pli,55,0.02218,217942,87.89402,247960
315,AlanFokCo,54,0.02178,217996,87.91579,247960
316,yaronha,54,0.02178,218050,87.93757,247960
317,blublinsky,53,0.02137,218103,87.95894,247960
318,edenbuaa,53,0.02137,218156,87.98032,247960
319,henrysecond1,53,0.02137,218209,88.00169,247960
320,jay-saldanha,53,0.02137,218262,88.02307,247960
321,jiyongjung0,53,0.02137,218315,88.04444,247960
322,kim-sardine,53,0.02137,218368,88.06582,247960
323,supertetelman,53,0.02137,218421,88.08719,247960
324,HeGaoYuan,52,0.02097,218473,88.10816,247960
325,kelvins,52,0.02097,218525,88.12913,247960
326,LeonardAukea,52,0.02097,218577,88.15010,247960
327,markwinter,52,0.02097,218629,88.17108,247960
328,PeterChg,52,0.02097,218681,88.19205,247960
329,Ruminateer,52,0.02097,218733,88.21302,247960
330,rummens,52,0.02097,218785,88.23399,247960
331,yuvipanda,52,0.02097,218837,88.25496,247960
332,SachinVarghese,51,0.02057,218888,88.27553,247960
333,toshitanian,51,0.02057,218939,88.29610,247960
334,wzhanw,51,0.02057,218990,88.31666,247960
335,axel7083,50,0.02016,219040,88.33683,247960
336,boarder7395,50,0.02016,219090,88.35699,247960
337,goswamig,49,0.01976,219139,88.37675,247960
338,jdplatt,49,0.01976,219188,88.39652,247960
339,vishh,49,0.01976,219237,88.41628,247960
340,pradithya,48,0.01936,219285,88.43563,247960
341,prem0912,48,0.01936,219333,88.45499,247960
342,qiankunli,48,0.01936,219381,88.47435,247960
343,saschagrunert,48,0.01936,219429,88.49371,247960
344,wdhorton,48,0.01936,219477,88.51307,247960
345,xinbinhuang,48,0.01936,219525,88.53242,247960
346,apryiomka,47,0.01895,219572,88.55138,247960
347,chenzhiwei,47,0.01895,219619,88.57033,247960
348,daikeshi,47,0.01895,219666,88.58929,247960
349,HassanOuda,47,0.01895,219713,88.60824,247960
350,PatrickGhosn,47,0.01895,219760,88.62720,247960
351,Realsen,47,0.01895,219807,88.64615,247960
352,Shuai-Xie,47,0.01895,219854,88.66511,247960
353,ahg-g,46,0.01855,219900,88.68366,247960
354,akgraner,46,0.01855,219946,88.70221,247960
355,erikerlandson,46,0.01855,219992,88.72076,247960
356,fabito,46,0.01855,220038,88.73931,247960
357,rarkins,46,0.01855,220084,88.75786,247960
358,sheevy,46,0.01855,220130,88.77642,247960
359,warf34,46,0.01855,220176,88.79497,247960
360,willingc,46,0.01855,220222,88.81352,247960
361,Kyrremann,45,0.01815,220267,88.83167,247960
362,TimZaman,45,0.01815,220312,88.84981,247960
363,amitripshtos,44,0.01774,220356,88.86756,247960
364,axsaucedo,44,0.01774,220400,88.88530,247960
365,danishsamad,44,0.01774,220444,88.90305,247960
366,garganubhav,44,0.01774,220488,88.92079,247960
367,hlu09,44,0.01774,220532,88.93854,247960
368,Hmr-ramzi,44,0.01774,220576,88.95628,247960
369,ldcastell,44,0.01774,220620,88.97403,247960
370,shuesc1,44,0.01774,220664,88.99177,247960
371,MATRIX4284,43,0.01734,220707,89.00911,247960
372,hzxuzhonghu,42,0.01694,220749,89.02605,247960
373,mkbhanda,42,0.01694,220791,89.04299,247960
374,ontheway16,42,0.01694,220833,89.05993,247960
375,Thor-wl,42,0.01694,220875,89.07687,247960
376,asahalyft,41,0.01653,220916,89.09340,247960
377,cjwagner,41,0.01653,220957,89.10994,247960
378,denkensk,41,0.01653,220998,89.12647,247960
379,elukey,41,0.01653,221039,89.14301,247960
380,Gsantomaggio,41,0.01653,221080,89.15954,247960
381,jkuruba,41,0.01653,221121,89.17608,247960
382,krzyzacy,41,0.01653,221162,89.19261,247960
383,lkpdn,41,0.01653,221203,89.20915,247960
384,ssheng,41,0.01653,221244,89.22568,247960
385,zlcnju,41,0.01653,221285,89.24222,247960
386,akirillov,40,0.01613,221325,89.25835,247960
387,fxue,40,0.01613,221365,89.27448,247960
388,hilcj,40,0.01613,221405,89.29061,247960
389,hmtai,40,0.01613,221445,89.30674,247960
390,jmcarp,40,0.01613,221485,89.32287,247960
391,rafaelbarreto87,40,0.01613,221525,89.33901,247960
392,TrsNium,40,0.01613,221565,89.35514,247960
393,bokleung,39,0.01573,221604,89.37087,247960
394,mpvartak,39,0.01573,221643,89.38659,247960
395,ojarjur,39,0.01573,221682,89.40232,247960
396,shotarok,39,0.01573,221721,89.41805,247960
397,ynqa,39,0.01573,221760,89.43378,247960
398,Dimiftb,38,0.01533,221798,89.44910,247960
399,vinayan3,38,0.01533,221836,89.46443,247960
400,asdfsx,37,0.01492,221873,89.47935,247960
401,chinmay22897,37,0.01492,221910,89.49427,247960
402,devxoxo,37,0.01492,221947,89.50920,247960
403,hackerboy01,37,0.01492,221984,89.52412,247960
404,ioandr,37,0.01492,222021,89.53904,247960
405,omarzouk,37,0.01492,222058,89.55396,247960
406,sachua,37,0.01492,222095,89.56888,247960
407,shikha130vv,37,0.01492,222132,89.58380,247960
408,Subreptivus,37,0.01492,222169,89.59873,247960
409,thedriftofwords,37,0.01492,222206,89.61365,247960
410,vjrantal,37,0.01492,222243,89.62857,247960
411,votti,37,0.01492,222280,89.64349,247960
412,yph152,37,0.01492,222317,89.65841,247960
413,zhujl1991,37,0.01492,222354,89.67333,247960
414,zionwu,37,0.01492,222391,89.68826,247960
415,372046933,36,0.01452,222427,89.70277,247960
416,anneum,36,0.01452,222463,89.71729,247960
417,jli,36,0.01452,222499,89.73181,247960
418,jsitu777,36,0.01452,222535,89.74633,247960
419,sylus,36,0.01452,222571,89.76085,247960
420,wengyao04,36,0.01452,222607,89.77537,247960
421,yoni-taranis,36,0.01452,222643,89.78989,247960
422,ywskycn,36,0.01452,222679,89.80440,247960
423,aaron-arellano,35,0.01412,222714,89.81852,247960
424,adilhusain-s,35,0.01412,222749,89.83263,247960
425,anupash147,35,0.01412,222784,89.84675,247960
426,danisla,35,0.01412,222819,89.86086,247960
427,evilnick,35,0.01412,222854,89.87498,247960
428,jasonliu747,35,0.01412,222889,89.88910,247960
429,jmsking,35,0.01412,222924,89.90321,247960
430,terrykong,35,0.01412,222959,89.91733,247960
431,wg102,35,0.01412,222994,89.93144,247960
432,yantriks-edi-bice,35,0.01412,223029,89.94556,247960
433,bartgras,34,0.01371,223063,89.95927,247960
434,haibingzhao,34,0.01371,223097,89.97298,247960
435,jzp1025,34,0.01371,223131,89.98669,247960
436,lehrig,34,0.01371,223165,90.00040,247960
437,leileiwan,34,0.01371,223199,90.01412,247960
438,libbyandhelen,34,0.01371,223233,90.02783,247960
439,plaffitte,34,0.01371,223267,90.04154,247960
440,seong7,34,0.01371,223301,90.05525,247960
441,shanidchamal,34,0.01371,223335,90.06896,247960
442,susan-shu-c,34,0.01371,223369,90.08267,247960
443,Utkagr,34,0.01371,223403,90.09639,247960
444,axelgobletbdr,33,0.01331,223436,90.10970,247960
445,ernestmartinez,33,0.01331,223469,90.12300,247960
446,ittus,33,0.01331,223502,90.13631,247960
447,magencio,33,0.01331,223535,90.14962,247960
448,pahask8,33,0.01331,223568,90.16293,247960
449,rem20806,33,0.01331,223601,90.17624,247960
450,tzstoyanov,33,0.01331,223634,90.18955,247960
451,vit-,33,0.01331,223667,90.20286,247960
452,ashahab,32,0.01291,223699,90.21576,247960
453,b675987273,32,0.01291,223731,90.22867,247960
454,cclauss,32,0.01291,223763,90.24157,247960
455,connorlwilkes,32,0.01291,223795,90.25448,247960
456,Dampolo03,32,0.01291,223827,90.26738,247960
457,praveen049,32,0.01291,223859,90.28029,247960
458,rc-coderepo,32,0.01291,223891,90.29319,247960
459,robbertvdg,32,0.01291,223923,90.30610,247960
460,UrmsOne,32,0.01291,223955,90.31900,247960
461,vaskokj,32,0.01291,223987,90.33191,247960
462,xiechengsheng,32,0.01291,224019,90.34481,247960
463,amitmukati-2604,31,0.01250,224050,90.35732,247960
464,axelborja,31,0.01250,224081,90.36982,247960
465,ccarpentiere,31,0.01250,224112,90.38232,247960
466,codeflitting,31,0.01250,224143,90.39482,247960
467,daganida88,31,0.01250,224174,90.40732,247960
468,davidstack,31,0.01250,224205,90.41983,247960
469,descampsk,31,0.01250,224236,90.43233,247960
470,hsinhoyeh,31,0.01250,224267,90.44483,247960
471,janvdvegt,31,0.01250,224298,90.45733,247960
472,KevinBNaughton,31,0.01250,224329,90.46983,247960
473,leoncamel,31,0.01250,224360,90.48234,247960
474,Manvi07,31,0.01250,224391,90.49484,247960
475,njhill,31,0.01250,224422,90.50734,247960
476,ramdootp,31,0.01250,224453,90.51984,247960
477,royxue,31,0.01250,224484,90.53234,247960
478,thunderboltsid,31,0.01250,224515,90.54485,247960
479,yylin1,31,0.01250,224546,90.55735,247960
480,arshashi,30,0.01210,224576,90.56945,247960
481,awcchungster,30,0.01210,224606,90.58155,247960
482,carolynwang,30,0.01210,224636,90.59364,247960
483,connected-bsamadi,30,0.01210,224666,90.60574,247960
484,crmne,30,0.01210,224696,90.61784,247960
485,IMBurbank,30,0.01210,224726,90.62994,247960
486,Oblynx,30,0.01210,224756,90.64204,247960
487,slenky,30,0.01210,224786,90.65414,247960
488,sulabh2000,30,0.01210,224816,90.66624,247960
489,Talador12,30,0.01210,224846,90.67834,247960
490,yubozhao,30,0.01210,224876,90.69043,247960
491,abkosar,29,0.01170,224905,90.70213,247960
492,butuzov,29,0.01170,224934,90.71382,247960
493,judyheflin,29,0.01170,224963,90.72552,247960
494,kawych,29,0.01170,224992,90.73722,247960
495,kindomLee,29,0.01170,225021,90.74891,247960
496,marrrcin,29,0.01170,225050,90.76061,247960
497,timothyjlaurent,29,0.01170,225079,90.77230,247960
498,tingshua-yts,29,0.01170,225108,90.78400,247960
499,zjj2wry,29,0.01170,225137,90.79569,247960
500,cloudbow,28,0.01129,225165,90.80698,247960
501,ekesken,28,0.01129,225193,90.81828,247960
502,ggaaooppeenngg,28,0.01129,225221,90.82957,247960
503,MaanavD,28,0.01129,225249,90.84086,247960
504,marcindulak,28,0.01129,225277,90.85215,247960
505,MatthewRalston,28,0.01129,225305,90.86345,247960
506,mszacillo,28,0.01129,225333,90.87474,247960
507,rbrishabh,28,0.01129,225361,90.88603,247960
508,r-matsuzaka,28,0.01129,225389,90.89732,247960
509,simmscg,28,0.01129,225417,90.90861,247960
510,vinaykakade,28,0.01129,225445,90.91991,247960
511,XinkaiWang515,28,0.01129,225473,90.93120,247960
512,631068264,27,0.01089,225500,90.94209,247960
513,DeliangFan,27,0.01089,225527,90.95298,247960
514,dwhitena,27,0.01089,225554,90.96387,247960
515,haijohn,27,0.01089,225581,90.97475,247960
516,Josepholaidepetro,27,0.01089,225608,90.98564,247960
517,kosehy,27,0.01089,225635,90.99653,247960
518,mnmami,27,0.01089,225662,91.00742,247960
519,Shaked,27,0.01089,225689,91.01831,247960
520,ShilpaGopal,27,0.01089,225716,91.02920,247960
521,u2takey,27,0.01089,225743,91.04009,247960
522,wuchunghsuan,27,0.01089,225770,91.05098,247960
523,wyljpn,27,0.01089,225797,91.06186,247960
524,zhan849,27,0.01089,225824,91.07275,247960
525,zhangchunsheng,27,0.01089,225851,91.08364,247960
526,zhixian82,27,0.01089,225878,91.09453,247960
527,amrobbins,26,0.01049,225904,91.10502,247960
528,benjamintanweihao,26,0.01049,225930,91.11550,247960
529,bitscuit,26,0.01049,225956,91.12599,247960
530,DmitryBe,26,0.01049,225982,91.13647,247960
531,jacobmalmberg,26,0.01049,226008,91.14696,247960
532,josepholaide,26,0.01049,226034,91.15744,247960
533,jzhoucliqr,26,0.01049,226060,91.16793,247960
534,kmarquardsen,26,0.01049,226086,91.17842,247960
535,krabhishek8260,26,0.01049,226112,91.18890,247960
536,lucinvitae,26,0.01049,226138,91.19939,247960
537,lukaszgryglicki,26,0.01049,226164,91.20987,247960
538,micemuni,26,0.01049,226190,91.22036,247960
539,mtickoobb,26,0.01049,226216,91.23084,247960
540,pvgbabu,26,0.01049,226242,91.24133,247960
541,rky0930,26,0.01049,226268,91.25181,247960
542,rtrobin,26,0.01049,226294,91.26230,247960
543,shalberd,26,0.01049,226320,91.27279,247960
544,thuzhf,26,0.01049,226346,91.28327,247960
545,valentin-stefan-popa,26,0.01049,226372,91.29376,247960
546,wyong16,26,0.01049,226398,91.30424,247960
547,alexandraj777,25,0.01008,226423,91.31432,247960
548,alsrgv,25,0.01008,226448,91.32441,247960
549,ccding,25,0.01008,226473,91.33449,247960
550,decewei,25,0.01008,226498,91.34457,247960
551,devgrok,25,0.01008,226523,91.35465,247960
552,govindKAG,25,0.01008,226548,91.36474,247960
553,karthikvadla,25,0.01008,226573,91.37482,247960
554,khoa-ho,25,0.01008,226598,91.38490,247960
555,majorinche,25,0.01008,226623,91.39498,247960
556,mayankjuneja,25,0.01008,226648,91.40507,247960
557,panchul,25,0.01008,226673,91.41515,247960
558,Sakuralbj,25,0.01008,226698,91.42523,247960
559,seizadi,25,0.01008,226723,91.43531,247960
560,ssiegel95,25,0.01008,226748,91.44539,247960
561,tedhtchang,25,0.01008,226773,91.45548,247960
562,Dhaval08,24,0.00968,226797,91.46516,247960
563,EKami,24,0.00968,226821,91.47483,247960
564,elmiko,24,0.00968,226845,91.48451,247960
565,Eric-Zhang1990,24,0.00968,226869,91.49419,247960
566,faweis,24,0.00968,226893,91.50387,247960
567,Garrybest,24,0.00968,226917,91.51355,247960
568,g-votte,24,0.00968,226941,91.52323,247960
569,ianhellstrom,24,0.00968,226965,91.53291,247960
570,JavaDerek,24,0.00968,226989,91.54259,247960
571,jiwang576,24,0.00968,227013,91.55227,247960
572,KingOnTheStar,24,0.00968,227037,91.56195,247960
573,marload,24,0.00968,227061,91.57162,247960
574,Peilun-Li,24,0.00968,227085,91.58130,247960
575,pvsousalima,24,0.00968,227109,91.59098,247960
576,samuelvl,24,0.00968,227133,91.60066,247960
577,streamnsight,24,0.00968,227157,91.61034,247960
578,swamat,24,0.00968,227181,91.62002,247960
579,tmckayus,24,0.00968,227205,91.62970,247960
580,xuhdev,24,0.00968,227229,91.63938,247960
581,alongzhi,23,0.00928,227252,91.64865,247960
582,chinhuang007,23,0.00928,227275,91.65793,247960
583,consideRatio,23,0.00928,227298,91.66720,247960
584,czheng94,23,0.00928,227321,91.67648,247960
585,dalbhanj,23,0.00928,227344,91.68576,247960
586,frozeNinK,23,0.00928,227367,91.69503,247960
587,gilbeckers,23,0.00928,227390,91.70431,247960
588,huixa,23,0.00928,227413,91.71358,247960
589,jokerwenxiao,23,0.00928,227436,91.72286,247960
590,matthen,23,0.00928,227459,91.73213,247960
591,naseemkullah,23,0.00928,227482,91.74141,247960
592,Nick-Harvey,23,0.00928,227505,91.75069,247960
593,runzhliu,23,0.00928,227528,91.75996,247960
594,ryantd,23,0.00928,227551,91.76924,247960
595,solovyevt,23,0.00928,227574,91.77851,247960
596,sriumcp,23,0.00928,227597,91.78779,247960
597,ucdmkt,23,0.00928,227620,91.79706,247960
598,umialpha,23,0.00928,227643,91.80634,247960
599,umka1332,23,0.00928,227666,91.81562,247960
600,yzhaozh,23,0.00928,227689,91.82489,247960
601,Aaronchoo,22,0.00887,227711,91.83376,247960
602,abdulsalama,22,0.00887,227733,91.84264,247960
603,acesir,22,0.00887,227755,91.85151,247960
604,capt2101akash,22,0.00887,227777,91.86038,247960
605,cndaimin,22,0.00887,227799,91.86925,247960
606,DanaHan,22,0.00887,227821,91.87813,247960
607,Felihong,22,0.00887,227843,91.88700,247960
608,grapefruitL,22,0.00887,227865,91.89587,247960
609,JohnPaton,22,0.00887,227887,91.90474,247960
610,kramachandran,22,0.00887,227909,91.91362,247960
611,LaVLaS,22,0.00887,227931,91.92249,247960
612,maanur,22,0.00887,227953,91.93136,247960
613,marwan116,22,0.00887,227975,91.94023,247960
614,ohmystack,22,0.00887,227997,91.94910,247960
615,oikomi,22,0.00887,228019,91.95798,247960
616,ricoms,22,0.00887,228041,91.96685,247960
617,rzgry,22,0.00887,228063,91.97572,247960
618,sahilmalav,22,0.00887,228085,91.98459,247960
619,sambaiz,22,0.00887,228107,91.99347,247960
620,strangemonad-faire,22,0.00887,228129,92.00234,247960
621,xychu,22,0.00887,228151,92.01121,247960
622,yurkoff-mv,22,0.00887,228173,92.02008,247960
623,AK-ayush,21,0.00847,228194,92.02855,247960
624,b4sus,21,0.00847,228215,92.03702,247960
625,BenTheElder,21,0.00847,228236,92.04549,247960
626,bikramnehra,21,0.00847,228257,92.05396,247960
627,bvboca,21,0.00847,228278,92.06243,247960
628,Chaos-Ju,21,0.00847,228299,92.07090,247960
629,chongchuanbing,21,0.00847,228320,92.07937,247960
630,dzungductran,21,0.00847,228341,92.08784,247960
631,eliaskoromilas,21,0.00847,228362,92.09631,247960
632,grobbie,21,0.00847,228383,92.10477,247960
633,jeremievallee,21,0.00847,228404,92.11324,247960
634,jizg,21,0.00847,228425,92.12171,247960
635,Julianxo,21,0.00847,228446,92.13018,247960
636,kbentaleb,21,0.00847,228467,92.13865,247960
637,lovejoy,21,0.00847,228488,92.14712,247960
638,mfojtak,21,0.00847,228509,92.15559,247960
639,ogre0403,21,0.00847,228530,92.16406,247960
640,ritazh,21,0.00847,228551,92.17253,247960
641,tizhou86,21,0.00847,228572,92.18100,247960
642,Ursanon,21,0.00847,228593,92.18947,247960
643,xiaogaozi,21,0.00847,228614,92.19794,247960
644,browningjp-datatonic,20,0.00807,228634,92.20600,247960
645,clarketm,20,0.00807,228654,92.21407,247960
646,dilzeem,20,0.00807,228674,92.22213,247960
647,dtzar,20,0.00807,228694,92.23020,247960
648,happyhuman,20,0.00807,228714,92.23826,247960
649,kandrio98,20,0.00807,228734,92.24633,247960
650,kvalev,20,0.00807,228754,92.25440,247960
651,linkvt,20,0.00807,228774,92.26246,247960
652,llegolas,20,0.00807,228794,92.27053,247960
653,Luke035,20,0.00807,228814,92.27859,247960
654,matty1979,20,0.00807,228834,92.28666,247960
655,mvartakAtVerta,20,0.00807,228854,92.29472,247960
656,ofaz,20,0.00807,228874,92.30279,247960
657,otaviocv,20,0.00807,228894,92.31086,247960
658,posix4e,20,0.00807,228914,92.31892,247960
659,pramodrj07,20,0.00807,228934,92.32699,247960
660,pranavpandit1,20,0.00807,228954,92.33505,247960
661,prcastro,20,0.00807,228974,92.34312,247960
662,Sharathmk99,20,0.00807,228994,92.35119,247960
663,svalleru,20,0.00807,229014,92.35925,247960
664,ulrikpl,20,0.00807,229034,92.36732,247960
665,vaskozl,20,0.00807,229054,92.37538,247960
666,yassine-labidi,20,0.00807,229074,92.38345,247960
667,YesterdayxD,20,0.00807,229094,92.39151,247960
668,amalts,19,0.00766,229113,92.39918,247960
669,anifort,19,0.00766,229132,92.40684,247960
670,arllanos,19,0.00766,229151,92.41450,247960
671,arun-gupta,19,0.00766,229170,92.42216,247960
672,CBischke,19,0.00766,229189,92.42983,247960
673,FlempTW,19,0.00766,229208,92.43749,247960
674,Iuiu1234,19,0.00766,229227,92.44515,247960
675,jeffgriffith,19,0.00766,229246,92.45281,247960
676,jessesuen,19,0.00766,229265,92.46048,247960
677,jmdevcs,19,0.00766,229284,92.46814,247960
678,jwwandy,19,0.00766,229303,92.47580,247960
679,lqj679ssn,19,0.00766,229322,92.48347,247960
680,OyutianO,19,0.00766,229341,92.49113,247960
681,plang85,19,0.00766,229360,92.49879,247960
682,s1113950,19,0.00766,229379,92.50645,247960
683,shydefoo,19,0.00766,229398,92.51412,247960
684,smsperitus,19,0.00766,229417,92.52178,247960
685,Syntax3rror404,19,0.00766,229436,92.52944,247960
686,szinck1,19,0.00766,229455,92.53710,247960
687,takmatsu,19,0.00766,229474,92.54477,247960
688,tanguycdls,19,0.00766,229493,92.55243,247960
689,vtlrazin,19,0.00766,229512,92.56009,247960
690,Windfarer,19,0.00766,229531,92.56775,247960
691,ysk24ok,19,0.00766,229550,92.57542,247960
692,ytetra,19,0.00766,229569,92.58308,247960
693,aaaaahaaaaa,18,0.00726,229587,92.59034,247960
694,allenc97,18,0.00726,229605,92.59760,247960
695,Arvind-Ideas2IT,18,0.00726,229623,92.60486,247960
696,cfregly,18,0.00726,229641,92.61211,247960
697,chauvenne,18,0.00726,229659,92.61937,247960
698,Davidnet,18,0.00726,229677,92.62663,247960
699,eLco,18,0.00726,229695,92.63389,247960
700,etheleon,18,0.00726,229713,92.64115,247960
701,GauravSarkar,18,0.00726,229731,92.64841,247960
702,hackintoshrao,18,0.00726,229749,92.65567,247960
703,helinwang,18,0.00726,229767,92.66293,247960
704,hellobiek,18,0.00726,229785,92.67019,247960
705,himanshu9345,18,0.00726,229803,92.67745,247960
706,hitesh1907nayyar,18,0.00726,229821,92.68471,247960
707,hno2,18,0.00726,229839,92.69197,247960
708,irvifa,18,0.00726,229857,92.69923,247960
709,juangon,18,0.00726,229875,92.70648,247960
710,leela-uppuluri,18,0.00726,229893,92.71374,247960
711,malixian,18,0.00726,229911,92.72100,247960
712,mastrogiovanni,18,0.00726,229929,92.72826,247960
713,mhausenblas,18,0.00726,229947,92.73552,247960
714,opus111,18,0.00726,229965,92.74278,247960
715,pthalasta,18,0.00726,229983,92.75004,247960
716,ptitzler,18,0.00726,230001,92.75730,247960
717,quanjielin,18,0.00726,230019,92.76456,247960
718,Rishit-dagli,18,0.00726,230037,92.77182,247960
719,SpontaneousDuck,18,0.00726,230055,92.77908,247960
720,wardVD,18,0.00726,230073,92.78634,247960
721,xiaohanhuang,18,0.00726,230091,92.79360,247960
722,yowenter,18,0.00726,230109,92.80085,247960
723,zmhassan,18,0.00726,230127,92.80811,247960
724,zoux86,18,0.00726,230145,92.81537,247960
725,allenzfan,17,0.00686,230162,92.82223,247960
726,andre-lx,17,0.00686,230179,92.82909,247960
727,ankan94,17,0.00686,230196,92.83594,247960
728,cyzhangchenya,17,0.00686,230213,92.84280,247960
729,DavidLangworthy,17,0.00686,230230,92.84965,247960
730,deepdad,17,0.00686,230247,92.85651,247960
731,g-luo,17,0.00686,230264,92.86337,247960
732,Junaid-Ahmed94,17,0.00686,230281,92.87022,247960
733,ketangangal,17,0.00686,230298,92.87708,247960
734,kunalyogenshah,17,0.00686,230315,92.88393,247960
735,larssuanet,17,0.00686,230332,92.89079,247960
736,leonardosul,17,0.00686,230349,92.89764,247960
737,Minkyu-Choi,17,0.00686,230366,92.90450,247960
738,PrathamSolanki,17,0.00686,230383,92.91136,247960
739,pselden,17,0.00686,230400,92.91821,247960
740,rimolive,17,0.00686,230417,92.92507,247960
741,sadeel,17,0.00686,230434,92.93192,247960
742,SebBlin,17,0.00686,230451,92.93878,247960
743,sm-hawkfish,17,0.00686,230468,92.94564,247960
744,vanpelt,17,0.00686,230485,92.95249,247960
745,WillBeebe,17,0.00686,230502,92.95935,247960
746,wjddyd66,17,0.00686,230519,92.96620,247960
747,blairdrummond,16,0.00645,230535,92.97266,247960
748,ChenjunZou,16,0.00645,230551,92.97911,247960
749,chethanmahadevaiah,16,0.00645,230567,92.98556,247960
750,ckchow,16,0.00645,230583,92.99201,247960
751,gabornyerges,16,0.00645,230599,92.99847,247960
752,gabrielvcbessa,16,0.00645,230615,93.00492,247960
753,georgkaleido,16,0.00645,230631,93.01137,247960
754,gogogwwb,16,0.00645,230647,93.01783,247960
755,hackenzheng,16,0.00645,230663,93.02428,247960
756,halvgaard,16,0.00645,230679,93.03073,247960
757,jiaxuanzhou,16,0.00645,230695,93.03718,247960
758,jobvarkey,16,0.00645,230711,93.04364,247960
759,jspenc72,16,0.00645,230727,93.05009,247960
760,kairos03,16,0.00645,230743,93.05654,247960
761,kierenj,16,0.00645,230759,93.06299,247960
762,meibenjin,16,0.00645,230775,93.06945,247960
763,meizabel,16,0.00645,230791,93.07590,247960
764,melihsqsp,16,0.00645,230807,93.08235,247960
765,mmatiaschek,16,0.00645,230823,93.08880,247960
766,mochiliu3000,16,0.00645,230839,93.09526,247960
767,narennadig,16,0.00645,230855,93.10171,247960
768,panpanli521,16,0.00645,230871,93.10816,247960
769,prasadkyp7,16,0.00645,230887,93.11462,247960
770,RDelg,16,0.00645,230903,93.12107,247960
771,Rohithzr,16,0.00645,230919,93.12752,247960
772,SimonCqk,16,0.00645,230935,93.13397,247960
773,snowneji,16,0.00645,230951,93.14043,247960
774,solarist,16,0.00645,230967,93.14688,247960
775,strawberrypie,16,0.00645,230983,93.15333,247960
776,TaylorHere,16,0.00645,230999,93.15978,247960
777,tumido,16,0.00645,231015,93.16624,247960
778,typeness,16,0.00645,231031,93.17269,247960
779,wenmin-wu,16,0.00645,231047,93.17914,247960
780,whalecold,16,0.00645,231063,93.18559,247960
781,xigang,16,0.00645,231079,93.19205,247960
782,aakashbajaj,15,0.00605,231094,93.19810,247960
783,AGKhalil,15,0.00605,231109,93.20415,247960
784,aheeruru,15,0.00605,231124,93.21020,247960
785,Akashdesarda,15,0.00605,231139,93.21624,247960
786,akchinSTC,15,0.00605,231154,93.22229,247960
787,alexeykaplin,15,0.00605,231169,93.22834,247960
788,axsauze,15,0.00605,231184,93.23439,247960
789,barambani,15,0.00605,231199,93.24044,247960
790,bkungfoo,15,0.00605,231214,93.24649,247960
791,chetanoruganti,15,0.00605,231229,93.25254,247960
792,dagondagon666,15,0.00605,231244,93.25859,247960
793,dtrawins,15,0.00605,231259,93.26464,247960
794,dvaldivia,15,0.00605,231274,93.27069,247960
795,fdasilva59,15,0.00605,231289,93.27674,247960
796,HongHuangNeu,15,0.00605,231304,93.28279,247960
797,imskr,15,0.00605,231319,93.28884,247960
798,ivan-valkov,15,0.00605,231334,93.29489,247960
799,jlbutler,15,0.00605,231349,93.30094,247960
800,julioo,15,0.00605,231364,93.30698,247960
801,kflynn,15,0.00605,231379,93.31303,247960
802,kimkihoon0515,15,0.00605,231394,93.31908,247960
803,knave07,15,0.00605,231409,93.32513,247960
804,kpouget,15,0.00605,231424,93.33118,247960
805,kweinmeister,15,0.00605,231439,93.33723,247960
806,LearnKen,15,0.00605,231454,93.34328,247960
807,lilida,15,0.00605,231469,93.34933,247960
808,martialblog,15,0.00605,231484,93.35538,247960
809,Matts966,15,0.00605,231499,93.36143,247960
810,mohona17,15,0.00605,231514,93.36748,247960
811,mokpolar,15,0.00605,231529,93.37353,247960
812,mpoqq,15,0.00605,231544,93.37958,247960
813,muthurajr,15,0.00605,231559,93.38563,247960
814,randxie,15,0.00605,231574,93.39168,247960
815,rostam-github,15,0.00605,231589,93.39773,247960
816,RudraprakashR,15,0.00605,231604,93.40377,247960
817,sergeyshevch,15,0.00605,231619,93.40982,247960
818,SheharyarTkxel,15,0.00605,231634,93.41587,247960
819,sports75482,15,0.00605,231649,93.42192,247960
820,summerisc,15,0.00605,231664,93.42797,247960
821,thandayuthapani,15,0.00605,231679,93.43402,247960
822,tretos53,15,0.00605,231694,93.44007,247960
823,vackysh,15,0.00605,231709,93.44612,247960
824,vsk2015,15,0.00605,231724,93.45217,247960
825,wadhah101,15,0.00605,231739,93.45822,247960
826,wajeehulhassanvii,15,0.00605,231754,93.46427,247960
827,wronk,15,0.00605,231769,93.47032,247960
828,yuhuishi-convect,15,0.00605,231784,93.47637,247960
829,YuxiJin-tobeyjin,15,0.00605,231799,93.48242,247960
830,zxsimple,15,0.00605,231814,93.48847,247960
831,aarondietz234,14,0.00565,231828,93.49411,247960
832,adamkgray,14,0.00565,231842,93.49976,247960
833,akranga,14,0.00565,231856,93.50540,247960
834,alexiguazio,14,0.00565,231870,93.51105,247960
835,anjalisood,14,0.00565,231884,93.51670,247960
836,BBK-PiJ-2015-41,14,0.00565,231898,93.52234,247960
837,ChethanUK,14,0.00565,231912,93.52799,247960
838,chris922,14,0.00565,231926,93.53363,247960
839,dandawg,14,0.00565,231940,93.53928,247960
840,DdMad,14,0.00565,231954,93.54493,247960
841,dhodun,14,0.00565,231968,93.55057,247960
842,doschkinow,14,0.00565,231982,93.55622,247960
843,Everret-moon,14,0.00565,231996,93.56186,247960
844,farisfirenze,14,0.00565,232010,93.56751,247960
845,Farrellow,14,0.00565,232024,93.57316,247960
846,GarnettWang,14,0.00565,232038,93.57880,247960
847,gracechristina,14,0.00565,232052,93.58445,247960
848,gregbarkerdcsg,14,0.00565,232066,93.59010,247960
849,gtarcoder,14,0.00565,232080,93.59574,247960
850,hall,14,0.00565,232094,93.60139,247960
851,iuiu34,14,0.00565,232108,93.60703,247960
852,jiahaoc1993,14,0.00565,232122,93.61268,247960
853,jiuntian,14,0.00565,232136,93.61833,247960
854,jomach,14,0.00565,232150,93.62397,247960
855,Juneezee,14,0.00565,232164,93.62962,247960
856,kangwoo,14,0.00565,232178,93.63526,247960
857,MattRose153,14,0.00565,232192,93.64091,247960
858,mgiessing,14,0.00565,232206,93.64656,247960
859,michaelliqx,14,0.00565,232220,93.65220,247960
860,nareshganesan,14,0.00565,232234,93.65785,247960
861,neolunar7,14,0.00565,232248,93.66349,247960
862,nlarusstone,14,0.00565,232262,93.66914,247960
863,owlet42,14,0.00565,232276,93.67479,247960
864,pbarker,14,0.00565,232290,93.68043,247960
865,post2web,14,0.00565,232304,93.68608,247960
866,Rstar1998,14,0.00565,232318,93.69172,247960
867,sameerbhadouria,14,0.00565,232332,93.69737,247960
868,skogsbrus,14,0.00565,232346,93.70302,247960
869,tcnt,14,0.00565,232360,93.70866,247960
870,tlkh,14,0.00565,232374,93.71431,247960
871,toyow,14,0.00565,232388,93.71995,247960
872,wangkeqiang123,14,0.00565,232402,93.72560,247960
873,wstian,14,0.00565,232416,93.73125,247960
874,xawangyd,14,0.00565,232430,93.73689,247960
875,xrmzju,14,0.00565,232444,93.74254,247960
876,Youki,14,0.00565,232458,93.74819,247960
877,Adarsh2910,13,0.00524,232471,93.75343,247960
878,aleb,13,0.00524,232484,93.75867,247960
879,alexisgaziello,13,0.00524,232497,93.76391,247960
880,ammarn911,13,0.00524,232510,93.76916,247960
881,anatolyzolotar,13,0.00524,232523,93.77440,247960
882,athamark,13,0.00524,232536,93.77964,247960
883,benoitdr,13,0.00524,232549,93.78488,247960
884,charlescurt,13,0.00524,232562,93.79013,247960
885,CraigSterrett,13,0.00524,232575,93.79537,247960
886,dav009,13,0.00524,232588,93.80061,247960
887,dkajtoch,13,0.00524,232601,93.80586,247960
888,dpaks,13,0.00524,232614,93.81110,247960
889,fboylu,13,0.00524,232627,93.81634,247960
890,fischor,13,0.00524,232640,93.82158,247960
891,fyuan1316,13,0.00524,232653,93.82683,247960
892,gaodan-fang,13,0.00524,232666,93.83207,247960
893,hexiaoting,13,0.00524,232679,93.83731,247960
894,hwk42,13,0.00524,232692,93.84256,247960
895,hyche,13,0.00524,232705,93.84780,247960
896,imiller445,13,0.00524,232718,93.85304,247960
897,jlzhao27,13,0.00524,232731,93.85828,247960
898,jmendesky,13,0.00524,232744,93.86353,247960
899,joyme123,13,0.00524,232757,93.86877,247960
900,julienstroheker,13,0.00524,232770,93.87401,247960
901,kimchitsigai,13,0.00524,232783,93.87925,247960
902,kylepad,13,0.00524,232796,93.88450,247960
903,lcax200000,13,0.00524,232809,93.88974,247960
904,Lijo050,13,0.00524,232822,93.89498,247960
905,ljainker,13,0.00524,232835,93.90023,247960
906,LY-today,13,0.00524,232848,93.90547,247960
907,mockdone,13,0.00524,232861,93.91071,247960
908,mosn,13,0.00524,232874,93.91595,247960
909,mrkm4ntr,13,0.00524,232887,93.92120,247960
910,mttcnnff,13,0.00524,232900,93.92644,247960
911,NKUCodingCat,13,0.00524,232913,93.93168,247960
912,omesser,13,0.00524,232926,93.93693,247960
913,osswangxining,13,0.00524,232939,93.94217,247960
914,pablofiumara-azumo,13,0.00524,232952,93.94741,247960
915,paulcarlton-ww,13,0.00524,232965,93.95265,247960
916,portellaa,13,0.00524,232978,93.95790,247960
917,raffaelespazzoli,13,0.00524,232991,93.96314,247960
918,rawc0der,13,0.00524,233004,93.96838,247960
919,rogaha,13,0.00524,233017,93.97362,247960
920,RunOrVeith,13,0.00524,233030,93.97887,247960
921,rustam-ashurov-mcx,13,0.00524,233043,93.98411,247960
922,ryan-williams,13,0.00524,233056,93.98935,247960
923,sabiroid,13,0.00524,233069,93.99460,247960
924,SarathChandran,13,0.00524,233082,93.99984,247960
925,Shasvat0601,13,0.00524,233095,94.00508,247960
926,sidpalas,13,0.00524,233108,94.01032,247960
927,tarat44,13,0.00524,233121,94.01557,247960
928,TrevorM15,13,0.00524,233134,94.02081,247960
929,webD97,13,0.00524,233147,94.02605,247960
930,wmuizelaar,13,0.00524,233160,94.03130,247960
931,XXXXIEHF,13,0.00524,233173,94.03654,247960
932,yingding,13,0.00524,233186,94.04178,247960
933,ykeuter,13,0.00524,233199,94.04702,247960
934,zzmao,13,0.00524,233212,94.05227,247960
935,0olwzo0,12,0.00484,233224,94.05711,247960
936,4n4nd,12,0.00484,233236,94.06195,247960
937,abaland,12,0.00484,233248,94.06678,247960
938,aeoluswing,12,0.00484,233260,94.07162,247960
939,aginpatrick,12,0.00484,233272,94.07646,247960
940,andrewsmartin,12,0.00484,233284,94.08130,247960
941,ariefrahmansyah,12,0.00484,233296,94.08614,247960
942,Aut0R3V,12,0.00484,233308,94.09098,247960
943,bdoohan-goog,12,0.00484,233320,94.09582,247960
944,BeneaAlinAndrei,12,0.00484,233332,94.10066,247960
945,BenHall,12,0.00484,233344,94.10550,247960
946,bermudezmt,12,0.00484,233356,94.11034,247960
947,bwassie,12,0.00484,233368,94.11518,247960
948,charlesa101,12,0.00484,233380,94.12002,247960
949,chingandy,12,0.00484,233392,94.12486,247960
950,dalfos,12,0.00484,233404,94.12970,247960
951,DanielQujun,12,0.00484,233416,94.13454,247960
952,davidyuyuan,12,0.00484,233428,94.13938,247960
953,deepio-oc,12,0.00484,233440,94.14422,247960
954,dhanisahu,12,0.00484,233452,94.14906,247960
955,DontStopMeNow,12,0.00484,233464,94.15390,247960
956,edhenry,12,0.00484,233476,94.15874,247960
957,edwardzjl,12,0.00484,233488,94.16357,247960
958,enriquedacostacambio,12,0.00484,233500,94.16841,247960
959,epa095,12,0.00484,233512,94.17325,247960
960,flx42,12,0.00484,233524,94.17809,247960
961,gar1t,12,0.00484,233536,94.18293,247960
962,GerardoGR,12,0.00484,233548,94.18777,247960
963,gogasca,12,0.00484,233560,94.19261,247960
964,guanhuichen,12,0.00484,233572,94.19745,247960
965,hefedev,12,0.00484,233584,94.20229,247960
966,hsezhiyan,12,0.00484,233596,94.20713,247960
967,hyeonsangjeon,12,0.00484,233608,94.21197,247960
968,Itega,12,0.00484,233620,94.21681,247960
969,jamesthegiantpeach,12,0.00484,233632,94.22165,247960
970,javen218,12,0.00484,233644,94.22649,247960
971,jdumm,12,0.00484,233656,94.23133,247960
972,jidemoski,12,0.00484,233668,94.23617,247960
973,jmalobicky,12,0.00484,233680,94.24101,247960
974,jrykr,12,0.00484,233692,94.24585,247960
975,krajasek,12,0.00484,233704,94.25069,247960
976,lauradang,12,0.00484,233716,94.25553,247960
977,LEDfan,12,0.00484,233728,94.26036,247960
978,Lejboelle,12,0.00484,233740,94.26520,247960
979,lomori,12,0.00484,233752,94.27004,247960
980,Lordfourteen,12,0.00484,233764,94.27488,247960
981,mkkb473,12,0.00484,233776,94.27972,247960
982,nachogarciam,12,0.00484,233788,94.28456,247960
983,Nagarajj,12,0.00484,233800,94.28940,247960
984,nikhil-koul,12,0.00484,233812,94.29424,247960
985,nitesh31mishra,12,0.00484,233824,94.29908,247960
986,nongqiqin,12,0.00484,233836,94.30392,247960
987,nqn,12,0.00484,233848,94.30876,247960
988,nuka137,12,0.00484,233860,94.31360,247960
989,ohke,12,0.00484,233872,94.31844,247960
990,OmriShiv,12,0.00484,233884,94.32328,247960
991,owennewo,12,0.00484,233896,94.32812,247960
992,RakeshRaj97,12,0.00484,233908,94.33296,247960
993,romeokienzler,12,0.00484,233920,94.33780,247960
994,saffaalvi,12,0.00484,233932,94.34264,247960
995,shivaylamba,12,0.00484,233944,94.34748,247960
996,sid027,12,0.00484,233956,94.35231,247960
997,songole,12,0.00484,233968,94.35715,247960
998,swapkh91,12,0.00484,233980,94.36199,247960
999,TheMichaelHu,12,0.00484,233992,94.36683,247960
1000,TomomasaTakatori,12,0.00484,234004,94.37167,247960
1001,vvnpan,12,0.00484,234016,94.37651,247960
1002,wallacezzzzz007,12,0.00484,234028,94.38135,247960
1003,WangAllen851018,12,0.00484,234040,94.38619,247960
1004,yiyuanyu17,12,0.00484,234052,94.39103,247960
1005,yuku,12,0.00484,234064,94.39587,247960
1006,zidarko,12,0.00484,234076,94.40071,247960
1007,aalugore-ai,11,0.00444,234087,94.40515,247960
1008,ahsan-n,11,0.00444,234098,94.40958,247960
1009,alexwennerberg,11,0.00444,234109,94.41402,247960
1010,alforik,11,0.00444,234120,94.41845,247960
1011,algs,11,0.00444,234131,94.42289,247960
1012,amybachir,11,0.00444,234142,94.42733,247960
1013,andreclaudino,11,0.00444,234153,94.43176,247960
1014,andrewm4894,11,0.00444,234164,94.43620,247960
1015,ashissharma97,11,0.00444,234175,94.44064,247960
1016,bbarnes52,11,0.00444,234186,94.44507,247960
1017,bencwallace,11,0.00444,234197,94.44951,247960
1018,berlinsaint,11,0.00444,234208,94.45394,247960
1019,bsikander,11,0.00444,234219,94.45838,247960
1020,cc-gb2,11,0.00444,234230,94.46282,247960
1021,chaodaiG,11,0.00444,234241,94.46725,247960
1022,davidxia,11,0.00444,234252,94.47169,247960
1023,dboshardy,11,0.00444,234263,94.47613,247960
1024,dkurt,11,0.00444,234274,94.48056,247960
1025,dongdan39,11,0.00444,234285,94.48500,247960
1026,dstnluong,11,0.00444,234296,94.48943,247960
1027,durandom,11,0.00444,234307,94.49387,247960
1028,gangliao,11,0.00444,234318,94.49831,247960
1029,geekygirldawn,11,0.00444,234329,94.50274,247960
1030,goldwinner,11,0.00444,234340,94.50718,247960
1031,haudren,11,0.00444,234351,94.51161,247960
1032,jagane-infinstor,11,0.00444,234362,94.51605,247960
1033,JakeSummers,11,0.00444,234373,94.52049,247960
1034,jpatanooga,11,0.00444,234384,94.52492,247960
1035,kavemun,11,0.00444,234395,94.52936,247960
1036,keithmattix,11,0.00444,234406,94.53380,247960
1037,konsloiz,11,0.00444,234417,94.53823,247960
1038,ksonbol,11,0.00444,234428,94.54267,247960
1039,kuikuikuizzZ,11,0.00444,234439,94.54710,247960
1040,ldd91,11,0.00444,234450,94.55154,247960
1041,luckyskg,11,0.00444,234461,94.55598,247960
1042,lwj1980s,11,0.00444,234472,94.56041,247960
1043,Mar-ai,11,0.00444,234483,94.56485,247960
1044,marcjimz,11,0.00444,234494,94.56929,247960
1045,meowcakes,11,0.00444,234505,94.57372,247960
1046,mishraprafful,11,0.00444,234516,94.57816,247960
1047,mk-nickyang,11,0.00444,234527,94.58259,247960
1048,m-mayran,11,0.00444,234538,94.58703,247960
1049,navneet1075,11,0.00444,234549,94.59147,247960
1050,nicolaiskogheim,11,0.00444,234560,94.59590,247960
1051,nihir27,11,0.00444,234571,94.60034,247960
1052,o0fatigue,11,0.00444,234582,94.60477,247960
1053,Pallavi-28,11,0.00444,234593,94.60921,247960
1054,ra312,11,0.00444,234604,94.61365,247960
1055,rawkintrevo,11,0.00444,234615,94.61808,247960
1056,reem,11,0.00444,234626,94.62252,247960
1057,riklopfer,11,0.00444,234637,94.62696,247960
1058,rionam,11,0.00444,234648,94.63139,247960
1059,SatwikBhandiwad,11,0.00444,234659,94.63583,247960
1060,soleares,11,0.00444,234670,94.64026,247960
1061,songm28,11,0.00444,234681,94.64470,247960
1062,soyuutaku,11,0.00444,234692,94.64914,247960
1063,SrinivasChilveri,11,0.00444,234703,94.65357,247960
1064,sshakeri,11,0.00444,234714,94.65801,247960
1065,sunilfernandes,11,0.00444,234725,94.66245,247960
1066,tarrade,11,0.00444,234736,94.66688,247960
1067,ThomaswellY,11,0.00444,234747,94.67132,247960
1068,tinyma123,11,0.00444,234758,94.67575,247960
1069,tkatila,11,0.00444,234769,94.68019,247960
1070,ultrons,11,0.00444,234780,94.68463,247960
1071,verult,11,0.00444,234791,94.68906,247960
1072,vijay-nag,11,0.00444,234802,94.69350,247960
1073,virgoaugustine,11,0.00444,234813,94.69794,247960
1074,VoVAllen,11,0.00444,234824,94.70237,247960
1075,WEICHINLIN,11,0.00444,234835,94.70681,247960
1076,whillas,11,0.00444,234846,94.71124,247960
1077,xiaowenxie5,11,0.00444,234857,94.71568,247960
1078,yoanisgil,11,0.00444,234868,94.72012,247960
1079,ytsophie,11,0.00444,234879,94.72455,247960
1080,zoyun,11,0.00444,234890,94.72899,247960
1081,zuston,11,0.00444,234901,94.73342,247960
1082,41tair,10,0.00403,234911,94.73746,247960
1083,achalshant,10,0.00403,234921,94.74149,247960
1084,afrittoli,10,0.00403,234931,94.74552,247960
1085,alexec,10,0.00403,234941,94.74956,247960
1086,amitkumarj441,10,0.00403,234951,94.75359,247960
1087,andres-de-castro,10,0.00403,234961,94.75762,247960
1088,AndriiNeverov,10,0.00403,234971,94.76166,247960
1089,AseiSugiyama,10,0.00403,234981,94.76569,247960
1090,axeltidemann,10,0.00403,234991,94.76972,247960
1091,barlock,10,0.00403,235001,94.77375,247960
1092,bestowjay,10,0.00403,235011,94.77779,247960
1093,blacksailer,10,0.00403,235021,94.78182,247960
1094,chaoleili,10,0.00403,235031,94.78585,247960
1095,clausagerskov,10,0.00403,235041,94.78989,247960
1096,Crazybean-lwb,10,0.00403,235051,94.79392,247960
1097,dharmeshkakadia,10,0.00403,235061,94.79795,247960
1098,dynofu,10,0.00403,235071,94.80198,247960
1099,eggiter,10,0.00403,235081,94.80602,247960
1100,fahadh4ilyas,10,0.00403,235091,94.81005,247960
1101,fakeburst,10,0.00403,235101,94.81408,247960
1102,FaustineLi,10,0.00403,235111,94.81812,247960
1103,gosandhya,10,0.00403,235121,94.82215,247960
1104,haghabozorgi,10,0.00403,235131,94.82618,247960
1105,iamshwin,10,0.00403,235141,94.83021,247960
1106,iankoulski,10,0.00403,235151,94.83425,247960
1107,insoo67park,10,0.00403,235161,94.83828,247960
1108,Intellicode,10,0.00403,235171,94.84231,247960
1109,jayunit100,10,0.00403,235181,94.84635,247960
1110,JetMuffin,10,0.00403,235191,94.85038,247960
1111,Jose-Matsuda,10,0.00403,235201,94.85441,247960
1112,josiemundi,10,0.00403,235211,94.85844,247960
1113,jszanto,10,0.00403,235221,94.86248,247960
1114,kamalmemon,10,0.00403,235231,94.86651,247960
1115,Klaven,10,0.00403,235241,94.87054,247960
1116,krish0005,10,0.00403,235251,94.87458,247960
1117,LinuxDevSecOps,10,0.00403,235261,94.87861,247960
1118,LSC527,10,0.00403,235271,94.88264,247960
1119,LuChengTHU,10,0.00403,235281,94.88668,247960
1120,lvcaiping,10,0.00403,235291,94.89071,247960
1121,Maerville,10,0.00403,235301,94.89474,247960
1122,mai-nakagawa,10,0.00403,235311,94.89877,247960
1123,martham93,10,0.00403,235321,94.90281,247960
1124,marwanfahmi,10,0.00403,235331,94.90684,247960
1125,MatthiasCarnein,10,0.00403,235341,94.91087,247960
1126,mengdong,10,0.00403,235351,94.91491,247960
1127,MeranaTona,10,0.00403,235361,94.91894,247960
1128,metrofun,10,0.00403,235371,94.92297,247960
1129,MingfeiPan,10,0.00403,235381,94.92700,247960
1130,miramar-labs,10,0.00403,235391,94.93104,247960
1131,mmwebster,10,0.00403,235401,94.93507,247960
1132,moey920,10,0.00403,235411,94.93910,247960
1133,MohammadOmr,10,0.00403,235421,94.94314,247960
1134,myonlyzzy,10,0.00403,235431,94.94717,247960
1135,NicoG94,10,0.00403,235441,94.95120,247960
1136,nihil0,10,0.00403,235451,94.95523,247960
1137,omartin2010,10,0.00403,235461,94.95927,247960
1138,omlomloml,10,0.00403,235471,94.96330,247960
1139,philwinder,10,0.00403,235481,94.96733,247960
1140,pineking,10,0.00403,235491,94.97137,247960
1141,pretidav,10,0.00403,235501,94.97540,247960
1142,ReyRen,10,0.00403,235511,94.97943,247960
1143,robertzsun-dev,10,0.00403,235521,94.98347,247960
1144,RoyerRamirez,10,0.00403,235531,94.98750,247960
1145,Rustastra,10,0.00403,235541,94.99153,247960
1146,saumilsdk,10,0.00403,235551,94.99556,247960
1147,sh0gg0th,10,0.00403,235561,94.99960,247960
1148,Sharon-iguazio,10,0.00403,235571,95.00363,247960
1149,shawnho1018,10,0.00403,235581,95.00766,247960
1150,Snapple49,10,0.00403,235591,95.01170,247960
1151,stobias123,10,0.00403,235601,95.01573,247960
1152,SumLare,10,0.00403,235611,95.01976,247960
1153,sunnythepatel,10,0.00403,235621,95.02379,247960
1154,tarjintor,10,0.00403,235631,95.02783,247960
1155,thebinaryone1,10,0.00403,235641,95.03186,247960
1156,tmc,10,0.00403,235651,95.03589,247960
1157,tranlyvu,10,0.00403,235661,95.03993,247960
1158,TranThanh96,10,0.00403,235671,95.04396,247960
1159,travishen,10,0.00403,235681,95.04799,247960
1160,tsuiot,10,0.00403,235691,95.05202,247960
1161,typhoonzero,10,0.00403,235701,95.05606,247960
1162,wangzewang,10,0.00403,235711,95.06009,247960
1163,wilbry,10,0.00403,235721,95.06412,247960
1164,wjhhuizi,10,0.00403,235731,95.06816,247960
1165,xiaoxubeii,10,0.00403,235741,95.07219,247960
1166,xybuty,10,0.00403,235751,95.07622,247960
1167,yangyang919,10,0.00403,235761,95.08025,247960
1168,yanp,10,0.00403,235771,95.08429,247960
1169,zhangle-dev,10,0.00403,235781,95.08832,247960
1170,zhuyaguang,10,0.00403,235791,95.09235,247960
1171,zsaladin,10,0.00403,235801,95.09639,247960
1172,3a78f807111,9,0.00363,235810,95.10002,247960
1173,3dimaging,9,0.00363,235819,95.10365,247960
1174,4everming,9,0.00363,235828,95.10728,247960
1175,adepuravikrishna,9,0.00363,235837,95.11090,247960
1176,AdrianLsk,9,0.00363,235846,95.11453,247960
1177,akdigitalself,9,0.00363,235855,95.11816,247960
1178,alexeygorobets,9,0.00363,235864,95.12179,247960
1179,alicelee0606,9,0.00363,235873,95.12542,247960
1180,allendred,9,0.00363,235882,95.12905,247960
1181,allenwux,9,0.00363,235891,95.13268,247960
1182,alokumar1,9,0.00363,235900,95.13631,247960
1183,amarrella,9,0.00363,235909,95.13994,247960
1184,AnberLu,9,0.00363,235918,95.14357,247960
1185,andreafehrman,9,0.00363,235927,95.14720,247960
1186,andrewgdavis,9,0.00363,235936,95.15083,247960
1187,arunnalpet,9,0.00363,235945,95.15446,247960
1188,axelmagn,9,0.00363,235954,95.15809,247960
1189,azmikamis,9,0.00363,235963,95.16172,247960
1190,bruce3557,9,0.00363,235972,95.16535,247960
1191,cabjr,9,0.00363,235981,95.16898,247960
1192,cah-parita-desai,9,0.00363,235990,95.17261,247960
1193,ChaseLyall,9,0.00363,235999,95.17624,247960
1194,chases2,9,0.00363,236008,95.17987,247960
1195,chupman,9,0.00363,236017,95.18350,247960
1196,collinarnett,9,0.00363,236026,95.18713,247960
1197,crosvera,9,0.00363,236035,95.19076,247960
1198,cwei44,9,0.00363,236044,95.19439,247960
1199,D0m021ng,9,0.00363,236053,95.19802,247960
1200,danieldn,9,0.00363,236062,95.20165,247960
1201,deathemperor,9,0.00363,236071,95.20528,247960
1202,dlorenc,9,0.00363,236080,95.20890,247960
1203,dutingda,9,0.00363,236089,95.21253,247960
1204,dylanpiergies,9,0.00363,236098,95.21616,247960
1205,eavelardev,9,0.00363,236107,95.21979,247960
1206,emmayang,9,0.00363,236116,95.22342,247960
1207,evonit,9,0.00363,236125,95.22705,247960
1208,geojaz,9,0.00363,236134,95.23068,247960
1209,harshad16,9,0.00363,236143,95.23431,247960
1210,ijackcy,9,0.00363,236152,95.23794,247960
1211,izapolsk,9,0.00363,236161,95.24157,247960
1212,jalola,9,0.00363,236170,95.24520,247960
1213,jcurlier,9,0.00363,236179,95.24883,247960
1214,JessicaBarh,9,0.00363,236188,95.25246,247960
1215,joey100,9,0.00363,236197,95.25609,247960
1216,johan-andersson01,9,0.00363,236206,95.25972,247960
1217,jq,9,0.00363,236215,95.26335,247960
1218,jsnowacki,9,0.00363,236224,95.26698,247960
1219,kbthu,9,0.00363,236233,95.27061,247960
1220,kevin85421,9,0.00363,236242,95.27424,247960
1221,liuqi,9,0.00363,236251,95.27787,247960
1222,lsuanet,9,0.00363,236260,95.28150,247960
1223,martin-laurent,9,0.00363,236269,95.28513,247960
1224,marziman,9,0.00363,236278,95.28876,247960
1225,mattf,9,0.00363,236287,95.29239,247960
1226,MenglingD,9,0.00363,236296,95.29602,247960
1227,mhbuehler,9,0.00363,236305,95.29965,247960
1228,migueltol22,9,0.00363,236314,95.30327,247960
1229,mike0355,9,0.00363,236323,95.30690,247960
1230,mikwieczorek,9,0.00363,236332,95.31053,247960
1231,Mistobaan,9,0.00363,236341,95.31416,247960
1232,molejnik-mergebit,9,0.00363,236350,95.31779,247960
1233,monkey3199,9,0.00363,236359,95.32142,247960
1234,motilalmeher,9,0.00363,236368,95.32505,247960
1235,mukul-shaunik-nokia,9,0.00363,236377,95.32868,247960
1236,ocherfas,9,0.00363,236386,95.33231,247960
1237,padrian2s,9,0.00363,236395,95.33594,247960
1238,PascalSchroederDE,9,0.00363,236404,95.33957,247960
1239,pavanaiyar,9,0.00363,236413,95.34320,247960
1240,pjo256,9,0.00363,236422,95.34683,247960
1241,prgawade,9,0.00363,236431,95.35046,247960
1242,pshiko,9,0.00363,236440,95.35409,247960
1243,raddaoui,9,0.00363,236449,95.35772,247960
1244,richarddli,9,0.00363,236458,95.36135,247960
1245,rlenferink,9,0.00363,236467,95.36498,247960
1246,rohank07,9,0.00363,236476,95.36861,247960
1247,romanzdk,9,0.00363,236485,95.37224,247960
1248,SachinT95,9,0.00363,236494,95.37587,247960
1249,sammy04,9,0.00363,236503,95.37950,247960
1250,sarjeet2013,9,0.00363,236512,95.38313,247960
1251,sarrourajerbi,9,0.00363,236521,95.38676,247960
1252,sdf611097,9,0.00363,236530,95.39039,247960
1253,shaunc,9,0.00363,236539,95.39402,247960
1254,shuaibiyy,9,0.00363,236548,95.39764,247960
1255,speaknowpotato,9,0.00363,236557,95.40127,247960
1256,statmike,9,0.00363,236566,95.40490,247960
1257,thliang01,9,0.00363,236575,95.40853,247960
1258,tks-ai,9,0.00363,236584,95.41216,247960
1259,TTRh,9,0.00363,236593,95.41579,247960
1260,tuvovan,9,0.00363,236602,95.41942,247960
1261,twittidai,9,0.00363,236611,95.42305,247960
1262,VaishnaviHire,9,0.00363,236620,95.42668,247960
1263,vladislavkoz,9,0.00363,236629,95.43031,247960
1264,wanglj-lanzer,9,0.00363,236638,95.43394,247960
1265,wynn5a,9,0.00363,236647,95.43757,247960
1266,zuowang,9,0.00363,236656,95.44120,247960
1267,814HiManny,8,0.00323,236664,95.44443,247960
1268,AahanSingh,8,0.00323,236672,95.44765,247960
1269,abhiverma1924,8,0.00323,236680,95.45088,247960
1270,alan-krumholz,8,0.00323,236688,95.45411,247960
1271,alexcpn,8,0.00323,236696,95.45733,247960
1272,alishaIBM,8,0.00323,236704,95.46056,247960
1273,andrewferlitsch,8,0.00323,236712,95.46378,247960
1274,areshytko,8,0.00323,236720,95.46701,247960
1275,arshyasharifian,8,0.00323,236728,95.47024,247960
1276,aurorazl,8,0.00323,236736,95.47346,247960
1277,austynherman,8,0.00323,236744,95.47669,247960
1278,aychang95,8,0.00323,236752,95.47992,247960
1279,AymenFJA,8,0.00323,236760,95.48314,247960
1280,BenzhaminKim,8,0.00323,236768,95.48637,247960
1281,bmenn,8,0.00323,236776,95.48960,247960
1282,brentchang,8,0.00323,236784,95.49282,247960
1283,butzist,8,0.00323,236792,95.49605,247960
1284,catalinad90,8,0.00323,236800,95.49927,247960
1285,cbreuel,8,0.00323,236808,95.50250,247960
1286,chenwenjun-github,8,0.00323,236816,95.50573,247960
1287,crauterb,8,0.00323,236824,95.50895,247960
1288,crbl1122,8,0.00323,236832,95.51218,247960
1289,danijar,8,0.00323,236840,95.51541,247960
1290,deepakm-ntnx,8,0.00323,236848,95.51863,247960
1291,EdwinZzy,8,0.00323,236856,95.52186,247960
1292,Eliacus,8,0.00323,236864,95.52508,247960
1293,eminemence,8,0.00323,236872,95.52831,247960
1294,erolco,8,0.00323,236880,95.53154,247960
1295,evalsocket,8,0.00323,236888,95.53476,247960
1296,ezioliao,8,0.00323,236896,95.53799,247960
1297,fbalicchia,8,0.00323,236904,95.54122,247960
1298,fejta,8,0.00323,236912,95.54444,247960
1299,FFede0,8,0.00323,236920,95.54767,247960
1300,Focke-Wulf,8,0.00323,236928,95.55090,247960
1301,gecube,8,0.00323,236936,95.55412,247960
1302,GigliOneiric,8,0.00323,236944,95.55735,247960
1303,Hachimaki,8,0.00323,236952,95.56057,247960
1304,ifuwang,8,0.00323,236960,95.56380,247960
1305,irabanillo91,8,0.00323,236968,95.56703,247960
1306,IreneGi,8,0.00323,236976,95.57025,247960
1307,irhawks,8,0.00323,236984,95.57348,247960
1308,jazka,8,0.00323,236992,95.57671,247960
1309,jhagege,8,0.00323,237000,95.57993,247960
1310,jhua18,8,0.00323,237008,95.58316,247960
1311,jiangkaihua,8,0.00323,237016,95.58638,247960
1312,jimbudarz,8,0.00323,237024,95.58961,247960
1313,jinxingwang,8,0.00323,237032,95.59284,247960
1314,JK-97,8,0.00323,237040,95.59606,247960
1315,jl-massey,8,0.00323,237048,95.59929,247960
1316,jnmclarty,8,0.00323,237056,95.60252,247960
1317,jpza,8,0.00323,237064,95.60574,247960
1318,juliadeclared,8,0.00323,237072,95.60897,247960
1319,k402xxxcenxxx,8,0.00323,237080,95.61220,247960
1320,kdubovikov,8,0.00323,237088,95.61542,247960
1321,khani92,8,0.00323,237096,95.61865,247960
1322,ktsakalozos,8,0.00323,237104,95.62187,247960
1323,Kulikovpavel,8,0.00323,237112,95.62510,247960
1324,l1990790120,8,0.00323,237120,95.62833,247960
1325,Liujingfang1,8,0.00323,237128,95.63155,247960
1326,logicbomb421,8,0.00323,237136,95.63478,247960
1327,lucasaytt,8,0.00323,237144,95.63801,247960
1328,magick93,8,0.00323,237152,95.64123,247960
1329,maorlipchuk,8,0.00323,237160,95.64446,247960
1330,MattSich,8,0.00323,237168,95.64769,247960
1331,MaxGrtz,8,0.00323,237176,95.65091,247960
1332,mcantrell,8,0.00323,237184,95.65414,247960
1333,mgyong,8,0.00323,237192,95.65736,247960
1334,mikel-brostrom,8,0.00323,237200,95.66059,247960
1335,missingcharacter,8,0.00323,237208,95.66382,247960
1336,mjurkus,8,0.00323,237216,95.66704,247960
1337,MnrGreg,8,0.00323,237224,95.67027,247960
1338,mojokb,8,0.00323,237232,95.67350,247960
1339,monoidus,8,0.00323,237240,95.67672,247960
1340,myqq0000,8,0.00323,237248,95.67995,247960
1341,neerfri,8,0.00323,237256,95.68317,247960
1342,NeoKish,8,0.00323,237264,95.68640,247960
1343,nepalineupane,8,0.00323,237272,95.68963,247960
1344,Neytoph,8,0.00323,237280,95.69285,247960
1345,nico-kuzak,8,0.00323,237288,95.69608,247960
1346,nkflash,8,0.00323,237296,95.69931,247960
1347,oxxygenio,8,0.00323,237304,95.70253,247960
1348,pavanky,8,0.00323,237312,95.70576,247960
1349,pconrad-fb,8,0.00323,237320,95.70899,247960
1350,PingYufeng,8,0.00323,237328,95.71221,247960
1351,psheorangithub,8,0.00323,237336,95.71544,247960
1352,pwzhong,8,0.00323,237344,95.71866,247960
1353,Rasen-wq,8,0.00323,237352,95.72189,247960
1354,rbq,8,0.00323,237360,95.72512,247960
1355,sam0996,8,0.00323,237368,95.72834,247960
1356,sasvaritoni,8,0.00323,237376,95.73157,247960
1357,sfabel,8,0.00323,237384,95.73480,247960
1358,shichengsg001,8,0.00323,237392,95.73802,247960
1359,shikajiro,8,0.00323,237400,95.74125,247960
1360,stsukrov,8,0.00323,237408,95.74447,247960
1361,sub-mod,8,0.00323,237416,95.74770,247960
1362,sudeshsh,8,0.00323,237424,95.75093,247960
1363,suigh,8,0.00323,237432,95.75415,247960
1364,suned,8,0.00323,237440,95.75738,247960
1365,suneeta-mall,8,0.00323,237448,95.76061,247960
1366,sunzhaochang,8,0.00323,237456,95.76383,247960
1367,tholop,8,0.00323,237464,95.76706,247960
1368,thomas-mueller,8,0.00323,237472,95.77029,247960
1369,thoraxe,8,0.00323,237480,95.77351,247960
1370,tinuxnet,8,0.00323,237488,95.77674,247960
1371,uniuuu,8,0.00323,237496,95.77996,247960
1372,velascoluis,8,0.00323,237504,95.78319,247960
1373,whiletruelearn,8,0.00323,237512,95.78642,247960
1374,x28646510,8,0.00323,237520,95.78964,247960
1375,xiabo2011,8,0.00323,237528,95.79287,247960
1376,xiaonancc77,8,0.00323,237536,95.79610,247960
1377,xiaoxq,8,0.00323,237544,95.79932,247960
1378,xiaqunfeng,8,0.00323,237552,95.80255,247960
1379,xqqcoder,8,0.00323,237560,95.80578,247960
1380,xRagnorokx,8,0.00323,237568,95.80900,247960
1381,yosit,8,0.00323,237576,95.81223,247960
1382,zamonia500,8,0.00323,237584,95.81545,247960
1383,15162162323,7,0.00282,237591,95.81828,247960
1384,Aditya-171,7,0.00282,237598,95.82110,247960
1385,adityaparamesh,7,0.00282,237605,95.82392,247960
1386,advancedwebdeveloper,7,0.00282,237612,95.82675,247960
1387,agilgur5,7,0.00282,237619,95.82957,247960
1388,Aiden-Jeon,7,0.00282,237626,95.83239,247960
1389,andrea-cola,7,0.00282,237633,95.83522,247960
1390,andreeamun,7,0.00282,237640,95.83804,247960
1391,andresmascl,7,0.00282,237647,95.84086,247960
1392,andrijaperovic,7,0.00282,237654,95.84368,247960
1393,AnnieWei58,7,0.00282,237661,95.84651,247960
1394,azarezade,7,0.00282,237668,95.84933,247960
1395,BAlmeidaS,7,0.00282,237675,95.85215,247960
1396,BioGeek,7,0.00282,237682,95.85498,247960
1397,bryanpaget,7,0.00282,237689,95.85780,247960
1398,caffeinism,7,0.00282,237696,95.86062,247960
1399,Can-Sahin,7,0.00282,237703,95.86345,247960
1400,cchanley2003,7,0.00282,237710,95.86627,247960
1401,celiawa,7,0.00282,237717,95.86909,247960
1402,celinew1221,7,0.00282,237724,95.87191,247960
1403,Corea,7,0.00282,237731,95.87474,247960
1404,crazy-canux,7,0.00282,237738,95.87756,247960
1405,CZYCW,7,0.00282,237745,95.88038,247960
1406,D4Lta,7,0.00282,237752,95.88321,247960
1407,dakoner,7,0.00282,237759,95.88603,247960
1408,dbg-raghulkrishna,7,0.00282,237766,95.88885,247960
1409,desaintmartin,7,0.00282,237773,95.89168,247960
1410,devashishshankar,7,0.00282,237780,95.89450,247960
1411,Dimss,7,0.00282,237787,95.89732,247960
1412,drozzy,7,0.00282,237794,95.90015,247960
1413,EDGsheryl,7,0.00282,237801,95.90297,247960
1414,Edilmo,7,0.00282,237808,95.90579,247960
1415,emenendez,7,0.00282,237815,95.90861,247960
1416,enricomarchesin,7,0.00282,237822,95.91144,247960
1417,ereil,7,0.00282,237829,95.91426,247960
1418,erekgit,7,0.00282,237836,95.91708,247960
1419,eshaingle,7,0.00282,237843,95.91991,247960
1420,FrancisLfg,7,0.00282,237850,95.92273,247960
1421,fvde,7,0.00282,237857,95.92555,247960
1422,galv,7,0.00282,237864,95.92838,247960
1423,GetOn4,7,0.00282,237871,95.93120,247960
1424,goodpp,7,0.00282,237878,95.93402,247960
1425,gpotti,7,0.00282,237885,95.93684,247960
1426,GuoHaiqing,7,0.00282,237892,95.93967,247960
1427,harperjuanl,7,0.00282,237899,95.94249,247960
1428,hassanzadeh,7,0.00282,237906,95.94531,247960
1429,hilliao,7,0.00282,237913,95.94814,247960
1430,hmizuma,7,0.00282,237920,95.95096,247960
1431,houz42,7,0.00282,237927,95.95378,247960
1432,iantowey,7,0.00282,237934,95.95661,247960
1433,imicer,7,0.00282,237941,95.95943,247960
1434,ivanmkc,7,0.00282,237948,95.96225,247960
1435,IvyBazan,7,0.00282,237955,95.96508,247960
1436,Jason-CKY,7,0.00282,237962,95.96790,247960
1437,Jeet-14,7,0.00282,237969,95.97072,247960
1438,jimmy-huang,7,0.00282,237976,95.97354,247960
1439,jimthompson5802,7,0.00282,237983,95.97637,247960
1440,jjf130,7,0.00282,237990,95.97919,247960
1441,joepeskett,7,0.00282,237997,95.98201,247960
1442,jpe316,7,0.00282,238004,95.98484,247960
1443,kbc8894,7,0.00282,238011,95.98766,247960
1444,kruthikakr,7,0.00282,238018,95.99048,247960
1445,kurianbenoy,7,0.00282,238025,95.99331,247960
1446,kvamshi,7,0.00282,238032,95.99613,247960
1447,lanya16,7,0.00282,238039,95.99895,247960
1448,laserK3000,7,0.00282,238046,96.00177,247960
1449,lresende,7,0.00282,238053,96.00460,247960
1450,LRSutton,7,0.00282,238060,96.00742,247960
1451,LuBingtan,7,0.00282,238067,96.01024,247960
1452,LukasBlank,7,0.00282,238074,96.01307,247960
1453,mageirakos,7,0.00282,238081,96.01589,247960
1454,maniappan,7,0.00282,238088,96.01871,247960
1455,mattiasarro,7,0.00282,238095,96.02154,247960
1456,matty-rose,7,0.00282,238102,96.02436,247960
1457,maxdebayser,7,0.00282,238109,96.02718,247960
1458,mChowdhury-91,7,0.00282,238116,96.03000,247960
1459,MISSEY,7,0.00282,238123,96.03283,247960
1460,montenegrodr,7,0.00282,238130,96.03565,247960
1461,mousam-singh,7,0.00282,238137,96.03847,247960
1462,mr-yaky,7,0.00282,238144,96.04130,247960
1463,mvwestendorp,7,0.00282,238151,96.04412,247960
1464,netankit,7,0.00282,238158,96.04694,247960
1465,NettrixTobin,7,0.00282,238165,96.04977,247960
1466,NicholaiStaalung,7,0.00282,238172,96.05259,247960
1467,nielsmeima,7,0.00282,238179,96.05541,247960
1468,Niuxiaotong,7,0.00282,238186,96.05824,247960
1469,nkosteski,7,0.00282,238193,96.06106,247960
1470,oemergenc,7,0.00282,238200,96.06388,247960
1471,OpenZSD,7,0.00282,238207,96.06670,247960
1472,Padarn,7,0.00282,238214,96.06953,247960
1473,person142,7,0.00282,238221,96.07235,247960
1474,razumv,7,0.00282,238228,96.07517,247960
1475,rhc54,7,0.00282,238235,96.07800,247960
1476,rickysage,7,0.00282,238242,96.08082,247960
1477,rodrigocaus,7,0.00282,238249,96.08364,247960
1478,rylynchen,7,0.00282,238256,96.08647,247960
1479,ryo-matsuzaka,7,0.00282,238263,96.08929,247960
1480,sdake,7,0.00282,238270,96.09211,247960
1481,sel,7,0.00282,238277,96.09493,247960
1482,SergeSpinoza,7,0.00282,238284,96.09776,247960
1483,shalankig,7,0.00282,238291,96.10058,247960
1484,shibuiwilliam,7,0.00282,238298,96.10340,247960
1485,shotarohorai,7,0.00282,238305,96.10623,247960
1486,sh-tatsuno,7,0.00282,238312,96.10905,247960
1487,Sim4n6,7,0.00282,238319,96.11187,247960
1488,skgreenstar,7,0.00282,238326,96.11470,247960
1489,sneelz,7,0.00282,238333,96.11752,247960
1490,snirkop89,7,0.00282,238340,96.12034,247960
1491,snowlover173,7,0.00282,238347,96.12317,247960
1492,songkane,7,0.00282,238354,96.12599,247960
1493,squillace,7,0.00282,238361,96.12881,247960
1494,srv-twry,7,0.00282,238368,96.13163,247960
1495,sshuair,7,0.00282,238375,96.13446,247960
1496,stevebanik,7,0.00282,238382,96.13728,247960
1497,subhabratabanerjee,7,0.00282,238389,96.14010,247960
1498,sunilvb,7,0.00282,238396,96.14293,247960
1499,Suozz,7,0.00282,238403,96.14575,247960
1500,talebzeghmi,7,0.00282,238410,96.14857,247960
1501,talhairfanbentley,7,0.00282,238417,96.15140,247960
1502,tbaums,7,0.00282,238424,96.15422,247960
1503,tech348712013870132,7,0.00282,238431,96.15704,247960
1504,theNewFlesh,7,0.00282,238438,96.15986,247960
1505,theophilee,7,0.00282,238445,96.16269,247960
1506,thetko85,7,0.00282,238452,96.16551,247960
1507,titansmc,7,0.00282,238459,96.16833,247960
1508,Toeplitz,7,0.00282,238466,96.17116,247960
1509,tossmilestone,7,0.00282,238473,96.17398,247960
1510,tripti-singhal,7,0.00282,238480,96.17680,247960
1511,ultraji,7,0.00282,238487,96.17963,247960
1512,veliborfrobas,7,0.00282,238494,96.18245,247960
1513,WalterSmuts,7,0.00282,238501,96.18527,247960
1514,WillianFuks,7,0.00282,238508,96.18809,247960
1515,wodecki,7,0.00282,238515,96.19092,247960
1516,XinchenWan,7,0.00282,238522,96.19374,247960
1517,yongwen,7,0.00282,238529,96.19656,247960
1518,yptheangel,7,0.00282,238536,96.19939,247960
1519,zengqingfu1442,7,0.00282,238543,96.20221,247960
1520,zmdelima,7,0.00282,238550,96.20503,247960
1521,zygm0nt,7,0.00282,238557,96.20786,247960
1522,13567436138,6,0.00242,238563,96.21028,247960
1523,AbelThorne,6,0.00242,238569,96.21270,247960
1524,abin-thomas-by,6,0.00242,238575,96.21512,247960
1525,achandras,6,0.00242,238581,96.21754,247960
1526,adriangay,6,0.00242,238587,96.21995,247960
1527,aflc,6,0.00242,238593,96.22237,247960
1528,akiyamasho,6,0.00242,238599,96.22479,247960
1529,aktivalux,6,0.00242,238605,96.22721,247960
1530,alanhdu,6,0.00242,238611,96.22963,247960
1531,alefesta,6,0.00242,238617,96.23205,247960
1532,amalendur,6,0.00242,238623,96.23447,247960
1533,AndrewMcFarren,6,0.00242,238629,96.23689,247960
1534,andyi2it,6,0.00242,238635,96.23931,247960
1535,anishasthana,6,0.00242,238641,96.24173,247960
1536,ardeshir,6,0.00242,238647,96.24415,247960
1537,asahnovskiy-deloitte,6,0.00242,238653,96.24657,247960
1538,ashrafgt,6,0.00242,238659,96.24899,247960
1539,beatgeek,6,0.00242,238665,96.25141,247960
1540,bebe424,6,0.00242,238671,96.25383,247960
1541,biaochen,6,0.00242,238677,96.25625,247960
1542,bobmayuze,6,0.00242,238683,96.25867,247960
1543,boniek83,6,0.00242,238689,96.26109,247960
1544,calvinleungyk,6,0.00242,238695,96.26351,247960
1545,CapKenR,6,0.00242,238701,96.26593,247960
1546,capkurmagati,6,0.00242,238707,96.26835,247960
1547,chaitanyak52,6,0.00242,238713,96.27077,247960
1548,CharlesxrWu,6,0.00242,238719,96.27319,247960
1549,chenwenjun1995,6,0.00242,238725,96.27561,247960
1550,chiefkarlin,6,0.00242,238731,96.27803,247960
1551,chiehpower,6,0.00242,238737,96.28045,247960
1552,clkao,6,0.00242,238743,96.28287,247960
1553,CosyOranges,6,0.00242,238749,96.28529,247960
1554,Crisescode,6,0.00242,238755,96.28771,247960
1555,d123456temp,6,0.00242,238761,96.29013,247960
1556,d34th4ck3r,6,0.00242,238767,96.29255,247960
1557,dale88,6,0.00242,238773,96.29497,247960
1558,deepyaman,6,0.00242,238779,96.29739,247960
1559,defoishugo,6,0.00242,238785,96.29981,247960
1560,denis-angilella,6,0.00242,238791,96.30223,247960
1561,DennisVis,6,0.00242,238797,96.30465,247960
1562,disktnk,6,0.00242,238803,96.30707,247960
1563,DurivetMatthias,6,0.00242,238809,96.30949,247960
1564,eastlunar,6,0.00242,238815,96.31191,247960
1565,EClaydon,6,0.00242,238821,96.31432,247960
1566,edu-ap,6,0.00242,238827,96.31674,247960
1567,EdwardZhang88,6,0.00242,238833,96.31916,247960
1568,ericandrewmeadows,6,0.00242,238839,96.32158,247960
1569,ErikEngerd,6,0.00242,238845,96.32400,247960
1570,etsyamitra,6,0.00242,238851,96.32642,247960
1571,fabianvdW,6,0.00242,238857,96.32884,247960
1572,fedeesku1,6,0.00242,238863,96.33126,247960
1573,ferrgo,6,0.00242,238869,96.33368,247960
1574,FrancisLennon17,6,0.00242,238875,96.33610,247960
1575,fstetic,6,0.00242,238881,96.33852,247960
1576,gachiemchiep,6,0.00242,238887,96.34094,247960
1577,gbin10533,6,0.00242,238893,96.34336,247960
1578,GdMacmillan,6,0.00242,238899,96.34578,247960
1579,gidutz,6,0.00242,238905,96.34820,247960
1580,gitpushdashf,6,0.00242,238911,96.35062,247960
1581,goyalankit,6,0.00242,238917,96.35304,247960
1582,gsunner,6,0.00242,238923,96.35546,247960
1583,halftan,6,0.00242,238929,96.35788,247960
1584,hanpeiyu94,6,0.00242,238935,96.36030,247960
1585,hansaimlim,6,0.00242,238941,96.36272,247960
1586,HelmiGH,6,0.00242,238947,96.36514,247960
1587,hjkkhj123,6,0.00242,238953,96.36756,247960
1588,HumairAK,6,0.00242,238959,96.36998,247960
1589,hustcat,6,0.00242,238965,96.37240,247960
1590,iavinas,6,0.00242,238971,96.37482,247960
1591,ID56,6,0.00242,238977,96.37724,247960
1592,Insullone,6,0.00242,238983,96.37966,247960
1593,iyera,6,0.00242,238989,96.38208,247960
1594,jaffe-fly,6,0.00242,238995,96.38450,247960
1595,jaiganeshp,6,0.00242,239001,96.38692,247960
1596,jdoliner,6,0.00242,239007,96.38934,247960
1597,jerrylam,6,0.00242,239013,96.39176,247960
1598,jielou,6,0.00242,239019,96.39418,247960
1599,jmdinis,6,0.00242,239025,96.39660,247960
1600,JoeyZwicker,6,0.00242,239031,96.39902,247960
1601,johnhoman,6,0.00242,239037,96.40144,247960
1602,jorwalk,6,0.00242,239043,96.40386,247960
1603,JoshZastrow,6,0.00242,239049,96.40628,247960
1604,jotaylo,6,0.00242,239055,96.40869,247960
1605,jtherin,6,0.00242,239061,96.41111,247960
1606,juanvasquezreyes,6,0.00242,239067,96.41353,247960
1607,julioyildo,6,0.00242,239073,96.41595,247960
1608,junhuihuang,6,0.00242,239079,96.41837,247960
1609,jw-websensa,6,0.00242,239085,96.42079,247960
1610,jzfb2,6,0.00242,239091,96.42321,247960
1611,kaivalya97,6,0.00242,239097,96.42563,247960
1612,kaka11chen,6,0.00242,239103,96.42805,247960
1613,kalyc,6,0.00242,239109,96.43047,247960
1614,keeplearnin,6,0.00242,239115,96.43289,247960
1615,keypointt,6,0.00242,239121,96.43531,247960
1616,kidddddddddddddddddddddd,6,0.00242,239127,96.43773,247960
1617,kinglion811,6,0.00242,239133,96.44015,247960
1618,kotalakshman,6,0.00242,239139,96.44257,247960
1619,lakshmanok,6,0.00242,239145,96.44499,247960
1620,LifeArchitect,6,0.00242,239151,96.44741,247960
1621,linpingta,6,0.00242,239157,96.44983,247960
1622,liorshk,6,0.00242,239163,96.45225,247960
1623,liu-sheng,6,0.00242,239169,96.45467,247960
1624,lovishch20,6,0.00242,239175,96.45709,247960
1625,lxl910915,6,0.00242,239181,96.45951,247960
1626,lyschoening,6,0.00242,239187,96.46193,247960
1627,m1pl,6,0.00242,239193,96.46435,247960
1628,madhukarkm,6,0.00242,239199,96.46677,247960
1629,MainRo,6,0.00242,239205,96.46919,247960
1630,marchmallow,6,0.00242,239211,96.47161,247960
1631,markgeejw,6,0.00242,239217,96.47403,247960
1632,matkosoric,6,0.00242,239223,96.47645,247960
1633,mcminis1,6,0.00242,239229,96.47887,247960
1634,meandmymind,6,0.00242,239235,96.48129,247960
1635,MeghanaSrinath,6,0.00242,239241,96.48371,247960
1636,MengYuanTsai,6,0.00242,239247,96.48613,247960
1637,mertkavi,6,0.00242,239253,96.48855,247960
1638,micmarty-deepsense,6,0.00242,239259,96.49097,247960
1639,milkybird98,6,0.00242,239265,96.49339,247960
1640,millerdz,6,0.00242,239271,96.49581,247960
1641,mindprince,6,0.00242,239277,96.49823,247960
1642,MLHafizur,6,0.00242,239283,96.50065,247960
1643,mmuppidi,6,0.00242,239289,96.50307,247960
1644,mshaikh786,6,0.00242,239295,96.50548,247960
1645,mumarniaz,6,0.00242,239301,96.50790,247960
1646,namlh16,6,0.00242,239307,96.51032,247960
1647,nanduri1998,6,0.00242,239313,96.51274,247960
1648,nicklhy,6,0.00242,239319,96.51516,247960
1649,nicokuzak,6,0.00242,239325,96.51758,247960
1650,NightLightTw,6,0.00242,239331,96.52000,247960
1651,nikhilsharma93,6,0.00242,239337,96.52242,247960
1652,nkrish1983,6,0.00242,239343,96.52484,247960
1653,nosmatch,6,0.00242,239349,96.52726,247960
1654,oncekey,6,0.00242,239355,96.52968,247960
1655,oonisim,6,0.00242,239361,96.53210,247960
1656,patrickpoirson,6,0.00242,239367,96.53452,247960
1657,peemblis,6,0.00242,239373,96.53694,247960
1658,PercyLau,6,0.00242,239379,96.53936,247960
1659,phoenixwu0229,6,0.00242,239385,96.54178,247960
1660,prashanthb-ai,6,0.00242,239391,96.54420,247960
1661,Princy-Malhotra,6,0.00242,239397,96.54662,247960
1662,priya170807,6,0.00242,239403,96.54904,247960
1663,pyang-aurora,6,0.00242,239409,96.55146,247960
1664,qifengz,6,0.00242,239415,96.55388,247960
1665,quanguachong,6,0.00242,239421,96.55630,247960
1666,rado-parrak,6,0.00242,239427,96.55872,247960
1667,rajesh-chawla,6,0.00242,239433,96.56114,247960
1668,raravena80,6,0.00242,239439,96.56356,247960
1669,raven-jia,6,0.00242,239445,96.56598,247960
1670,RDarrylR,6,0.00242,239451,96.56840,247960
1671,rileygreen-ncs,6,0.00242,239457,96.57082,247960
1672,Roma110,6,0.00242,239463,96.57324,247960
1673,rrrkharse,6,0.00242,239469,96.57566,247960
1674,saintmalik,6,0.00242,239475,96.57808,247960
1675,saksham93,6,0.00242,239481,96.58050,247960
1676,samuel-sujith,6,0.00242,239487,96.58292,247960
1677,samuelthan,6,0.00242,239493,96.58534,247960
1678,saurabh24292,6,0.00242,239499,96.58776,247960
1679,sbakiu,6,0.00242,239505,96.59018,247960
1680,seoha-kim,6,0.00242,239511,96.59260,247960
1681,sfujiwara,6,0.00242,239517,96.59502,247960
1682,sharmahemlata,6,0.00242,239523,96.59744,247960
1683,shouryaotta,6,0.00242,239529,96.59985,247960
1684,siddharthjain1611,6,0.00242,239535,96.60227,247960
1685,simon-mo,6,0.00242,239541,96.60469,247960
1686,Soot3,6,0.00242,239547,96.60711,247960
1687,spots107,6,0.00242,239553,96.60953,247960
1688,srinjay-paul,6,0.00242,239559,96.61195,247960
1689,stephenhenderson,6,0.00242,239565,96.61437,247960
1690,stomplee,6,0.00242,239571,96.61679,247960
1691,tClelford,6,0.00242,239577,96.61921,247960
1692,tidylobster,6,0.00242,239583,96.62163,247960
1693,tiliter-algorithms,6,0.00242,239589,96.62405,247960
1694,tongtaott,6,0.00242,239595,96.62647,247960
1695,vamshikrishna9999,6,0.00242,239601,96.62889,247960
1696,Ventals,6,0.00242,239607,96.63131,247960
1697,vincentarthur,6,0.00242,239613,96.63373,247960
1698,vkoppisetti-verisk,6,0.00242,239619,96.63615,247960
1699,vlagache,6,0.00242,239625,96.63857,247960
1700,vswami78,6,0.00242,239631,96.64099,247960
1701,wakanapo,6,0.00242,239637,96.64341,247960
1702,wave112,6,0.00242,239643,96.64583,247960
1703,wcass77,6,0.00242,239649,96.64825,247960
1704,WestonLu,6,0.00242,239655,96.65067,247960
1705,wzrdtales,6,0.00242,239661,96.65309,247960
1706,xaoo,6,0.00242,239667,96.65551,247960
1707,xiaoyili,6,0.00242,239673,96.65793,247960
1708,y4roslav,6,0.00242,239679,96.66035,247960
1709,yanqiangmiffy,6,0.00242,239685,96.66277,247960
1710,yarnabrina,6,0.00242,239691,96.66519,247960
1711,yuanbw,6,0.00242,239697,96.66761,247960
1712,zeusro,6,0.00242,239703,96.67003,247960
1713,zhilingc,6,0.00242,239709,96.67245,247960
1714,zimmertr,6,0.00242,239715,96.67487,247960
1715,14sudharsan,5,0.00202,239720,96.67688,247960
1716,482170765,5,0.00202,239725,96.67890,247960
1717,aaltay,5,0.00202,239730,96.68092,247960
1718,Abhi3linku,5,0.00202,239735,96.68293,247960
1719,agemocui,5,0.00202,239740,96.68495,247960
1720,agnz,5,0.00202,239745,96.68697,247960
1721,aichiludan,5,0.00202,239750,96.68898,247960
1722,aisensiy,5,0.00202,239755,96.69100,247960
1723,AkashDharani,5,0.00202,239760,96.69302,247960
1724,akfmdl,5,0.00202,239765,96.69503,247960
1725,akshaydtada,5,0.00202,239770,96.69705,247960
1726,AlecZebrick,5,0.00202,239775,96.69906,247960
1727,AlexanderEkdahl,5,0.00202,239780,96.70108,247960
1728,alimhanif,5,0.00202,239785,96.70310,247960
1729,ali-raza-tariq,5,0.00202,239790,96.70511,247960
1730,Amitg1,5,0.00202,239795,96.70713,247960
1731,amolsr,5,0.00202,239800,96.70915,247960
1732,and-1,5,0.00202,239805,96.71116,247960
1733,Anderssorby,5,0.00202,239810,96.71318,247960
1734,anilreddyv,5,0.00202,239815,96.71520,247960
1735,anineharto,5,0.00202,239820,96.71721,247960
1736,anishjain18,5,0.00202,239825,96.71923,247960
1737,antigenius0910,5,0.00202,239830,96.72125,247960
1738,antimack,5,0.00202,239835,96.72326,247960
1739,AntPeixe,5,0.00202,239840,96.72528,247960
1740,Anujay-Saraf,5,0.00202,239845,96.72729,247960
1741,Anushka30,5,0.00202,239850,96.72931,247960
1742,Aryan-Deshpande,5,0.00202,239855,96.73133,247960
1743,asahnovskiy,5,0.00202,239860,96.73334,247960
1744,AssafKatz3,5,0.00202,239865,96.73536,247960
1745,ayush-1506,5,0.00202,239870,96.73738,247960
1746,backnotprop,5,0.00202,239875,96.73939,247960
1747,bankbiz,5,0.00202,239880,96.74141,247960
1748,BarleyXu,5,0.00202,239885,96.74343,247960
1749,baskaranz,5,0.00202,239890,96.74544,247960
1750,bbhuston,5,0.00202,239895,96.74746,247960
1751,benash,5,0.00202,239900,96.74948,247960
1752,benjaminhuo,5,0.00202,239905,96.75149,247960
1753,benjaminwinokur,5,0.00202,239910,96.75351,247960
1754,bnsblue,5,0.00202,239915,96.75553,247960
1755,BoecquaertJonas,5,0.00202,239920,96.75754,247960
1756,Boes-man,5,0.00202,239925,96.75956,247960
1757,bomerzz,5,0.00202,239930,96.76157,247960
1758,brettkoonce,5,0.00202,239935,96.76359,247960
1759,brsolomon-deloitte,5,0.00202,239940,96.76561,247960
1760,brtasavpatel,5,0.00202,239945,96.76762,247960
1761,bsraya,5,0.00202,239950,96.76964,247960
1762,btphan95,5,0.00202,239955,96.77166,247960
1763,busunkim96,5,0.00202,239960,96.77367,247960
1764,ccrrvvaa,5,0.00202,239965,96.77569,247960
1765,ChenhanXmu,5,0.00202,239970,96.77771,247960
1766,chie8842,5,0.00202,239975,96.77972,247960
1767,chinmaychandak,5,0.00202,239980,96.78174,247960
1768,chirag0002,5,0.00202,239985,96.78376,247960
1769,ChiragGorsia05,5,0.00202,239990,96.78577,247960
1770,condaatje,5,0.00202,239995,96.78779,247960
1771,crispto,5,0.00202,240000,96.78980,247960
1772,csteegz,5,0.00202,240005,96.79182,247960
1773,cyang49,5,0.00202,240010,96.79384,247960
1774,dakl,5,0.00202,240015,96.79585,247960
1775,damitkwr,5,0.00202,240020,96.79787,247960
1776,danielricks,5,0.00202,240025,96.79989,247960
1777,danielsiwiec,5,0.00202,240030,96.80190,247960
1778,danizavtz,5,0.00202,240035,96.80392,247960
1779,darthsuogles,5,0.00202,240040,96.80594,247960
1780,david-thrower,5,0.00202,240045,96.80795,247960
1781,deafdave,5,0.00202,240050,96.80997,247960
1782,deepak2431,5,0.00202,240055,96.81199,247960
1783,deepaknadig,5,0.00202,240060,96.81400,247960
1784,dejangolubovic,5,0.00202,240065,96.81602,247960
1785,denverdino,5,0.00202,240070,96.81804,247960
1786,dfarr,5,0.00202,240075,96.82005,247960
1787,dilip640,5,0.00202,240080,96.82207,247960
1788,dimpavloff,5,0.00202,240085,96.82408,247960
1789,divinerapier,5,0.00202,240090,96.82610,247960
1790,divyadilip91,5,0.00202,240095,96.82812,247960
1791,dmueller2001,5,0.00202,240100,96.83013,247960
1792,drPytho,5,0.00202,240105,96.83215,247960
1793,drubinstein,5,0.00202,240110,96.83417,247960
1794,dsiegel,5,0.00202,240115,96.83618,247960
1795,dthomson25,5,0.00202,240120,96.83820,247960
1796,dwatrous,5,0.00202,240125,96.84022,247960
1797,dweitzman,5,0.00202,240130,96.84223,247960
1798,edlee2121,5,0.00202,240135,96.84425,247960
1799,ElizabethSvit,5,0.00202,240140,96.84627,247960
1800,EsaFazal72,5,0.00202,240145,96.84828,247960
1801,fatimaafridi,5,0.00202,240150,96.85030,247960
1802,femtonelson,5,0.00202,240155,96.85231,247960
1803,fisache,5,0.00202,240160,96.85433,247960
1804,frankyn,5,0.00202,240165,96.85635,247960
1805,frederick0329,5,0.00202,240170,96.85836,247960
1806,frsann,5,0.00202,240175,96.86038,247960
1807,fsaina,5,0.00202,240180,96.86240,247960
1808,gaborvecsei,5,0.00202,240185,96.86441,247960
1809,gabrielecastellano,5,0.00202,240190,96.86643,247960
1810,gcheron,5,0.00202,240195,96.86845,247960
1811,geewynn,5,0.00202,240200,96.87046,247960
1812,gfursin,5,0.00202,240205,96.87248,247960
1813,ggodreau,5,0.00202,240210,96.87450,247960
1814,g-karthik,5,0.00202,240215,96.87651,247960
1815,gmfrasca,5,0.00202,240220,96.87853,247960
1816,goodoid,5,0.00202,240225,96.88055,247960
1817,GraphtyLove,5,0.00202,240230,96.88256,247960
1818,gxfun,5,0.00202,240235,96.88458,247960
1819,harshavardhana,5,0.00202,240240,96.88659,247960
1820,harshit-deepsource,5,0.00202,240245,96.88861,247960
1821,hbrylkowski,5,0.00202,240250,96.89063,247960
1822,heyfey,5,0.00202,240255,96.89264,247960
1823,hholst80,5,0.00202,240260,96.89466,247960
1824,hirokinko,5,0.00202,240265,96.89668,247960
1825,HWiese1980,5,0.00202,240270,96.89869,247960
1826,ianonavy,5,0.00202,240275,96.90071,247960
1827,ice1x,5,0.00202,240280,96.90273,247960
1828,indraforyou,5,0.00202,240285,96.90474,247960
1829,ishantanu,5,0.00202,240290,96.90676,247960
1830,itayvallach,5,0.00202,240295,96.90878,247960
1831,jadechip,5,0.00202,240300,96.91079,247960
1832,JaimeHolland,5,0.00202,240305,96.91281,247960
1833,james426759,5,0.00202,240310,96.91482,247960
1834,jameswnl,5,0.00202,240315,96.91684,247960
1835,janousy,5,0.00202,240320,96.91886,247960
1836,javierdlrm,5,0.00202,240325,96.92087,247960
1837,javyxu,5,0.00202,240330,96.92289,247960
1838,jax79sg,5,0.00202,240335,96.92491,247960
1839,jayaswalayush,5,0.00202,240340,96.92692,247960
1840,Jaydeemourg,5,0.00202,240345,96.92894,247960
1841,jcastagneri,5,0.00202,240350,96.93096,247960
1842,jcatana,5,0.00202,240355,96.93297,247960
1843,jdonnelly-apixio,5,0.00202,240360,96.93499,247960
1844,jfigura,5,0.00202,240365,96.93701,247960
1845,jiaanguo,5,0.00202,240370,96.93902,247960
1846,jinze,5,0.00202,240375,96.94104,247960
1847,jnavarro86,5,0.00202,240380,96.94306,247960
1848,JODIN1727,5,0.00202,240385,96.94507,247960
1849,joeswashington,5,0.00202,240390,96.94709,247960
1850,jonin,5,0.00202,240395,96.94910,247960
1851,jshelman,5,0.00202,240400,96.95112,247960
1852,juandiegopalomino,5,0.00202,240405,96.95314,247960
1853,Jude188,5,0.00202,240410,96.95515,247960
1854,jvendegna,5,0.00202,240415,96.95717,247960
1855,katiesandford,5,0.00202,240420,96.95919,247960
1856,KausthubK,5,0.00202,240425,96.96120,247960
1857,kevinpauli,5,0.00202,240430,96.96322,247960
1858,k-gupta,5,0.00202,240435,96.96524,247960
1859,KikiCS,5,0.00202,240440,96.96725,247960
1860,koalalorenzo,5,0.00202,240445,96.96927,247960
1861,kunallimaye,5,0.00202,240450,96.97129,247960
1862,kunpengprod,5,0.00202,240455,96.97330,247960
1863,kwonmha,5,0.00202,240460,96.97532,247960
1864,lechwolowski,5,0.00202,240465,96.97734,247960
1865,liubog2008,5,0.00202,240470,96.97935,247960
1866,liudonggang,5,0.00202,240475,96.98137,247960
1867,lokesh-sreedhara,5,0.00202,240480,96.98338,247960
1868,lppier,5,0.00202,240485,96.98540,247960
1869,lp-pl,5,0.00202,240490,96.98742,247960
1870,lqdev,5,0.00202,240495,96.98943,247960
1871,Luci1306,5,0.00202,240500,96.99145,247960
1872,lukemarsden,5,0.00202,240505,96.99347,247960
1873,M00nF1sh,5,0.00202,240510,96.99548,247960
1874,Madaditya,5,0.00202,240515,96.99750,247960
1875,marcoleewow,5,0.00202,240520,96.99952,247960
1876,MatthiasVDDooren,5,0.00202,240525,97.00153,247960
1877,mauermbq,5,0.00202,240530,97.00355,247960
1878,mengkai94,5,0.00202,240535,97.00557,247960
1879,michelle192837,5,0.00202,240540,97.00758,247960
1880,miguelangel,5,0.00202,240545,97.00960,247960
1881,Mithil467,5,0.00202,240550,97.01161,247960
1882,MLXQ,5,0.00202,240555,97.01363,247960
1883,moorthy156,5,0.00202,240560,97.01565,247960
1884,mtszkw,5,0.00202,240565,97.01766,247960
1885,muik,5,0.00202,240570,97.01968,247960
1886,MustafaHar,5,0.00202,240575,97.02170,247960
1887,nakamasato,5,0.00202,240580,97.02371,247960
1888,nallagangus,5,0.00202,240585,97.02573,247960
1889,nellaivijay,5,0.00202,240590,97.02775,247960
1890,nithin8702,5,0.00202,240595,97.02976,247960
1891,NSLog0,5,0.00202,240600,97.03178,247960
1892,odellus,5,0.00202,240605,97.03380,247960
1893,ohtaro,5,0.00202,240610,97.03581,247960
1894,orezahc,5,0.00202,240615,97.03783,247960
1895,orugantichetan,5,0.00202,240620,97.03985,247960
1896,patzhang,5,0.00202,240625,97.04186,247960
1897,pbalm,5,0.00202,240630,97.04388,247960
1898,pengyuan,5,0.00202,240635,97.04589,247960
1899,peterhaddad3121,5,0.00202,240640,97.04791,247960
1900,phansoks,5,0.00202,240645,97.04993,247960
1901,pinkavaj,5,0.00202,240650,97.05194,247960
1902,pisymbol,5,0.00202,240655,97.05396,247960
1903,pod3275,5,0.00202,240660,97.05598,247960
1904,PoornimaDevii,5,0.00202,240665,97.05799,247960
1905,pritidesai,5,0.00202,240670,97.06001,247960
1906,pshah16,5,0.00202,240675,97.06203,247960
1907,ptrckbnck,5,0.00202,240680,97.06404,247960
1908,pvellanki,5,0.00202,240685,97.06606,247960
1909,Rabelaiss,5,0.00202,240690,97.06808,247960
1910,radhakrishnang,5,0.00202,240695,97.07009,247960
1911,rajan123456,5,0.00202,240700,97.07211,247960
1912,randombishop,5,0.00202,240705,97.07412,247960
1913,RansSelected,5,0.00202,240710,97.07614,247960
1914,rbo,5,0.00202,240715,97.07816,247960
1915,rcrowe-google,5,0.00202,240720,97.08017,247960
1916,regorsmitz,5,0.00202,240725,97.08219,247960
1917,rllin,5,0.00202,240730,97.08421,247960
1918,rmporsch,5,0.00202,240735,97.08622,247960
1919,robin2008,5,0.00202,240740,97.08824,247960
1920,rverma-nikiai,5,0.00202,240745,97.09026,247960
1921,santiagoolivar2017,5,0.00202,240750,97.09227,247960
1922,scottcantreid,5,0.00202,240755,97.09429,247960
1923,seanswyi,5,0.00202,240760,97.09631,247960
1924,sebastien-prudhomme,5,0.00202,240765,97.09832,247960
1925,Sergiodiaz53,5,0.00202,240770,97.10034,247960
1926,serhio7,5,0.00202,240775,97.10236,247960
1927,shkr,5,0.00202,240780,97.10437,247960
1928,siganakis,5,0.00202,240785,97.10639,247960
1929,silverlining21,5,0.00202,240790,97.10840,247960
1930,snmohan83,5,0.00202,240795,97.11042,247960
1931,snps-jinto,5,0.00202,240800,97.11244,247960
1932,soffieprincess06,5,0.00202,240805,97.11445,247960
1933,Souheil-Yazji,5,0.00202,240810,97.11647,247960
1934,soumochak83,5,0.00202,240815,97.11849,247960
1935,souvik-deepsource,5,0.00202,240820,97.12050,247960
1936,sozercan,5,0.00202,240825,97.12252,247960
1937,Subhraj07,5,0.00202,240830,97.12454,247960
1938,subramaniankarthik,5,0.00202,240835,97.12655,247960
1939,sukumargaonkar,5,0.00202,240840,97.12857,247960
1940,superkjp,5,0.00202,240845,97.13059,247960
1941,tall-josh,5,0.00202,240850,97.13260,247960
1942,tdhite,5,0.00202,240855,97.13462,247960
1943,tgaddair,5,0.00202,240860,97.13663,247960
1944,TheFreaky,5,0.00202,240865,97.13865,247960
1945,theone4ever,5,0.00202,240870,97.14067,247960
1946,toniz,5,0.00202,240875,97.14268,247960
1947,TravRan,5,0.00202,240880,97.14470,247960
1948,tremblerz,5,0.00202,240885,97.14672,247960
1949,TristansCloud,5,0.00202,240890,97.14873,247960
1950,tristan-vt,5,0.00202,240895,97.15075,247960
1951,ValdasK,5,0.00202,240900,97.15277,247960
1952,VasiliShi,5,0.00202,240905,97.15478,247960
1953,vinaynair,5,0.00202,240910,97.15680,247960
1954,vinnysenthil,5,0.00202,240915,97.15882,247960
1955,VishDev12,5,0.00202,240920,97.16083,247960
1956,vkaushik189,5,0.00202,240925,97.16285,247960
1957,v-raja,5,0.00202,240930,97.16487,247960
1958,wangzheyuan,5,0.00202,240935,97.16688,247960
1959,wgliang,5,0.00202,240940,97.16890,247960
1960,wilkensoncode,5,0.00202,240945,97.17091,247960
1961,william-wang,5,0.00202,240950,97.17293,247960
1962,Windrill,5,0.00202,240955,97.17495,247960
1963,Winowang,5,0.00202,240960,97.17696,247960
1964,wooleybugger,5,0.00202,240965,97.17898,247960
1965,xiaoluwwwxiaolu,5,0.00202,240970,97.18100,247960
1966,yahavb,5,0.00202,240975,97.18301,247960
1967,yaliqin,5,0.00202,240980,97.18503,247960
1968,yetone,5,0.00202,240985,97.18705,247960
1969,zoltan-fedor,5,0.00202,240990,97.18906,247960
1970,zpcalan,5,0.00202,240995,97.19108,247960
1971,zyxue,5,0.00202,241000,97.19310,247960
1972,zzunny97,5,0.00202,241005,97.19511,247960
1973,0as1s,4,0.00161,241009,97.19673,247960
1974,0xE282B0,4,0.00161,241013,97.19834,247960
1975,251744647,4,0.00161,241017,97.19995,247960
1976,aakarshg,4,0.00161,241021,97.20156,247960
1977,A-And,4,0.00161,241025,97.20318,247960
1978,aaron-prindle,4,0.00161,241029,97.20479,247960
1979,abhishektiwari,4,0.00161,241033,97.20640,247960
1980,adipola,4,0.00161,241037,97.20802,247960
1981,Aditya-Kashyap,4,0.00161,241041,97.20963,247960
1982,ahmed-menshawy,4,0.00161,241045,97.21124,247960
1983,ai4life,4,0.00161,241049,97.21286,247960
1984,aikidave,4,0.00161,241053,97.21447,247960
1985,ajaypbrt,4,0.00161,241057,97.21608,247960
1986,akrava,4,0.00161,241061,97.21770,247960
1987,aldazero,4,0.00161,241065,97.21931,247960
1988,alexmt,4,0.00161,241069,97.22092,247960
1989,alienxt,4,0.00161,241073,97.22254,247960
1990,alinakuz,4,0.00161,241077,97.22415,247960
1991,AlirezaSadeghi,4,0.00161,241081,97.22576,247960
1992,alison-lim,4,0.00161,241085,97.22738,247960
1993,alvercau,4,0.00161,241089,97.22899,247960
1994,amrragab8080,4,0.00161,241093,97.23060,247960
1995,andaag,4,0.00161,241097,97.23221,247960
1996,andrewlarimer,4,0.00161,241101,97.23383,247960
1997,anisnasir,4,0.00161,241105,97.23544,247960
1998,anjaliagarwal8,4,0.00161,241109,97.23705,247960
1999,Anosh21,4,0.00161,241113,97.23867,247960
2000,apatil4,4,0.00161,241117,97.24028,247960
2001,apatsekin,4,0.00161,241121,97.24189,247960
2002,arjunm183,4,0.00161,241125,97.24351,247960
2003,armandmcqueen,4,0.00161,241129,97.24512,247960
2004,arun-vc,4,0.00161,241133,97.24673,247960
2005,ashujain2,4,0.00161,241137,97.24835,247960
2006,asongent,4,0.00161,241141,97.24996,247960
2007,astirya,4,0.00161,241145,97.25157,247960
2008,AtrisMio,4,0.00161,241149,97.25319,247960
2009,aviklai,4,0.00161,241153,97.25480,247960
2010,ayush7007,4,0.00161,241157,97.25641,247960
2011,bakhtiary,4,0.00161,241161,97.25803,247960
2012,bartlomiej-malecki,4,0.00161,241165,97.25964,247960
2013,batawfic,4,0.00161,241169,97.26125,247960
2014,bbrewington,4,0.00161,241173,97.26286,247960
2015,bhkamath,4,0.00161,241177,97.26448,247960
2016,biggedi,4,0.00161,241181,97.26609,247960
2017,bleachzk,4,0.00161,241185,97.26770,247960
2018,blsaws,4,0.00161,241189,97.26932,247960
2019,bnussbau,4,0.00161,241193,97.27093,247960
2020,BobLiu20,4,0.00161,241197,97.27254,247960
2021,Bowen0729,4,0.00161,241201,97.27416,247960
2022,cai-harry,4,0.00161,241205,97.27577,247960
2023,cakeislife100,4,0.00161,241209,97.27738,247960
2024,caleb-artifact,4,0.00161,241213,97.27900,247960
2025,CameliaBenLaamari,4,0.00161,241217,97.28061,247960
2026,camille-rodriguez,4,0.00161,241221,97.28222,247960
2027,canshiwei,4,0.00161,241225,97.28384,247960
2028,carre140,4,0.00161,241229,97.28545,247960
2029,cgebbe,4,0.00161,241233,97.28706,247960
2030,chansonzhang,4,0.00161,241237,97.28868,247960
2031,chantikummari,4,0.00161,241241,97.29029,247960
2032,charlesparasa,4,0.00161,241245,97.29190,247960
2033,CheaterAdams,4,0.00161,241249,97.29352,247960
2034,chenbodeng719,4,0.00161,241253,97.29513,247960
2035,chessahoekstra,4,0.00161,241257,97.29674,247960
2036,Chris-Paul-Li,4,0.00161,241261,97.29835,247960
2037,chromatices,4,0.00161,241265,97.29997,247960
2038,clj2567,4,0.00161,241269,97.30158,247960
2039,crispindev,4,0.00161,241273,97.30319,247960
2040,damejovanoski,4,0.00161,241277,97.30481,247960
2041,davidleejy,4,0.00161,241281,97.30642,247960
2042,dblate,4,0.00161,241285,97.30803,247960
2043,dchickabasapa,4,0.00161,241289,97.30965,247960
2044,denisl78,4,0.00161,241293,97.31126,247960
2045,devonkinghorn,4,0.00161,241297,97.31287,247960
2046,dformoso,4,0.00161,241301,97.31449,247960
2047,DharmitD,4,0.00161,241305,97.31610,247960
2048,DianaDai,4,0.00161,241309,97.31771,247960
2049,dimm0,4,0.00161,241313,97.31933,247960
2050,dlahlou,4,0.00161,241317,97.32094,247960
2051,DmitriGekhtman,4,0.00161,241321,97.32255,247960
2052,dmsuehir,4,0.00161,241325,97.32417,247960
2053,dnavale,4,0.00161,241329,97.32578,247960
2054,doctapp,4,0.00161,241333,97.32739,247960
2055,DQinYuan,4,0.00161,241337,97.32900,247960
2056,DreamerCather,4,0.00161,241341,97.33062,247960
2057,drewbo,4,0.00161,241345,97.33223,247960
2058,drewylui,4,0.00161,241349,97.33384,247960
2059,dvianello,4,0.00161,241353,97.33546,247960
2060,DvirDukhan,4,0.00161,241357,97.33707,247960
2061,dwang55,4,0.00161,241361,97.33868,247960
2062,dyoung23,4,0.00161,241365,97.34030,247960
2063,eero-t,4,0.00161,241369,97.34191,247960
2064,elgalu,4,0.00161,241373,97.34352,247960
2065,elim19,4,0.00161,241377,97.34514,247960
2066,elrussord1,4,0.00161,241381,97.34675,247960
2067,elyase,4,0.00161,241385,97.34836,247960
2068,erkolson,4,0.00161,241389,97.34998,247960
2069,errordeveloper,4,0.00161,241393,97.35159,247960
2070,eternity1984,4,0.00161,241397,97.35320,247960
2071,evanseabrook,4,0.00161,241401,97.35482,247960
2072,fabboe,4,0.00161,241405,97.35643,247960
2073,fai555,4,0.00161,241409,97.35804,247960
2074,FANG-MING,4,0.00161,241413,97.35965,247960
2075,fhingerl,4,0.00161,241417,97.36127,247960
2076,fighterhit,4,0.00161,241421,97.36288,247960
2077,fondlykip,4,0.00161,241425,97.36449,247960
2078,fulei-9,4,0.00161,241429,97.36611,247960
2079,f-wole,4,0.00161,241433,97.36772,247960
2080,g-angstrom,4,0.00161,241437,97.36933,247960
2081,garlic5566,4,0.00161,241441,97.37095,247960
2082,Gaurang10,4,0.00161,241445,97.37256,247960
2083,gayathry2612,4,0.00161,241449,97.37417,247960
2084,gcampax,4,0.00161,241453,97.37579,247960
2085,George0112,4,0.00161,241457,97.37740,247960
2086,gethinzhang,4,0.00161,241461,97.37901,247960
2087,ggeorgakoudis,4,0.00161,241465,97.38063,247960
2088,Gilbert88,4,0.00161,241469,97.38224,247960
2089,gundeti,4,0.00161,241473,97.38385,247960
2090,Guo-Yunzhe,4,0.00161,241477,97.38547,247960
2091,guoziyi-study,4,0.00161,241481,97.38708,247960
2092,hahchenchen,4,0.00161,241485,97.38869,247960
2093,haksunLee,4,0.00161,241489,97.39030,247960
2094,hanneshapke,4,0.00161,241493,97.39192,247960
2095,haydnkeung,4,0.00161,241497,97.39353,247960
2096,hebo-yang,4,0.00161,241501,97.39514,247960
2097,hellodk,4,0.00161,241505,97.39676,247960
2098,helloericsf,4,0.00161,241509,97.39837,247960
2099,hieuhc,4,0.00161,241513,97.39998,247960
2100,hopper-signifyd,4,0.00161,241517,97.40160,247960
2101,HP-Nunes,4,0.00161,241521,97.40321,247960
2102,hrsma2i,4,0.00161,241525,97.40482,247960
2103,huanghy95,4,0.00161,241529,97.40644,247960
2104,Huang-Wei,4,0.00161,241533,97.40805,247960
2105,husamaf,4,0.00161,241537,97.40966,247960
2106,ibrahimhaddad,4,0.00161,241541,97.41128,247960
2107,illeatmyhat,4,0.00161,241545,97.41289,247960
2108,ionicsolutions,4,0.00161,241549,97.41450,247960
2109,iptizer,4,0.00161,241553,97.41612,247960
2110,ispmarin,4,0.00161,241557,97.41773,247960
2111,ja06200,4,0.00161,241561,97.41934,247960
2112,jageshmaharjan,4,0.00161,241565,97.42095,247960
2113,jamborta,4,0.00161,241569,97.42257,247960
2114,japan4415,4,0.00161,241573,97.42418,247960
2115,Jboulery,4,0.00161,241577,97.42579,247960
2116,jceb,4,0.00161,241581,97.42741,247960
2117,jdalbosc-cisco,4,0.00161,241585,97.42902,247960
2118,jdelfino,4,0.00161,241589,97.43063,247960
2119,jerryjin2018,4,0.00161,241593,97.43225,247960
2120,jiaozhentian,4,0.00161,241597,97.43386,247960
2121,jiasenwu,4,0.00161,241601,97.43547,247960
2122,jiayingz,4,0.00161,241605,97.43709,247960
2123,jinzhejz,4,0.00161,241609,97.43870,247960
2124,JishinJames,4,0.00161,241613,97.44031,247960
2125,jkim711,4,0.00161,241617,97.44193,247960
2126,jnatale11,4,0.00161,241621,97.44354,247960
2127,johanfleury,4,0.00161,241625,97.44515,247960
2128,JohnRobinv,4,0.00161,241629,97.44677,247960
2129,jomenxiao,4,0.00161,241633,97.44838,247960
2130,jonasboecquaert,4,0.00161,241637,97.44999,247960
2131,josefkorbel,4,0.00161,241641,97.45161,247960
2132,JuanmaBM,4,0.00161,241645,97.45322,247960
2133,juansebashr,4,0.00161,241649,97.45483,247960
2134,justrohan,4,0.00161,241653,97.45644,247960
2135,kalakandi,4,0.00161,241657,97.45806,247960
2136,KamalAman,4,0.00161,241661,97.45967,247960
2137,karanveersingh5623,4,0.00161,241665,97.46128,247960
2138,kerthcet,4,0.00161,241669,97.46290,247960
2139,kevinbazira,4,0.00161,241673,97.46451,247960
2140,kimuson,4,0.00161,241677,97.46612,247960
2141,KineticCookie,4,0.00161,241681,97.46774,247960
2142,kmrshntr,4,0.00161,241685,97.46935,247960
2143,knabben,4,0.00161,241689,97.47096,247960
2144,Kokkini,4,0.00161,241693,97.47258,247960
2145,kolasanichaitanya,4,0.00161,241697,97.47419,247960
2146,komalkotha,4,0.00161,241701,97.47580,247960
2147,konradmalik,4,0.00161,241705,97.47742,247960
2148,kpulipati,4,0.00161,241709,97.47903,247960
2149,krazyhaas,4,0.00161,241713,97.48064,247960
2150,kris-nova,4,0.00161,241717,97.48226,247960
2151,Kriyszig,4,0.00161,241721,97.48387,247960
2152,kschroed,4,0.00161,241725,97.48548,247960
2153,kumare3,4,0.00161,241729,97.48709,247960
2154,kxiao-fn,4,0.00161,241733,97.48871,247960
2155,langhuansanren,4,0.00161,241737,97.49032,247960
2156,larrytin,4,0.00161,241741,97.49193,247960
2157,learning-automation,4,0.00161,241745,97.49355,247960
2158,leeadh,4,0.00161,241749,97.49516,247960
2159,leetdavid,4,0.00161,241753,97.49677,247960
2160,lightning-like,4,0.00161,241757,97.49839,247960
2161,longpi1,4,0.00161,241761,97.50000,247960
2162,luisquintanilla,4,0.00161,241765,97.50161,247960
2163,lzuwei,4,0.00161,241769,97.50323,247960
2164,ma2331550908,4,0.00161,241773,97.50484,247960
2165,mahsanaru,4,0.00161,241777,97.50645,247960
2166,malawskim,4,0.00161,241781,97.50807,247960
2167,manasjain0699,4,0.00161,241785,97.50968,247960
2168,marcelorum,4,0.00161,241789,97.51129,247960
2169,MarcinHawryluk,4,0.00161,241793,97.51291,247960
2170,marcinkosztolowicz,4,0.00161,241797,97.51452,247960
2171,MarcSkovMadsen,4,0.00161,241801,97.51613,247960
2172,markmirch,4,0.00161,241805,97.51774,247960
2173,masroorhasan,4,0.00161,241809,97.51936,247960
2174,mathematiguy,4,0.00161,241813,97.52097,247960
2175,MatthiasHertel,4,0.00161,241817,97.52258,247960
2176,mavencode01,4,0.00161,241821,97.52420,247960
2177,Mayank12022,4,0.00161,241825,97.52581,247960
2178,mbelton37,4,0.00161,241829,97.52742,247960
2179,Mddct,4,0.00161,241833,97.52904,247960
2180,md-shabbir,4,0.00161,241837,97.53065,247960
2181,menardorama,4,0.00161,241841,97.53226,247960
2182,mereldawu,4,0.00161,241845,97.53388,247960
2183,metaphor,4,0.00161,241849,97.53549,247960
2184,mf-giwoong-lee,4,0.00161,241853,97.53710,247960
2185,michaelwsherman,4,0.00161,241857,97.53872,247960
2186,michalbrys,4,0.00161,241861,97.54033,247960
2187,millerhooks,4,0.00161,241865,97.54194,247960
2188,minhwan-rocks,4,0.00161,241869,97.54356,247960
2189,mkbahk,4,0.00161,241873,97.54517,247960
2190,MLnick,4,0.00161,241877,97.54678,247960
2191,mnmainguy,4,0.00161,241881,97.54839,247960
2192,MostafaGazar,4,0.00161,241885,97.55001,247960
2193,mosyang,4,0.00161,241889,97.55162,247960
2194,Mrreboot7,4,0.00161,241893,97.55323,247960
2195,mstopa,4,0.00161,241897,97.55485,247960
2196,msvensson222,4,0.00161,241901,97.55646,247960
2197,mukulp,4,0.00161,241905,97.55807,247960
2198,munendrasn,4,0.00161,241909,97.55969,247960
2199,munnerz,4,0.00161,241913,97.56130,247960
2200,mustafaghaliUnity,4,0.00161,241917,97.56291,247960
2201,naveen24691,4,0.00161,241921,97.56453,247960
2202,nickchase,4,0.00161,241925,97.56614,247960
2203,nicksettje,4,0.00161,241929,97.56775,247960
2204,nidhidamodaran,4,0.00161,241933,97.56937,247960
2205,nirsagi,4,0.00161,241937,97.57098,247960
2206,N-Kingsley,4,0.00161,241941,97.57259,247960
2207,nkpng2k,4,0.00161,241945,97.57421,247960
2208,nksma,4,0.00161,241949,97.57582,247960
2209,nkumar15,4,0.00161,241953,97.57743,247960
2210,NourhanKhaled,4,0.00161,241957,97.57905,247960
2211,nsriram13,4,0.00161,241961,97.58066,247960
2212,onurgu,4,0.00161,241965,97.58227,247960
2213,oshev,4,0.00161,241969,97.58388,247960
2214,paipaoso,4,0.00161,241973,97.58550,247960
2215,paravatha,4,0.00161,241977,97.58711,247960
2216,patricia92fa,4,0.00161,241981,97.58872,247960
2217,PatrickKhouryGhosn,4,0.00161,241985,97.59034,247960
2218,pdcoded,4,0.00161,241989,97.59195,247960
2219,pedrovgp,4,0.00161,241993,97.59356,247960
2220,perlinger,4,0.00161,241997,97.59518,247960
2221,persistman,4,0.00161,242001,97.59679,247960
2222,pffijt,4,0.00161,242005,97.59840,247960
2223,pigbrain,4,0.00161,242009,97.60002,247960
2224,pkasson,4,0.00161,242013,97.60163,247960
2225,plombardi89,4,0.00161,242017,97.60324,247960
2226,pretendhigh,4,0.00161,242021,97.60486,247960
2227,pxu20,4,0.00161,242025,97.60647,247960
2228,PyoJunCode,4,0.00161,242029,97.60808,247960
2229,pythagoras1357,4,0.00161,242033,97.60970,247960
2230,rachitchauhan43,4,0.00161,242037,97.61131,247960
2231,Rajneesh-Tiwari,4,0.00161,242041,97.61292,247960
2232,randmind,4,0.00161,242045,97.61453,247960
2233,raphaelauv,4,0.00161,242049,97.61615,247960
2234,rc-zhang,4,0.00161,242053,97.61776,247960
2235,rganeshsharma,4,0.00161,242057,97.61937,247960
2236,Roman-Ka,4,0.00161,242061,97.62099,247960
2237,rtroutinz,4,0.00161,242065,97.62260,247960
2238,RustamGimadiev,4,0.00161,242069,97.62421,247960
2239,ryangrahamnc,4,0.00161,242073,97.62583,247960
2240,sahilkhanna129,4,0.00161,242077,97.62744,247960
2241,SaintBacchus,4,0.00161,242081,97.62905,247960
2242,saintnoah,4,0.00161,242085,97.63067,247960
2243,sandeep-krishnamurthy,4,0.00161,242089,97.63228,247960
2244,Saul-R,4,0.00161,242093,97.63389,247960
2245,saurovn,4,0.00161,242097,97.63551,247960
2246,sebastianohl,4,0.00161,242101,97.63712,247960
2247,SebastianScherer88,4,0.00161,242105,97.63873,247960
2248,sebgoa,4,0.00161,242109,97.64035,247960
2249,sebnyberg,4,0.00161,242113,97.64196,247960
2250,seger48,4,0.00161,242117,97.64357,247960
2251,senthilsivanath,4,0.00161,242121,97.64518,247960
2252,sevensees,4,0.00161,242125,97.64680,247960
2253,shantanuVerma7,4,0.00161,242129,97.64841,247960
2254,SharpEdgeMarshall,4,0.00161,242133,97.65002,247960
2255,sheep94lion,4,0.00161,242137,97.65164,247960
2256,shimdude,4,0.00161,242141,97.65325,247960
2257,shintaro-uchiyama,4,0.00161,242145,97.65486,247960
2258,shuaiyy,4,0.00161,242149,97.65648,247960
2259,ShyamSubramanian,4,0.00161,242153,97.65809,247960
2260,sidray7965,4,0.00161,242157,97.65970,247960
2261,simanadler,4,0.00161,242161,97.66132,247960
2262,sk1395,4,0.00161,242165,97.66293,247960
2263,skrawn,4,0.00161,242169,97.66454,247960
2264,slitery1234,4,0.00161,242173,97.66616,247960
2265,sngahane,4,0.00161,242177,97.66777,247960
2266,sradc,4,0.00161,242181,97.66938,247960
2267,srinandan,4,0.00161,242185,97.67100,247960
2268,srujanattunuri,4,0.00161,242189,97.67261,247960
2269,ssdst,4,0.00161,242193,97.67422,247960
2270,staugust,4,0.00161,242197,97.67583,247960
2271,Sterls,4,0.00161,242201,97.67745,247960
2272,StevenReitsma,4,0.00161,242205,97.67906,247960
2273,sublimotion,4,0.00161,242209,97.68067,247960
2274,suensummit,4,0.00161,242213,97.68229,247960
2275,suibinz,4,0.00161,242217,97.68390,247960
2276,swapnilogale,4,0.00161,242221,97.68551,247960
2277,taivokasper,4,0.00161,242225,97.68713,247960
2278,Tauranis,4,0.00161,242229,97.68874,247960
2279,temporafugiunt,4,0.00161,242233,97.69035,247960
2280,texdade,4,0.00161,242237,97.69197,247960
2281,thavlik,4,0.00161,242241,97.69358,247960
2282,themowski,4,0.00161,242245,97.69519,247960
2283,thlevy,4,0.00161,242249,97.69681,247960
2284,tianhaoz95,4,0.00161,242253,97.69842,247960
2285,timbuktuu,4,0.00161,242257,97.70003,247960
2286,tkislan,4,0.00161,242261,97.70165,247960
2287,tobegit3hub,4,0.00161,242265,97.70326,247960
2288,ToddMorrill,4,0.00161,242269,97.70487,247960
2289,TomasPihrt,4,0.00161,242273,97.70648,247960
2290,tonanhngo,4,0.00161,242277,97.70810,247960
2291,toyama0919,4,0.00161,242281,97.70971,247960
2292,trog-levrai,4,0.00161,242285,97.71132,247960
2293,tszumowski,4,0.00161,242289,97.71294,247960
2294,tyrsius,4,0.00161,242293,97.71455,247960
2295,unclerayray,4,0.00161,242297,97.71616,247960
2296,unexpectedpanda,4,0.00161,242301,97.71778,247960
2297,ustcyue,4,0.00161,242305,97.71939,247960
2298,uzuku,4,0.00161,242309,97.72100,247960
2299,vamshi-rvk,4,0.00161,242313,97.72262,247960
2300,vanillakola,4,0.00161,242317,97.72423,247960
2301,venkateshreddy1388,4,0.00161,242321,97.72584,247960
2302,vgarba2,4,0.00161,242325,97.72746,247960
2303,VibratingPig,4,0.00161,242329,97.72907,247960
2304,vicmeng,4,0.00161,242333,97.73068,247960
2305,victpf,4,0.00161,242337,97.73230,247960
2306,vigosser,4,0.00161,242341,97.73391,247960
2307,vinayjain15,4,0.00161,242345,97.73552,247960
2308,VincentDu2021,4,0.00161,242349,97.73714,247960
2309,vineetbadola,4,0.00161,242353,97.73875,247960
2310,vishal-kr-yadav,4,0.00161,242357,97.74036,247960
2311,wang-mask,4,0.00161,242361,97.74197,247960
2312,wywywy01,4,0.00161,242365,97.74359,247960
2313,xin-hao-awx,4,0.00161,242369,97.74520,247960
2314,xinzhangcmu,4,0.00161,242373,97.74681,247960
2315,yajunwong,4,0.00161,242377,97.74843,247960
2316,Yaoda77,4,0.00161,242381,97.75004,247960
2317,yarcyarc,4,0.00161,242385,97.75165,247960
2318,yarongol,4,0.00161,242389,97.75327,247960
2319,ycfnana,4,0.00161,242393,97.75488,247960
2320,yeahydq,4,0.00161,242397,97.75649,247960
2321,yncxcw,4,0.00161,242401,97.75811,247960
2322,ypitrey,4,0.00161,242405,97.75972,247960
2323,zachomedia,4,0.00161,242409,97.76133,247960
2324,zheddie,4,0.00161,242413,97.76295,247960
2325,zhitaoli,4,0.00161,242417,97.76456,247960
2326,zulissi,4,0.00161,242421,97.76617,247960
2327,zwqjoy,4,0.00161,242425,97.76779,247960
2328,11fenil11,3,0.00121,242428,97.76899,247960
2329,64J0,3,0.00121,242431,97.77020,247960
2330,abbyearnin,3,0.00121,242434,97.77141,247960
2331,abe-hpe,3,0.00121,242437,97.77262,247960
2332,aborilov,3,0.00121,242440,97.77383,247960
2333,aburns7,3,0.00121,242443,97.77504,247960
2334,adamjablonowski,3,0.00121,242446,97.77625,247960
2335,Adithimurthi,3,0.00121,242449,97.77746,247960
2336,adrian-plutoflume,3,0.00121,242452,97.77867,247960
2337,AhmedGrati,3,0.00121,242455,97.77988,247960
2338,ahmet-uyar,3,0.00121,242458,97.78109,247960
2339,AigizK,3,0.00121,242461,97.78230,247960
2340,ajayakumar-jayaraj,3,0.00121,242464,97.78351,247960
2341,AjayZinngg,3,0.00121,242467,97.78472,247960
2342,ajithkumar6,3,0.00121,242470,97.78593,247960
2343,AkihiroSuda,3,0.00121,242473,97.78714,247960
2344,ak-tanak,3,0.00121,242476,97.78835,247960
2345,AlbertCintas,3,0.00121,242479,97.78956,247960
2346,aleksandra-sp,3,0.00121,242482,97.79077,247960
2347,alessandroferrari,3,0.00121,242485,97.79198,247960
2348,alexbarta,3,0.00121,242488,97.79319,247960
2349,ali8zake,3,0.00121,242491,97.79440,247960
2350,alzindiq,3,0.00121,242494,97.79561,247960
2351,AmberCheng,3,0.00121,242497,97.79682,247960
2352,amirhessam88,3,0.00121,242500,97.79803,247960
2353,amitbhadra,3,0.00121,242503,97.79924,247960
2354,amitchatbd,3,0.00121,242506,97.80045,247960
2355,amq,3,0.00121,242509,97.80166,247960
2356,Amrit-Mann,3,0.00121,242512,97.80287,247960
2357,amyxst,3,0.00121,242515,97.80408,247960
2358,Anamika28,3,0.00121,242518,97.80529,247960
2359,andrewspiers,3,0.00121,242521,97.80650,247960
2360,AndreyRomanchev,3,0.00121,242524,97.80771,247960
2361,anj-s,3,0.00121,242527,97.80892,247960
2362,ankur47,3,0.00121,242530,97.81013,247960
2363,antshuwen,3,0.00121,242533,97.81134,247960
2364,apulache,3,0.00121,242536,97.81255,247960
2365,argunasekhar,3,0.00121,242539,97.81376,247960
2366,arianyambao,3,0.00121,242542,97.81497,247960
2367,aritar,3,0.00121,242545,97.81618,247960
2368,aronla,3,0.00121,242548,97.81739,247960
2369,ArVar,3,0.00121,242551,97.81860,247960
2370,AshokKuramdasu,3,0.00121,242554,97.81981,247960
2371,aslisabanci,3,0.00121,242557,97.82102,247960
2372,asojoabiola,3,0.00121,242560,97.82223,247960
2373,asok-mirror,3,0.00121,242563,97.82344,247960
2374,augustovictor,3,0.00121,242566,97.82465,247960
2375,avarf,3,0.00121,242569,97.82586,247960
2376,aVideogamer,3,0.00121,242572,97.82707,247960
2377,avolution,3,0.00121,242575,97.82828,247960
2378,awittzb,3,0.00121,242578,97.82949,247960
2379,ayman107,3,0.00121,242581,97.83070,247960
2380,azadehatfxtl,3,0.00121,242584,97.83191,247960
2381,banbanandroid,3,0.00121,242587,97.83312,247960
2382,Bartket,3,0.00121,242590,97.83433,247960
2383,bbarn3y,3,0.00121,242593,97.83554,247960
2384,beliaev-maksim,3,0.00121,242596,97.83675,247960
2385,benbrandt,3,0.00121,242599,97.83796,247960
2386,BenoitLeguay,3,0.00121,242602,97.83917,247960
2387,ben-omji,3,0.00121,242605,97.84038,247960
2388,benswinney,3,0.00121,242608,97.84159,247960
2389,bharath0208,3,0.00121,242611,97.84280,247960
2390,bharaththiruveedula,3,0.00121,242614,97.84401,247960
2391,Bhavesh-Joshi,3,0.00121,242617,97.84522,247960
2392,binblee,3,0.00121,242620,97.84643,247960
2393,bobcatfish,3,0.00121,242623,97.84764,247960
2394,bobuel,3,0.00121,242626,97.84885,247960
2395,bodak,3,0.00121,242629,97.85006,247960
2396,bonacciog,3,0.00121,242632,97.85127,247960
2397,BorFour,3,0.00121,242635,97.85248,247960
2398,BrainLogic,3,0.00121,242638,97.85369,247960
2399,Brajen259,3,0.00121,242641,97.85490,247960
2400,bravo325806,3,0.00121,242644,97.85611,247960
2401,BrentDorsey,3,0.00121,242647,97.85732,247960
2402,bretttully,3,0.00121,242650,97.85853,247960
2403,browningjp,3,0.00121,242653,97.85974,247960
2404,brtknr,3,0.00121,242656,97.86095,247960
2405,brucechin,3,0.00121,242659,97.86216,247960
2406,bryanl,3,0.00121,242662,97.86337,247960
2407,brychcy,3,0.00121,242665,97.86457,247960
2408,bsamadi,3,0.00121,242668,97.86578,247960
2409,busycalibrating,3,0.00121,242671,97.86699,247960
2410,cah4444,3,0.00121,242674,97.86820,247960
2411,capoolebugchat,3,0.00121,242677,97.86941,247960
2412,caren-guo,3,0.00121,242680,97.87062,247960
2413,carlthome,3,0.00121,242683,97.87183,247960
2414,cblackd7r,3,0.00121,242686,97.87304,247960
2415,CBrucePerkins,3,0.00121,242689,97.87425,247960
2416,cbscientist,3,0.00121,242692,97.87546,247960
2417,cc4i,3,0.00121,242695,97.87667,247960
2418,ccll,3,0.00121,242698,97.87788,247960
2419,ccurro,3,0.00121,242701,97.87909,247960
2420,cejj,3,0.00121,242704,97.88030,247960
2421,chanwit,3,0.00121,242707,97.88151,247960
2422,chaosxeras,3,0.00121,242710,97.88272,247960
2423,chelarua,3,0.00121,242713,97.88393,247960
2424,chengmengli06,3,0.00121,242716,97.88514,247960
2425,chintha-v,3,0.00121,242719,97.88635,247960
2426,chiragjn,3,0.00121,242722,97.88756,247960
2427,chxk,3,0.00121,242725,97.88877,247960
2428,CJZheng91,3,0.00121,242728,97.88998,247960
2429,ClaudioDavi,3,0.00121,242731,97.89119,247960
2430,cloudw,3,0.00121,242734,97.89240,247960
2431,cmhokej,3,0.00121,242737,97.89361,247960
2432,CoderHam,3,0.00121,242740,97.89482,247960
2433,cody-yancey,3,0.00121,242743,97.89603,247960
2434,ColinCampbell-GBI,3,0.00121,242746,97.89724,247960
2435,ConnorBarnhill,3,0.00121,242749,97.89845,247960
2436,cp2587,3,0.00121,242752,97.89966,247960
2437,cpedrinaci,3,0.00121,242755,97.90087,247960
2438,croesuslab,3,0.00121,242758,97.90208,247960
2439,ctrahey,3,0.00121,242761,97.90329,247960
2440,danicat,3,0.00121,242764,97.90450,247960
2441,daniel-beyond,3,0.00121,242767,97.90571,247960
2442,DanieleBaranzini,3,0.00121,242770,97.90692,247960
2443,DanielLund,3,0.00121,242773,97.90813,247960
2444,danielschulz,3,0.00121,242776,97.90934,247960
2445,dannydk6,3,0.00121,242779,97.91055,247960
2446,dan-slinky-ckpd,3,0.00121,242782,97.91176,247960
2447,dari-o,3,0.00121,242785,97.91297,247960
2448,dboc,3,0.00121,242788,97.91418,247960
2449,dctelus,3,0.00121,242791,97.91539,247960
2450,dcyoung,3,0.00121,242794,97.91660,247960
2451,deepanker13,3,0.00121,242797,97.91781,247960
2452,deeptikorwar,3,0.00121,242800,97.91902,247960
2453,dennis1du,3,0.00121,242803,97.92023,247960
2454,destornillador,3,0.00121,242806,97.92144,247960
2455,dfm871002,3,0.00121,242809,97.92265,247960
2456,diegodgs,3,0.00121,242812,97.92386,247960
2457,diegok-unity,3,0.00121,242815,97.92507,247960
2458,DineshkumarElumalai,3,0.00121,242818,97.92628,247960
2459,dizcology,3,0.00121,242821,97.92749,247960
2460,djwhatle,3,0.00121,242824,97.92870,247960
2461,dkozlov,3,0.00121,242827,97.92991,247960
2462,dogopupper,3,0.00121,242830,97.93112,247960
2463,Don12138,3,0.00121,242833,97.93233,247960
2464,DonggeunYu,3,0.00121,242836,97.93354,247960
2465,Dottorepoloni,3,0.00121,242839,97.93475,247960
2466,dpoulopoulos,3,0.00121,242842,97.93596,247960
2467,Dravigon,3,0.00121,242845,97.93717,247960
2468,drawesomenic,3,0.00121,242848,97.93838,247960
2469,duchy,3,0.00121,242851,97.93959,247960
2470,dynamicwebpaige,3,0.00121,242854,97.94080,247960
2471,eCeleritas,3,0.00121,242857,97.94201,247960
2472,Edward-liang,3,0.00121,242860,97.94322,247960
2473,Edwardsleo,3,0.00121,242863,97.94443,247960
2474,elcombato,3,0.00121,242866,97.94564,247960
2475,elenimou,3,0.00121,242869,97.94685,247960
2476,eliastsironis,3,0.00121,242872,97.94806,247960
2477,elibixby,3,0.00121,242875,97.94927,247960
2478,ElnazBigdeli,3,0.00121,242878,97.95048,247960
2479,Enzo90910,3,0.00121,242881,97.95169,247960
2480,erhwenkuo,3,0.00121,242884,97.95290,247960
2481,Eros11on,3,0.00121,242887,97.95411,247960
2482,ErraticO,3,0.00121,242890,97.95532,247960
2483,esha-ingle-mpf,3,0.00121,242893,97.95653,247960
2484,ettiee,3,0.00121,242896,97.95774,247960
2485,EUCHI1996,3,0.00121,242899,97.95894,247960
2486,eundonglee,3,0.00121,242902,97.96015,247960
2487,EvanFabry,3,0.00121,242905,97.96136,247960
2488,eyalcha,3,0.00121,242908,97.96257,247960
2489,fakeskimo,3,0.00121,242911,97.96378,247960
2490,filintod,3,0.00121,242914,97.96499,247960
2491,Fkawala,3,0.00121,242917,97.96620,247960
2492,florian-koenig,3,0.00121,242920,97.96741,247960
2493,frankmanbb,3,0.00121,242923,97.96862,247960
2494,frankzhao,3,0.00121,242926,97.96983,247960
2495,fuhuifang,3,0.00121,242929,97.97104,247960
2496,gehring,3,0.00121,242932,97.97225,247960
2497,genome21,3,0.00121,242935,97.97346,247960
2498,georgetree,3,0.00121,242938,97.97467,247960
2499,gettheguru,3,0.00121,242941,97.97588,247960
2500,gigi-at-zymergen,3,0.00121,242944,97.97709,247960
2501,gindeleo,3,0.00121,242947,97.97830,247960
2502,gnovack,3,0.00121,242950,97.97951,247960
2503,goat023,3,0.00121,242953,97.98072,247960
2504,gogeof,3,0.00121,242956,97.98193,247960
2505,gokuatkai,3,0.00121,242959,97.98314,247960
2506,gomrinal,3,0.00121,242962,97.98435,247960
2507,gongcan1219,3,0.00121,242965,97.98556,247960
2508,GoodJoey,3,0.00121,242968,97.98677,247960
2509,goodluckbot,3,0.00121,242971,97.98798,247960
2510,gopitk,3,0.00121,242974,97.98919,247960
2511,gordonsilvera,3,0.00121,242977,97.99040,247960
2512,Gorosia,3,0.00121,242980,97.99161,247960
2513,govindsinghnegi,3,0.00121,242983,97.99282,247960
2514,gprashanthkumar,3,0.00121,242986,97.99403,247960
2515,grehce,3,0.00121,242989,97.99524,247960
2516,grischa,3,0.00121,242992,97.99645,247960
2517,gtoonstra,3,0.00121,242995,97.99766,247960
2518,GT-ZhangAcer,3,0.00121,242998,97.99887,247960
2519,gudipudipradeep,3,0.00121,243001,98.00008,247960
2520,gugumituo,3,0.00121,243004,98.00129,247960
2521,guimou,3,0.00121,243007,98.00250,247960
2522,gxin0426,3,0.00121,243010,98.00371,247960
2523,hainp,3,0.00121,243013,98.00492,247960
2524,halayudha,3,0.00121,243016,98.00613,247960
2525,haoxinst,3,0.00121,243019,98.00734,247960
2526,HaozhengAN,3,0.00121,243022,98.00855,247960
2527,harshsaini,3,0.00121,243025,98.00976,247960
2528,harshvladha,3,0.00121,243028,98.01097,247960
2529,harupy,3,0.00121,243031,98.01218,247960
2530,hecheng64,3,0.00121,243034,98.01339,247960
2531,Heena-PyCloud,3,0.00121,243037,98.01460,247960
2532,Helvind,3,0.00121,243040,98.01581,247960
2533,HenrryVargas,3,0.00121,243043,98.01702,247960
2534,Henry-Kim-Youngwoo,3,0.00121,243046,98.01823,247960
2535,hepwori,3,0.00121,243049,98.01944,247960
2536,hightoxicity,3,0.00121,243052,98.02065,247960
2537,hongjunGu2019,3,0.00121,243055,98.02186,247960
2538,huan11,3,0.00121,243058,98.02307,247960
2539,hunhoon21,3,0.00121,243061,98.02428,247960
2540,hwdef,3,0.00121,243064,98.02549,247960
2541,hykych,3,0.00121,243067,98.02670,247960
2542,hyzhak,3,0.00121,243070,98.02791,247960
2543,hzliangbin,3,0.00121,243073,98.02912,247960
2544,iamvarol,3,0.00121,243076,98.03033,247960
2545,ifs-pauljegouic,3,0.00121,243079,98.03154,247960
2546,ijaouani,3,0.00121,243082,98.03275,247960
2547,iliastsi,3,0.00121,243085,98.03396,247960
2548,InCogNiTo124,3,0.00121,243088,98.03517,247960
2549,isaacyuenhk01,3,0.00121,243091,98.03638,247960
2550,ishanmadan1996,3,0.00121,243094,98.03759,247960
2551,ivanbrave,3,0.00121,243097,98.03880,247960
2552,jaminsore,3,0.00121,243100,98.04001,247960
2553,janbe-ts,3,0.00121,243103,98.04122,247960
2554,jardon,3,0.00121,243106,98.04243,247960
2555,jasonbrancazio,3,0.00121,243109,98.04364,247960
2556,jayanthp-intellect,3,0.00121,243112,98.04485,247960
2557,JBosom,3,0.00121,243115,98.04606,247960
2558,jcastill,3,0.00121,243118,98.04727,247960
2559,jcooklin,3,0.00121,243121,98.04848,247960
2560,jeanbaptiste-brasselet,3,0.00121,243124,98.04969,247960
2561,jednymslowem,3,0.00121,243127,98.05090,247960
2562,jer0nim0,3,0.00121,243130,98.05211,247960
2563,jernster,3,0.00121,243133,98.05332,247960
2564,jerry40214,3,0.00121,243136,98.05452,247960
2565,jetbasrawi,3,0.00121,243139,98.05573,247960
2566,jhasm,3,0.00121,243142,98.05694,247960
2567,jhattingh,3,0.00121,243145,98.05815,247960
2568,jianhuashao,3,0.00121,243148,98.05936,247960
2569,jihoon-seo,3,0.00121,243151,98.06057,247960
2570,jimmy-hawkfish,3,0.00121,243154,98.06178,247960
2571,jingli0118,3,0.00121,243157,98.06299,247960
2572,jinnovation,3,0.00121,243160,98.06420,247960
2573,JishnuM,3,0.00121,243163,98.06541,247960
2574,jjayadeep06,3,0.00121,243166,98.06662,247960
2575,jklaise,3,0.00121,243169,98.06783,247960
2576,jlouea,3,0.00121,243172,98.06904,247960
2577,joaquingarciaatos,3,0.00121,243175,98.07025,247960
2578,JohannesTK,3,0.00121,243178,98.07146,247960
2579,johnbuluba,3,0.00121,243181,98.07267,247960
2580,john-cr,3,0.00121,243184,98.07388,247960
2581,johnmacnamararseg,3,0.00121,243187,98.07509,247960
2582,JohnWick-888,3,0.00121,243190,98.07630,247960
2583,JoinHands,3,0.00121,243193,98.07751,247960
2584,Jonuknownothingsnow,3,0.00121,243196,98.07872,247960
2585,jovan-absci,3,0.00121,243199,98.07993,247960
2586,jphines,3,0.00121,243202,98.08114,247960
2587,JuanValencia,3,0.00121,243205,98.08235,247960
2588,Juggernaut1997,3,0.00121,243208,98.08356,247960
2589,JunPyoL22,3,0.00121,243211,98.08477,247960
2590,justin0322,3,0.00121,243214,98.08598,247960
2591,JV-DHL,3,0.00121,243217,98.08719,247960
2592,k4rth33k,3,0.00121,243220,98.08840,247960
2593,kabilan6,3,0.00121,243223,98.08961,247960
2594,kairen,3,0.00121,243226,98.09082,247960
2595,kaishah,3,0.00121,243229,98.09203,247960
2596,kakaxilyp,3,0.00121,243232,98.09324,247960
2597,katieole,3,0.00121,243235,98.09445,247960
2598,kaybon,3,0.00121,243238,98.09566,247960
2599,kbmanseau,3,0.00121,243241,98.09687,247960
2600,kemp2001,3,0.00121,243244,98.09808,247960
2601,kenly-ldk,3,0.00121,243247,98.09929,247960
2602,keshavpeswani,3,0.00121,243250,98.10050,247960
2603,kevinstumpf,3,0.00121,243253,98.10171,247960
2604,khersey,3,0.00121,243256,98.10292,247960
2605,kilicbaran,3,0.00121,243259,98.10413,247960
2606,kim-seoha,3,0.00121,243262,98.10534,247960
2607,kishoreallwynraj,3,0.00121,243265,98.10655,247960
2608,kkolli,3,0.00121,243268,98.10776,247960
2609,Kloempi,3,0.00121,243271,98.10897,247960
2610,kmr0877,3,0.00121,243274,98.11018,247960
2611,konnase,3,0.00121,243277,98.11139,247960
2612,Kribylet,3,0.00121,243280,98.11260,247960
2613,kuzm1ch,3,0.00121,243283,98.11381,247960
2614,kwlzn,3,0.00121,243286,98.11502,247960
2615,kwokon0ng,3,0.00121,243289,98.11623,247960
2616,kzhai,3,0.00121,243292,98.11744,247960
2617,LeeJian,3,0.00121,243295,98.11865,247960
2618,Lee-Yeongjae,3,0.00121,243298,98.11986,247960
2619,leopd,3,0.00121,243301,98.12107,247960
2620,linuraj,3,0.00121,243304,98.12228,247960
2621,liuweibin6566396837,3,0.00121,243307,98.12349,247960
2622,livneros,3,0.00121,243310,98.12470,247960
2623,liyinhgqw,3,0.00121,243313,98.12591,247960
2624,llimboy,3,0.00121,243316,98.12712,247960
2625,lmxia,3,0.00121,243319,98.12833,247960
2626,lnmohankumar,3,0.00121,243322,98.12954,247960
2627,louisvernon,3,0.00121,243325,98.13075,247960
2628,LucidNeko,3,0.00121,243328,98.13196,247960
2629,LuigiCerone,3,0.00121,243331,98.13317,247960
2630,ma08,3,0.00121,243334,98.13438,247960
2631,mabi08,3,0.00121,243337,98.13559,247960
2632,Madhav111,3,0.00121,243340,98.13680,247960
2633,magreenberg1,3,0.00121,243343,98.13801,247960
2634,majidhali,3,0.00121,243346,98.13922,247960
2635,mak-454,3,0.00121,243349,98.14043,247960
2636,makeitai,3,0.00121,243352,98.14164,247960
2637,manojlds,3,0.00121,243355,98.14285,247960
2638,manuelsh,3,0.00121,243358,98.14406,247960
2639,mappedinn,3,0.00121,243361,98.14527,247960
2640,marcmillien,3,0.00121,243364,98.14648,247960
2641,markqiu,3,0.00121,243367,98.14769,247960
2642,markusthoemmes,3,0.00121,243370,98.14889,247960
2643,MartinRogmann,3,0.00121,243373,98.15010,247960
2644,masoudjalayer90,3,0.00121,243376,98.15131,247960
2645,matejaputic,3,0.00121,243379,98.15252,247960
2646,mathieulallier807,3,0.00121,243382,98.15373,247960
2647,mattshma,3,0.00121,243385,98.15494,247960
2648,maver1ck,3,0.00121,243388,98.15615,247960
2649,maxisacoder,3,0.00121,243391,98.15736,247960
2650,mayakacz,3,0.00121,243394,98.15857,247960
2651,mdew192837,3,0.00121,243397,98.15978,247960
2652,Meadosc,3,0.00121,243400,98.16099,247960
2653,meiblorn,3,0.00121,243403,98.16220,247960
2654,mesaverde0207,3,0.00121,243406,98.16341,247960
2655,Mesilenceki,3,0.00121,243409,98.16462,247960
2656,MessKon,3,0.00121,243412,98.16583,247960
2657,mgwismer,3,0.00121,243415,98.16704,247960
2658,mhamdan91,3,0.00121,243418,98.16825,247960
2659,MichaelJiangPlus,3,0.00121,243421,98.16946,247960
2660,mickeyh,3,0.00121,243424,98.17067,247960
2661,mikejmills,3,0.00121,243427,98.17188,247960
2662,mikereeves,3,0.00121,243430,98.17309,247960
2663,mikevoets,3,0.00121,243433,98.17430,247960
2664,mindthevirt,3,0.00121,243436,98.17551,247960
2665,Mithul,3,0.00121,243439,98.17672,247960
2666,MKRNaqeebi,3,0.00121,243442,98.17793,247960
2667,mlegore,3,0.00121,243445,98.17914,247960
2668,mnoble-vody,3,0.00121,243448,98.18035,247960
2669,MohammedRashad,3,0.00121,243451,98.18156,247960
2670,mohite-abhi,3,0.00121,243454,98.18277,247960
2671,mohittalele,3,0.00121,243457,98.18398,247960
2672,moonyoung430,3,0.00121,243460,98.18519,247960
2673,Morride,3,0.00121,243463,98.18640,247960
2674,mosabami,3,0.00121,243466,98.18761,247960
2675,mradha-beat,3,0.00121,243469,98.18882,247960
2676,mroy31,3,0.00121,243472,98.19003,247960
2677,MrPhilosopher,3,0.00121,243475,98.19124,247960
2678,mschuwalow,3,0.00121,243478,98.19245,247960
2679,muhammadtehseenSystemsltd,3,0.00121,243481,98.19366,247960
2680,MuhammadZeeshan34,3,0.00121,243484,98.19487,247960
2681,mwoodbri,3,0.00121,243487,98.19608,247960
2682,n3o-Bhushan,3,0.00121,243490,98.19729,247960
2683,nachocano,3,0.00121,243493,98.19850,247960
2684,nak3,3,0.00121,243496,98.19971,247960
2685,narner90,3,0.00121,243499,98.20092,247960
2686,nashra2637,3,0.00121,243502,98.20213,247960
2687,NathanHowell,3,0.00121,243505,98.20334,247960
2688,navo1194,3,0.00121,243508,98.20455,247960
2689,neonihil,3,0.00121,243511,98.20576,247960
2690,neupaneaj,3,0.00121,243514,98.20697,247960
2691,nicholas-abad,3,0.00121,243517,98.20818,247960
2692,nickozilla,3,0.00121,243520,98.20939,247960
2693,nicolas-geniteau,3,0.00121,243523,98.21060,247960
2694,NiveditaViswanathNVIDIA,3,0.00121,243526,98.21181,247960
2695,NoahRoseLedesma,3,0.00121,243529,98.21302,247960
2696,NohaIhab,3,0.00121,243532,98.21423,247960
2697,noushi,3,0.00121,243535,98.21544,247960
2698,nroberts1,3,0.00121,243538,98.21665,247960
2699,nsteblay,3,0.00121,243541,98.21786,247960
2700,ntl-ibm,3,0.00121,243544,98.21907,247960
2701,nuel-d1,3,0.00121,243547,98.22028,247960
2702,nurcandurak,3,0.00121,243550,98.22149,247960
2703,nutmilk10,3,0.00121,243553,98.22270,247960
2704,oadams,3,0.00121,243556,98.22391,247960
2705,ofir-bt,3,0.00121,243559,98.22512,247960
2706,olegchorny,3,0.00121,243562,98.22633,247960
2707,omerfsen,3,0.00121,243565,98.22754,247960
2708,Omoong,3,0.00121,243568,98.22875,247960
2709,onetonfoot,3,0.00121,243571,98.22996,247960
2710,onur-sam-gtn-ai,3,0.00121,243574,98.23117,247960
2711,opalelement,3,0.00121,243577,98.23238,247960
2712,panbalag,3,0.00121,243580,98.23359,247960
2713,pashtet04,3,0.00121,243583,98.23480,247960
2714,patcombe,3,0.00121,243586,98.23601,247960
2715,paulbaumgart,3,0.00121,243589,98.23722,247960
2716,pavan-infiswift,3,0.00121,243592,98.23843,247960
2717,pavankumarboinapalli,3,0.00121,243595,98.23964,247960
2718,Pedrohgv,3,0.00121,243598,98.24085,247960
2719,pheianox,3,0.00121,243601,98.24206,247960
2720,pinglin,3,0.00121,243604,98.24327,247960
2721,pkourouklidis,3,0.00121,243607,98.24447,247960
2722,plainenough,3,0.00121,243610,98.24568,247960
2723,pmcvay,3,0.00121,243613,98.24689,247960
2724,pmuilu,3,0.00121,243616,98.24810,247960
2725,pogacsa,3,0.00121,243619,98.24931,247960
2726,prachirp,3,0.00121,243622,98.25052,247960
2727,prashanthharshangi,3,0.00121,243625,98.25173,247960
2728,pratibhadeepti,3,0.00121,243628,98.25294,247960
2729,PrimeF,3,0.00121,243631,98.25415,247960
2730,probirsil,3,0.00121,243634,98.25536,247960
2731,prsrepo,3,0.00121,243637,98.25657,247960
2732,psschwei,3,0.00121,243640,98.25778,247960
2733,punkerpunker,3,0.00121,243643,98.25899,247960
2734,qinjie545,3,0.00121,243646,98.26020,247960
2735,quaterneon,3,0.00121,243649,98.26141,247960
2736,rabierp,3,0.00121,243652,98.26262,247960
2737,rahuja23,3,0.00121,243655,98.26383,247960
2738,rahulsmehta,3,0.00121,243658,98.26504,247960
2739,Rajadeepan,3,0.00121,243661,98.26625,247960
2740,rajatonit,3,0.00121,243664,98.26746,247960
2741,rajendra-tamboli,3,0.00121,243667,98.26867,247960
2742,ramakrishnamamidi,3,0.00121,243670,98.26988,247960
2743,rameshkemp,3,0.00121,243673,98.27109,247960
2744,rastislavs,3,0.00121,243676,98.27230,247960
2745,rclough,3,0.00121,243679,98.27351,247960
2746,rduan,3,0.00121,243682,98.27472,247960
2747,rebsp,3,0.00121,243685,98.27593,247960
2748,RenaudWasTaken,3,0.00121,243688,98.27714,247960
2749,retnuh,3,0.00121,243691,98.27835,247960
2750,revathijay,3,0.00121,243694,98.27956,247960
2751,revolutionisme,3,0.00121,243697,98.28077,247960
2752,rexad,3,0.00121,243700,98.28198,247960
2753,richardagalvez,3,0.00121,243703,98.28319,247960
2754,ringtail,3,0.00121,243706,98.28440,247960
2755,riosv,3,0.00121,243709,98.28561,247960
2756,ritaarex,3,0.00121,243712,98.28682,247960
2757,riyaj8888,3,0.00121,243715,98.28803,247960
2758,rjtshrm,3,0.00121,243718,98.28924,247960
2759,rmard90,3,0.00121,243721,98.29045,247960
2760,RobinKa,3,0.00121,243724,98.29166,247960
2761,rochaporto,3,0.00121,243727,98.29287,247960
2762,rohithreddy,3,0.00121,243730,98.29408,247960
2763,romankazinnik,3,0.00121,243733,98.29529,247960
2764,RosaCandela,3,0.00121,243736,98.29650,247960
2765,rosgluk,3,0.00121,243739,98.29771,247960
2766,rsalmond,3,0.00121,243742,98.29892,247960
2767,rubenaranamorera,3,0.00121,243745,98.30013,247960
2768,rushins,3,0.00121,243748,98.30134,247960
2769,rvesse,3,0.00121,243751,98.30255,247960
2770,sachithmuhandiram,3,0.00121,243754,98.30376,247960
2771,sagravat,3,0.00121,243757,98.30497,247960
2772,salilmishra23,3,0.00121,243760,98.30618,247960
2773,SamChb72,3,0.00121,243763,98.30739,247960
2774,samos123,3,0.00121,243766,98.30860,247960
2775,samuelmi2,3,0.00121,243769,98.30981,247960
2776,sathiez,3,0.00121,243772,98.31102,247960
2777,SatyaNarayan1,3,0.00121,243775,98.31223,247960
2778,scott0000,3,0.00121,243778,98.31344,247960
2779,SeanNaren,3,0.00121,243781,98.31465,247960
2780,seansxl,3,0.00121,243784,98.31586,247960
2781,senarvi,3,0.00121,243787,98.31707,247960
2782,sergeykuprikov,3,0.00121,243790,98.31828,247960
2783,shan100github,3,0.00121,243793,98.31949,247960
2784,shashank3959,3,0.00121,243796,98.32070,247960
2785,shashikant-ghangare,3,0.00121,243799,98.32191,247960
2786,shashisingh,3,0.00121,243802,98.32312,247960
2787,shbijlan,3,0.00121,243805,98.32433,247960
2788,shimpel,3,0.00121,243808,98.32554,247960
2789,shivaga9esh,3,0.00121,243811,98.32675,247960
2790,shivam-rai,3,0.00121,243814,98.32796,247960
2791,shruthingcp,3,0.00121,243817,98.32917,247960
2792,shuhaohe,3,0.00121,243820,98.33038,247960
2793,siddharthchaurasia-tudip,3,0.00121,243823,98.33159,247960
2794,Sifat1998,3,0.00121,243826,98.33280,247960
2795,sijieamoy,3,0.00121,243829,98.33401,247960
2796,Silentphantom62,3,0.00121,243832,98.33522,247960
2797,simonjcarr,3,0.00121,243835,98.33643,247960
2798,siriusa51,3,0.00121,243838,98.33764,247960
2799,skothawa-tibco,3,0.00121,243841,98.33884,247960
2800,skuchipu,3,0.00121,243844,98.34005,247960
2801,smurli,3,0.00121,243847,98.34126,247960
2802,soochem,3,0.00121,243850,98.34247,247960
2803,SpecialAll,3,0.00121,243853,98.34368,247960
2804,sriharan16,3,0.00121,243856,98.34489,247960
2805,sshrdp,3,0.00121,243859,98.34610,247960
2806,stampcrab,3,0.00121,243862,98.34731,247960
2807,steveplazafb,3,0.00121,243865,98.34852,247960
2808,subramp,3,0.00121,243868,98.34973,247960
2809,sujaykulkarn,3,0.00121,243871,98.35094,247960
2810,SunilManika,3,0.00121,243874,98.35215,247960
2811,suryaavala,3,0.00121,243877,98.35336,247960
2812,sushkov-r,3,0.00121,243880,98.35457,247960
2813,sxmon,3,0.00121,243883,98.35578,247960
2814,szymonbcoding,3,0.00121,243886,98.35699,247960
2815,TaChao,3,0.00121,243889,98.35820,247960
2816,talcoh2x,3,0.00121,243892,98.35941,247960
2817,TalhaNaeem101,3,0.00121,243895,98.36062,247960
2818,tamera-lanham,3,0.00121,243898,98.36183,247960
2819,Tatsinnit,3,0.00121,243901,98.36304,247960
2820,tbaggu,3,0.00121,243904,98.36425,247960
2821,tech509201941,3,0.00121,243907,98.36546,247960
2822,techwolf139,3,0.00121,243910,98.36667,247960
2823,tejaschumbalkar,3,0.00121,243913,98.36788,247960
2824,tekumara,3,0.00121,243916,98.36909,247960
2825,therc,3,0.00121,243919,98.37030,247960
2826,TheTravellingSalesman,3,0.00121,243922,98.37151,247960
2827,tiansiyuan,3,0.00121,243925,98.37272,247960
2828,Tilyp,3,0.00121,243928,98.37393,247960
2829,timcharper,3,0.00121,243931,98.37514,247960
2830,timothysu,3,0.00121,243934,98.37635,247960
2831,tktest1234,3,0.00121,243937,98.37756,247960
2832,Tlaloc-Es,3,0.00121,243940,98.37877,247960
2833,tleewongjaro-agoda,3,0.00121,243943,98.37998,247960
2834,tmielika,3,0.00121,243946,98.38119,247960
2835,Tomer23,3,0.00121,243949,98.38240,247960
2836,torbre16,3,0.00121,243952,98.38361,247960
2837,TosinAina,3,0.00121,243955,98.38482,247960
2838,true-source,3,0.00121,243958,98.38603,247960
2839,tteltrab,3,0.00121,243961,98.38724,247960
2840,twitchax,3,0.00121,243964,98.38845,247960
2841,twolffpiggott,3,0.00121,243967,98.38966,247960
2842,uhhc,3,0.00121,243970,98.39087,247960
2843,vabshere,3,0.00121,243973,98.39208,247960
2844,vandanavk,3,0.00121,243976,98.39329,247960
2845,varinic,3,0.00121,243979,98.39450,247960
2846,Vasuji,3,0.00121,243982,98.39571,247960
2847,vcarnogu,3,0.00121,243985,98.39692,247960
2848,vditya,3,0.00121,243988,98.39813,247960
2849,vegoutha,3,0.00121,243991,98.39934,247960
2850,vemqar,3,0.00121,243994,98.40055,247960
2851,venci6,3,0.00121,243997,98.40176,247960
2852,verhoek,3,0.00121,244000,98.40297,247960
2853,vgmartinez,3,0.00121,244003,98.40418,247960
2854,vielmetti,3,0.00121,244006,98.40539,247960
2855,VilmaZubak,3,0.00121,244009,98.40660,247960
2856,vinhngx,3,0.00121,244012,98.40781,247960
2857,vipul-sharma20,3,0.00121,244015,98.40902,247960
2858,vitobotta,3,0.00121,244018,98.41023,247960
2859,vladhc,3,0.00121,244021,98.41144,247960
2860,vmallya-123,3,0.00121,244024,98.41265,247960
2861,vmolina,3,0.00121,244027,98.41386,247960
2862,vstrimaitis,3,0.00121,244030,98.41507,247960
2863,wallarug,3,0.00121,244033,98.41628,247960
2864,wallies,3,0.00121,244036,98.41749,247960
2865,WangAooa,3,0.00121,244039,98.41870,247960
2866,wangdian,3,0.00121,244042,98.41991,247960
2867,wangpf09,3,0.00121,244045,98.42112,247960
2868,wanvincent,3,0.00121,244048,98.42233,247960
2869,wenboown,3,0.00121,244051,98.42354,247960
2870,Wenshiqi222,3,0.00121,244054,98.42475,247960
2871,wfg314,3,0.00121,244057,98.42596,247960
2872,wjentner,3,0.00121,244060,98.42717,247960
2873,wkeifenheim,3,0.00121,244063,98.42838,247960
2874,Writtic,3,0.00121,244066,98.42959,247960
2875,wydwww,3,0.00121,244069,98.43080,247960
2876,wzxJayce,3,0.00121,244072,98.43201,247960
2877,Xiaoaier-Z-L,3,0.00121,244075,98.43322,247960
2878,xiaowei-zillow,3,0.00121,244078,98.43442,247960
2879,xieqihui,3,0.00121,244081,98.43563,247960
2880,yangwenhuan,3,0.00121,244084,98.43684,247960
2881,ycheng,3,0.00121,244087,98.43805,247960
2882,yeahdongcn,3,0.00121,244090,98.43926,247960
2883,yehiyam,3,0.00121,244093,98.44047,247960
2884,YogeshSomawar,3,0.00121,244096,98.44168,247960
2885,yordis,3,0.00121,244099,98.44289,247960
2886,younkun,3,0.00121,244102,98.44410,247960
2887,yribeiro,3,0.00121,244105,98.44531,247960
2888,yue9944882,3,0.00121,244108,98.44652,247960
2889,yuefengz,3,0.00121,244111,98.44773,247960
2890,yuval-yaari,3,0.00121,244114,98.44894,247960
2891,YuxiangJohn,3,0.00121,244117,98.45015,247960
2892,zacharyzhao,3,0.00121,244120,98.45136,247960
2893,zanelliriccardo,3,0.00121,244123,98.45257,247960
2894,ZA-NVG,3,0.00121,244126,98.45378,247960
2895,Zashino,3,0.00121,244129,98.45499,247960
2896,zeb-stephen-downs,3,0.00121,244132,98.45620,247960
2897,zhang87492,3,0.00121,244135,98.45741,247960
2898,zhangle-java,3,0.00121,244138,98.45862,247960
2899,zhangzewen,3,0.00121,244141,98.45983,247960
2900,zhcf,3,0.00121,244144,98.46104,247960
2901,ZhengJuCn,3,0.00121,244147,98.46225,247960
2902,zhiyxu,3,0.00121,244150,98.46346,247960
2903,zhyon404,3,0.00121,244153,98.46467,247960
2904,zhzhang,3,0.00121,244156,98.46588,247960
2905,zm274310577,3,0.00121,244159,98.46709,247960
2906,zqz-net,3,0.00121,244162,98.46830,247960
2907,ZxMYS,3,0.00121,244165,98.46951,247960
2908,zzha2941,3,0.00121,244168,98.47072,247960
2909,11mhg,2,0.00081,244170,98.47153,247960
2910,5had3z,2,0.00081,244172,98.47233,247960
2911,Aakash1822,2,0.00081,244174,98.47314,247960
2912,aaronsssya,2,0.00081,244176,98.47395,247960
2913,aashish-sheshadri,2,0.00081,244178,98.47475,247960
2914,aba-ca-xi,2,0.00081,244180,98.47556,247960
2915,abdennour,2,0.00081,244182,98.47637,247960
2916,abdullin,2,0.00081,244184,98.47717,247960
2917,abimur-123,2,0.00081,244186,98.47798,247960
2918,abishek-murali,2,0.00081,244188,98.47879,247960
2919,abramovi,2,0.00081,244190,98.47959,247960
2920,abrarmajeedi,2,0.00081,244192,98.48040,247960
2921,abreu4,2,0.00081,244194,98.48121,247960
2922,ace-gabriel,2,0.00081,244196,98.48201,247960
2923,achal-wwt,2,0.00081,244198,98.48282,247960
2924,adhaene-noimos,2,0.00081,244200,98.48363,247960
2925,adhilcodes,2,0.00081,244202,98.48443,247960
2926,adhithyasrinivasan,2,0.00081,244204,98.48524,247960
2927,AdityaSoni19031997,2,0.00081,244206,98.48605,247960
2928,adiwijaya,2,0.00081,244208,98.48685,247960
2929,adrshm91,2,0.00081,244210,98.48766,247960
2930,adux6991,2,0.00081,244212,98.48847,247960
2931,adyachok,2,0.00081,244214,98.48927,247960
2932,afilcheff,2,0.00081,244216,98.49008,247960
2933,agnim25,2,0.00081,244218,98.49089,247960
2934,agoloAbbas,2,0.00081,244220,98.49169,247960
2935,ahmed1alqulayti,2,0.00081,244222,98.49250,247960
2936,ahousley,2,0.00081,244224,98.49331,247960
2937,aicdp1010,2,0.00081,244226,98.49411,247960
2938,AiDataSciencer,2,0.00081,244228,98.49492,247960
2939,aka-toxa,2,0.00081,244230,98.49573,247960
2940,akhimji,2,0.00081,244232,98.49653,247960
2941,akravacyber,2,0.00081,244234,98.49734,247960
2942,akshatgit,2,0.00081,244236,98.49814,247960
2943,akshayuppal3,2,0.00081,244238,98.49895,247960
2944,aku134,2,0.00081,244240,98.49976,247960
2945,Al4DIN,2,0.00081,244242,98.50056,247960
2946,alanhughes,2,0.00081,244244,98.50137,247960
2947,AldusLorde,2,0.00081,244246,98.50218,247960
2948,alekseyolg,2,0.00081,244248,98.50298,247960
2949,AlexanderCHarrington,2,0.00081,244250,98.50379,247960
2950,AlexChenSkyBlue,2,0.00081,244252,98.50460,247960
2951,alexcoca,2,0.00081,244254,98.50540,247960
2952,alexmirrington,2,0.00081,244256,98.50621,247960
2953,alexw994,2,0.00081,244258,98.50702,247960
2954,alidadar7676,2,0.00081,244260,98.50782,247960
2955,Alienfeel,2,0.00081,244262,98.50863,247960
2956,alok-raj,2,0.00081,244264,98.50944,247960
2957,amalow,2,0.00081,244266,98.51024,247960
2958,ameya-parab,2,0.00081,244268,98.51105,247960
2959,Amishakumari544,2,0.00081,244270,98.51186,247960
2960,amitchnick,2,0.00081,244272,98.51266,247960
2961,ammubharatram,2,0.00081,244274,98.51347,247960
2962,amosaini,2,0.00081,244276,98.51428,247960
2963,amostech,2,0.00081,244278,98.51508,247960
2964,andersonvc,2,0.00081,244280,98.51589,247960
2965,andong0323,2,0.00081,244282,98.51670,247960
2966,andradron,2,0.00081,244284,98.51750,247960
2967,andreas-schliebitz,2,0.00081,244286,98.51831,247960
2968,andrebriggs,2,0.00081,244288,98.51912,247960
2969,andrewcantos,2,0.00081,244290,98.51992,247960
2970,AndrewLeach,2,0.00081,244292,98.52073,247960
2971,andyk,2,0.00081,244294,98.52154,247960
2972,andyswift,2,0.00081,244296,98.52234,247960
2973,andyzheung,2,0.00081,244298,98.52315,247960
2974,angoothachap,2,0.00081,244300,98.52396,247960
2975,anhuaxiang,2,0.00081,244302,98.52476,247960
2976,animesh-agarwal,2,0.00081,244304,98.52557,247960
2977,AnnaYue,2,0.00081,244306,98.52638,247960
2978,anshuman-cg,2,0.00081,244308,98.52718,247960
2979,ant31,2,0.00081,244310,98.52799,247960
2980,anyingl,2,0.00081,244312,98.52879,247960
2981,aoighost,2,0.00081,244314,98.52960,247960
2982,apshoemaker,2,0.00081,244316,98.53041,247960
2983,apurva3000,2,0.00081,244318,98.53121,247960
2984,arashd,2,0.00081,244320,98.53202,247960
2985,Archa91,2,0.00081,244322,98.53283,247960
2986,aresa7796,2,0.00081,244324,98.53363,247960
2987,arianpasquali,2,0.00081,244326,98.53444,247960
2988,arinto,2,0.00081,244328,98.53525,247960
2989,arjun921,2,0.00081,244330,98.53605,247960
2990,arlofaria,2,0.00081,244332,98.53686,247960
2991,artemlops,2,0.00081,244334,98.53767,247960
2992,asavpatel92,2,0.00081,244336,98.53847,247960
2993,asaydin,2,0.00081,244338,98.53928,247960
2994,Aschwinvo,2,0.00081,244340,98.54009,247960
2995,Ashish-Bhau,2,0.00081,244342,98.54089,247960
2996,ashokbalaraman,2,0.00081,244344,98.54170,247960
2997,ashokramadass,2,0.00081,244346,98.54251,247960
2998,asif001,2,0.00081,244348,98.54331,247960
2999,aslom,2,0.00081,244350,98.54412,247960
3000,asmod3us,2,0.00081,244352,98.54493,247960
3001,atamahjoubfar,2,0.00081,244354,98.54573,247960
3002,atbraoy,2,0.00081,244356,98.54654,247960
3003,athensofamerica,2,0.00081,244358,98.54735,247960
3004,at-machine-user,2,0.00081,244360,98.54815,247960
3005,Attila111111,2,0.00081,244362,98.54896,247960
3006,avik-taranis,2,0.00081,244364,98.54977,247960
3007,awl-ext-hoangtml,2,0.00081,244366,98.55057,247960
3008,AxdorphCoder,2,0.00081,244368,98.55138,247960
3009,ayushpandeyemotionrx,2,0.00081,244370,98.55219,247960
3010,banderlog,2,0.00081,244372,98.55299,247960
3011,bankentan,2,0.00081,244374,98.55380,247960
3012,barney-s,2,0.00081,244376,98.55461,247960
3013,Barteus,2,0.00081,244378,98.55541,247960
3014,bcebere,2,0.00081,244380,98.55622,247960
3015,bdlb77,2,0.00081,244382,98.55703,247960
3016,bearrito,2,0.00081,244384,98.55783,247960
3017,Benjamin-Etheredge,2,0.00081,244386,98.55864,247960
3018,bertinma,2,0.00081,244388,98.55945,247960
3019,beyersito,2,0.00081,244390,98.56025,247960
3020,bhupc,2,0.00081,244392,98.56106,247960
3021,bigflood,2,0.00081,244394,98.56186,247960
3022,bioshazard,2,0.00081,244396,98.56267,247960
3023,bjmrevilla,2,0.00081,244398,98.56348,247960
3024,bkhuong,2,0.00081,244400,98.56428,247960
3025,blacky-i,2,0.00081,244402,98.56509,247960
3026,blankenshipz,2,0.00081,244404,98.56590,247960
3027,BlodwenZ,2,0.00081,244406,98.56670,247960
3028,bmopuri,2,0.00081,244408,98.56751,247960
3029,bobmerevel,2,0.00081,244410,98.56832,247960
3030,BOBO-ZzB,2,0.00081,244412,98.56912,247960
3031,Bonbonbg,2,0.00081,244414,98.56993,247960
3032,bonclay,2,0.00081,244416,98.57074,247960
3033,borremosch,2,0.00081,244418,98.57154,247960
3034,bradleykcardwell,2,0.00081,244420,98.57235,247960
3035,brendanobra,2,0.00081,244422,98.57316,247960
3036,brianmartin,2,0.00081,244424,98.57396,247960
3037,brness,2,0.00081,244426,98.57477,247960
3038,BroderPeters,2,0.00081,244428,98.57558,247960
3039,brucearctor,2,0.00081,244430,98.57638,247960
3040,brussell757,2,0.00081,244432,98.57719,247960
3041,bryanye97,2,0.00081,244434,98.57800,247960
3042,bug-developer021,2,0.00081,244436,98.57880,247960
3043,buluba89,2,0.00081,244438,98.57961,247960
3044,ByronHsu,2,0.00081,244440,98.58042,247960
3045,byronyi,2,0.00081,244442,98.58122,247960
3046,caiyuanji,2,0.00081,244444,98.58203,247960
3047,calebmoss,2,0.00081,244446,98.58284,247960
3048,CaNignEX,2,0.00081,244448,98.58364,247960
3049,carmat88,2,0.00081,244450,98.58445,247960
3050,Cas-pian,2,0.00081,244452,98.58526,247960
3051,cavepopo,2,0.00081,244454,98.58606,247960
3052,cchung100m,2,0.00081,244456,98.58687,247960
3053,cdraper-CS,2,0.00081,244458,98.58768,247960
3054,cdyangzhenyu,2,0.00081,244460,98.58848,247960
3055,cells2numbers,2,0.00081,244462,98.58929,247960
3056,cesargomez,2,0.00081,244464,98.59010,247960
3057,cgparkinson,2,0.00081,244466,98.59090,247960
3058,chanansh,2,0.00081,244468,98.59171,247960
3059,chaowangnk1,2,0.00081,244470,98.59251,247960
3060,charlesmelby,2,0.00081,244472,98.59332,247960
3061,Charlie-L-K,2,0.00081,244474,98.59413,247960
3062,chen98,2,0.00081,244476,98.59493,247960
3063,chenglinzhang,2,0.00081,244478,98.59574,247960
3064,chenhan1218,2,0.00081,244480,98.59655,247960
3065,chenmay0921,2,0.00081,244482,98.59735,247960
3066,chennupushkar,2,0.00081,244484,98.59816,247960
3067,Chenxs1122,2,0.00081,244486,98.59897,247960
3068,chienfuchen32,2,0.00081,244488,98.59977,247960
3069,chlun1,2,0.00081,244490,98.60058,247960
3070,choismn00,2,0.00081,244492,98.60139,247960
3071,chpmoreno,2,0.00081,244494,98.60219,247960
3072,chris-andrasick,2,0.00081,244496,98.60300,247960
3073,ChrisMagnuson,2,0.00081,244498,98.60381,247960
3074,chrisstockton,2,0.00081,244500,98.60461,247960
3075,chriswu99aaa,2,0.00081,244502,98.60542,247960
3076,chunyang-wen,2,0.00081,244504,98.60623,247960
3077,ChusMoyano,2,0.00081,244506,98.60703,247960
3078,chwonghk01,2,0.00081,244508,98.60784,247960
3079,civitaspo,2,0.00081,244510,98.60865,247960
3080,cjidboon94,2,0.00081,244512,98.60945,247960
3081,clarizzafern,2,0.00081,244514,98.61026,247960
3082,claytonlemons,2,0.00081,244516,98.61107,247960
3083,cm185255,2,0.00081,244518,98.61187,247960
3084,C-nit,2,0.00081,244520,98.61268,247960
3085,constanton,2,0.00081,244522,98.61349,247960
3086,Corezcy,2,0.00081,244524,98.61429,247960
3087,cornleaf,2,0.00081,244526,98.61510,247960
3088,corvin-quodai,2,0.00081,244528,98.61591,247960
3089,CreatorSky,2,0.00081,244530,98.61671,247960
3090,crogers923,2,0.00081,244532,98.61752,247960
3091,CRSilkworth,2,0.00081,244534,98.61833,247960
3092,cruxyoung,2,0.00081,244536,98.61913,247960
3093,csachs,2,0.00081,244538,98.61994,247960
3094,cupdike,2,0.00081,244540,98.62075,247960
3095,custom8,2,0.00081,244542,98.62155,247960
3096,cyfdecyf,2,0.00081,244544,98.62236,247960
3097,cyphar,2,0.00081,244546,98.62317,247960
3098,D1o0g9s,2,0.00081,244548,98.62397,247960
3099,daisuke834,2,0.00081,244550,98.62478,247960
3100,dalxds,2,0.00081,244552,98.62558,247960
3101,daniel-hutao,2,0.00081,244554,98.62639,247960
3102,danielrs,2,0.00081,244556,98.62720,247960
3103,danielvegamyhre,2,0.00081,244558,98.62800,247960
3104,daniel-woolworths,2,0.00081,244560,98.62881,247960
3105,DanMcInerney,2,0.00081,244562,98.62962,247960
3106,dardanbekteshi,2,0.00081,244564,98.63042,247960
3107,DarioBernardo,2,0.00081,244566,98.63123,247960
3108,darkopevec,2,0.00081,244568,98.63204,247960
3109,darthveda-ai,2,0.00081,244570,98.63284,247960
3110,davemaung,2,0.00081,244572,98.63365,247960
3111,davidgao7,2,0.00081,244574,98.63446,247960
3112,DavidGeW,2,0.00081,244576,98.63526,247960
3113,davidggz,2,0.00081,244578,98.63607,247960
3114,davidLif,2,0.00081,244580,98.63688,247960
3115,davidtwomey,2,0.00081,244582,98.63768,247960
3116,dawu76,2,0.00081,244584,98.63849,247960
3117,ddbmh,2,0.00081,244586,98.63930,247960
3118,DDDDDDDDDDDDLANG,2,0.00081,244588,98.64010,247960
3119,DDFaller,2,0.00081,244590,98.64091,247960
3120,Deancup,2,0.00081,244592,98.64172,247960
3121,derekwyatt,2,0.00081,244594,98.64252,247960
3122,DeshuaiWang,2,0.00081,244596,98.64333,247960
3123,DesmondH0,2,0.00081,244598,98.64414,247960
3124,devenjarvis,2,0.00081,244600,98.64494,247960
3125,devil-cyber,2,0.00081,244602,98.64575,247960
3126,devoftheweb,2,0.00081,244604,98.64656,247960
3127,dewnull,2,0.00081,244606,98.64736,247960
3128,dgess,2,0.00081,244608,98.64817,247960
3129,DHolmanCoding,2,0.00081,244610,98.64898,247960
3130,diazidabagus,2,0.00081,244612,98.64978,247960
3131,dijitali,2,0.00081,244614,98.65059,247960
3132,DimaKav,2,0.00081,244616,98.65140,247960
3133,dimara,2,0.00081,244618,98.65220,247960
3134,dimitraz,2,0.00081,244620,98.65301,247960
3135,dippynark,2,0.00081,244622,98.65382,247960
3136,d-kavaliou,2,0.00081,244624,98.65462,247960
3137,dmrub,2,0.00081,244626,98.65543,247960
3138,doctorai-in,2,0.00081,244628,98.65623,247960
3139,doepking,2,0.00081,244630,98.65704,247960
3140,dogukanutuna,2,0.00081,244632,98.65785,247960
3141,doodlesbykumbi,2,0.00081,244634,98.65865,247960
3142,DorotheaKal,2,0.00081,244636,98.65946,247960
3143,dragonwarp,2,0.00081,244638,98.66027,247960
3144,dredwilliams,2,0.00081,244640,98.66107,247960
3145,drobison-deloitte,2,0.00081,244642,98.66188,247960
3146,dsblank,2,0.00081,244644,98.66269,247960
3147,dshen51,2,0.00081,244646,98.66349,247960
3148,dtaniwaki,2,0.00081,244648,98.66430,247960
3149,duoduo-ai,2,0.00081,244650,98.66511,247960
3150,duongnt,2,0.00081,244652,98.66591,247960
3151,durch,2,0.00081,244654,98.66672,247960
3152,duttab49,2,0.00081,244656,98.66753,247960
3153,dvdbisong,2,0.00081,244658,98.66833,247960
3154,Dylan-Rich,2,0.00081,244660,98.66914,247960
3155,e-compagno,2,0.00081,244662,98.66995,247960
3156,EdanSneh,2,0.00081,244664,98.67075,247960
3157,edgar971,2,0.00081,244666,98.67156,247960
3158,ediphy-azorab,2,0.00081,244668,98.67237,247960
3159,EDjur,2,0.00081,244670,98.67317,247960
3160,EdMorrell,2,0.00081,244672,98.67398,247960
3161,edowson,2,0.00081,244674,98.67479,247960
3162,edwardstudy,2,0.00081,244676,98.67559,247960
3163,Efthymios-Stathakis,2,0.00081,244678,98.67640,247960
3164,Eliasecchi,2,0.00081,244680,98.67721,247960
3165,eqqe,2,0.00081,244682,98.67801,247960
3166,eran-nussbaum,2,0.00081,244684,98.67882,247960
3167,EricBentoML,2,0.00081,244686,98.67963,247960
3168,Eshan-Agarwal,2,0.00081,244688,98.68043,247960
3169,eshiroma,2,0.00081,244690,98.68124,247960
3170,espears1,2,0.00081,244692,98.68205,247960
3171,etracer65,2,0.00081,244694,98.68285,247960
3172,eugenesiow,2,0.00081,244696,98.68366,247960
3173,ev4isthos,2,0.00081,244698,98.68447,247960
3174,Evanto,2,0.00081,244700,98.68527,247960
3175,ever-cheng,2,0.00081,244702,98.68608,247960
3176,ey00,2,0.00081,244704,98.68688,247960
3177,eykanal,2,0.00081,244706,98.68769,247960
3178,ezeeyahoo,2,0.00081,244708,98.68850,247960
3179,f6wbl6,2,0.00081,244710,98.68930,247960
3180,fabianbaier,2,0.00081,244712,98.69011,247960
3181,falcocoris,2,0.00081,244714,98.69092,247960
3182,fanminshi,2,0.00081,244716,98.69172,247960
3183,Faraz743,2,0.00081,244718,98.69253,247960
3184,farazmujtaba,2,0.00081,244720,98.69334,247960
3185,farshadsm,2,0.00081,244722,98.69414,247960
3186,farzinsarvaramini,2,0.00081,244724,98.69495,247960
3187,fberanizo,2,0.00081,244726,98.69576,247960
3188,Feelas,2,0.00081,244728,98.69656,247960
3189,feizerl,2,0.00081,244730,98.69737,247960
3190,felixhuangau,2,0.00081,244732,98.69818,247960
3191,ferpitol,2,0.00081,244734,98.69898,247960
3192,FGXZ2JO,2,0.00081,244736,98.69979,247960
3193,Findlazyfriend,2,0.00081,244738,98.70060,247960
3194,Fizmath,2,0.00081,244740,98.70140,247960
3195,FKSI,2,0.00081,244742,98.70221,247960
3196,floleuerer,2,0.00081,244744,98.70302,247960
3197,Franco8888,2,0.00081,244746,98.70382,247960
3198,frosenberg,2,0.00081,244748,98.70463,247960
3199,gajanankulkarni-18,2,0.00081,244750,98.70544,247960
3200,Gallardot,2,0.00081,244752,98.70624,247960
3201,GarrettMooney,2,0.00081,244754,98.70705,247960
3202,garrettwong,2,0.00081,244756,98.70786,247960
3203,geoantony9,2,0.00081,244758,98.70866,247960
3204,GeorgeLeePatterson,2,0.00081,244760,98.70947,247960
3205,Geoyi,2,0.00081,244762,98.71028,247960
3206,gerrith3,2,0.00081,244764,98.71108,247960
3207,Gevorg-Minasyan,2,0.00081,244766,98.71189,247960
3208,gfyulx,2,0.00081,244768,98.71270,247960
3209,ggogel,2,0.00081,244770,98.71350,247960
3210,giogit,2,0.00081,244772,98.71431,247960
3211,GitHub007Dra,2,0.00081,244774,98.71512,247960
3212,glong1997,2,0.00081,244776,98.71592,247960
3213,Gnommer,2,0.00081,244778,98.71673,247960
3214,goofy-z,2,0.00081,244780,98.71754,247960
3215,graykode,2,0.00081,244782,98.71834,247960
3216,greggdonovan,2,0.00081,244784,98.71915,247960
3217,groszewn,2,0.00081,244786,98.71995,247960
3218,guhcampos,2,0.00081,244788,98.72076,247960
3219,guykhazma,2,0.00081,244790,98.72157,247960
3220,GytisBraz,2,0.00081,244792,98.72237,247960
3221,hahamark1,2,0.00081,244794,98.72318,247960
3222,hahns0lo,2,0.00081,244796,98.72399,247960
3223,hanan9m,2,0.00081,244798,98.72479,247960
3224,hanwgyu,2,0.00081,244800,98.72560,247960
3225,harish422,2,0.00081,244802,98.72641,247960
3226,Harishkrishna17,2,0.00081,244804,98.72721,247960
3227,harmeet-singh-discovery,2,0.00081,244806,98.72802,247960
3228,hasansalimkanmaz,2,0.00081,244808,98.72883,247960
3229,hchiuzhuo,2,0.00081,244810,98.72963,247960
3230,hegand,2,0.00081,244812,98.73044,247960
3231,heilerich,2,0.00081,244814,98.73125,247960
3232,hemangjoshi37a,2,0.00081,244816,98.73205,247960
3233,HenryW95,2,0.00081,244818,98.73286,247960
3234,hexiaoliangRick,2,0.00081,244820,98.73367,247960
3235,hfarooqui,2,0.00081,244822,98.73447,247960
3236,hfwen0502,2,0.00081,244824,98.73528,247960
3237,hgrsd,2,0.00081,244826,98.73609,247960
3238,hhji,2,0.00081,244828,98.73689,247960
3239,hideto0710,2,0.00081,244830,98.73770,247960
3240,hikoz,2,0.00081,244832,98.73851,247960
3241,himanshu007-creator,2,0.00081,244834,98.73931,247960
3242,himkt,2,0.00081,244836,98.74012,247960
3243,hkair,2,0.00081,244838,98.74093,247960
3244,hlngaiSam,2,0.00081,244840,98.74173,247960
3245,hmc-cs-mdrissi,2,0.00081,244842,98.74254,247960
3246,hoangtnm,2,0.00081,244844,98.74335,247960
3247,holadepo,2,0.00081,244846,98.74415,247960
3248,Hongbo-Miao,2,0.00081,244848,98.74496,247960
3249,hongyonggan,2,0.00081,244850,98.74577,247960
3250,hossein-rasi,2,0.00081,244852,98.74657,247960
3251,huang06,2,0.00081,244854,98.74738,247960
3252,huboqiang,2,0.00081,244856,98.74819,247960
3253,huone1,2,0.00081,244858,98.74899,247960
3254,Huy199,2,0.00081,244860,98.74980,247960
3255,HVKHCM,2,0.00081,244862,98.75060,247960
3256,hwang9u,2,0.00081,244864,98.75141,247960
3257,hwHans,2,0.00081,244866,98.75222,247960
3258,hyperbolic2346,2,0.00081,244868,98.75302,247960
3259,hyperparameters,2,0.00081,244870,98.75383,247960
3260,iBluemind,2,0.00081,244872,98.75464,247960
3261,ib-steffen,2,0.00081,244874,98.75544,247960
3262,i-chvets,2,0.00081,244876,98.75625,247960
3263,idahoakl,2,0.00081,244878,98.75706,247960
3264,idealhack,2,0.00081,244880,98.75786,247960
3265,idibidiart,2,0.00081,244882,98.75867,247960
3266,idvoretskyi,2,0.00081,244884,98.75948,247960
3267,iedmrc,2,0.00081,244886,98.76028,247960
3268,ihorby,2,0.00081,244888,98.76109,247960
3269,II-VSB-II,2,0.00081,244890,98.76190,247960
3270,ilchemla,2,0.00081,244892,98.76270,247960
3271,ilovecomet,2,0.00081,244894,98.76351,247960
3272,iluoeli,2,0.00081,244896,98.76432,247960
3273,ImadEddineBek,2,0.00081,244898,98.76512,247960
3274,imagr-pat,2,0.00081,244900,98.76593,247960
3275,indranilr,2,0.00081,244902,98.76674,247960
3276,infa-ddeore,2,0.00081,244904,98.76754,247960
3277,isaacmg,2,0.00081,244906,98.76835,247960
3278,isaranto,2,0.00081,244908,98.76916,247960
3279,IsraelAbebe,2,0.00081,244910,98.76996,247960
3280,isuyyy,2,0.00081,244912,98.77077,247960
3281,Itfly,2,0.00081,244914,98.77158,247960
3282,IvanAlejandro888,2,0.00081,244916,98.77238,247960
3283,ivanjacobsec,2,0.00081,244918,98.77319,247960
3284,ivryan,2,0.00081,244920,98.77400,247960
3285,Jabbo16,2,0.00081,244922,98.77480,247960
3286,JackDallas,2,0.00081,244924,98.77561,247960
3287,jacklu2016,2,0.00081,244926,98.77642,247960
3288,jaggaer-mtrninic,2,0.00081,244928,98.77722,247960
3289,jainprachi2506,2,0.00081,244930,98.77803,247960
3290,Jalmeida1994,2,0.00081,244932,98.77884,247960
3291,jamesandres,2,0.00081,244934,98.77964,247960
3292,jamessandy,2,0.00081,244936,98.78045,247960
3293,jammingyu9,2,0.00081,244938,98.78126,247960
3294,jangold-miovision,2,0.00081,244940,98.78206,247960
3295,JasonPad19,2,0.00081,244942,98.78287,247960
3296,javajon,2,0.00081,244944,98.78367,247960
3297,javiroman,2,0.00081,244946,98.78448,247960
3298,jayaprasadt,2,0.00081,244948,98.78529,247960
3299,jaystary,2,0.00081,244950,98.78609,247960
3300,jcRisch,2,0.00081,244952,98.78690,247960
3301,JCzz,2,0.00081,244954,98.78771,247960
3302,jdavis34265,2,0.00081,244956,98.78851,247960
3303,jdurago,2,0.00081,244958,98.78932,247960
3304,JebasinghLuccas,2,0.00081,244960,98.79013,247960
3305,jeesmon,2,0.00081,244962,98.79093,247960
3306,JeffersonH44,2,0.00081,244964,98.79174,247960
3307,jentrialgo,2,0.00081,244966,98.79255,247960
3308,Jetafull,2,0.00081,244968,98.79335,247960
3309,jhamet93,2,0.00081,244970,98.79416,247960
3310,jhebelerDS,2,0.00081,244972,98.79497,247960
3311,jhs0318,2,0.00081,244974,98.79577,247960
3312,jimbobby5,2,0.00081,244976,98.79658,247960
3313,jimenan-iguazio,2,0.00081,244978,98.79739,247960
3314,jimspohrer,2,0.00081,244980,98.79819,247960
3315,jinseonlee1215,2,0.00081,244982,98.79900,247960
3316,jithinvalsalan,2,0.00081,244984,98.79981,247960
3317,jiujiang,2,0.00081,244986,98.80061,247960
3318,jkchang,2,0.00081,244988,98.80142,247960
3319,jnmaomao,2,0.00081,244990,98.80223,247960
3320,joal-zb,2,0.00081,244992,98.80303,247960
3321,joesan,2,0.00081,244994,98.80384,247960
3322,johnchenghk01,2,0.00081,244996,98.80465,247960
3323,joinal-ahmed,2,0.00081,244998,98.80545,247960
3324,jonas,2,0.00081,245000,98.80626,247960
3325,jonathanglima,2,0.00081,245002,98.80707,247960
3326,jonathangold,2,0.00081,245004,98.80787,247960
3327,JonChanGit,2,0.00081,245006,98.80868,247960
3328,jonghyunho,2,0.00081,245008,98.80949,247960
3329,Jooho,2,0.00081,245010,98.81029,247960
3330,josete89,2,0.00081,245012,98.81110,247960
3331,jphuynh,2,0.00081,245014,98.81191,247960
3332,jpic,2,0.00081,245016,98.81271,247960
3333,JP-MRPhys,2,0.00081,245018,98.81352,247960
3334,jpvandervelden,2,0.00081,245020,98.81432,247960
3335,jrabary,2,0.00081,245022,98.81513,247960
3336,jrabiah,2,0.00081,245024,98.81594,247960
3337,JRBANCEL,2,0.00081,245026,98.81674,247960
3338,jszendre,2,0.00081,245028,98.81755,247960
3339,jtlz2,2,0.00081,245030,98.81836,247960
3340,JuanPabloSebey,2,0.00081,245032,98.81916,247960
3341,juan-sv,2,0.00081,245034,98.81997,247960
3342,juhyeon-cha,2,0.00081,245036,98.82078,247960
3343,junaid18183,2,0.00081,245038,98.82158,247960
3344,junggeh,2,0.00081,245040,98.82239,247960
3345,jusingh,2,0.00081,245042,98.82320,247960
3346,JustinReboullot,2,0.00081,245044,98.82400,247960
3347,j-wezel,2,0.00081,245046,98.82481,247960
3348,JyothsnaPendyala,2,0.00081,245048,98.82562,247960
3349,jzonthemtn,2,0.00081,245050,98.82642,247960
3350,kaikun213,2,0.00081,245052,98.82723,247960
3351,kamal24111991,2,0.00081,245054,98.82804,247960
3352,kanwaljitkhurmi,2,0.00081,245056,98.82884,247960
3353,karkumar,2,0.00081,245058,98.82965,247960
3354,karlmutch,2,0.00081,245060,98.83046,247960
3355,karmicdude,2,0.00081,245062,98.83126,247960
3356,KateGo520,2,0.00081,245064,98.83207,247960
3357,Katharine,2,0.00081,245066,98.83288,247960
3358,KatyaRuth,2,0.00081,245068,98.83368,247960
3359,kcturner123,2,0.00081,245070,98.83449,247960
3360,kenhktsui,2,0.00081,245072,98.83530,247960
3361,kenugraha,2,0.00081,245074,98.83610,247960
3362,kenwoodjw,2,0.00081,245076,98.83691,247960
3363,kevincasadodsc,2,0.00081,245078,98.83772,247960
3364,khangtrantri,2,0.00081,245080,98.83852,247960
3365,khsibr,2,0.00081,245082,98.83933,247960
3366,ki-arie,2,0.00081,245084,98.84014,247960
3367,kikko,2,0.00081,245086,98.84094,247960
3368,Kiza,2,0.00081,245088,98.84175,247960
3369,k-jeon,2,0.00081,245090,98.84256,247960
3370,kkohtaka,2,0.00081,245092,98.84336,247960
3371,klaus82,2,0.00081,245094,98.84417,247960
3372,Klein-Hu,2,0.00081,245096,98.84497,247960
3373,kmathiou,2,0.00081,245098,98.84578,247960
3374,KMFidom,2,0.00081,245100,98.84659,247960
3375,koenmtb1,2,0.00081,245102,98.84739,247960
3376,kolakows,2,0.00081,245104,98.84820,247960
3377,KonstantinosAnd,2,0.00081,245106,98.84901,247960
3378,koseoyoung,2,0.00081,245108,98.84981,247960
3379,kow3ns,2,0.00081,245110,98.85062,247960
3380,kpeters,2,0.00081,245112,98.85143,247960
3381,kslin,2,0.00081,245114,98.85223,247960
3382,kstory8,2,0.00081,245116,98.85304,247960
3383,kubeflow-examples,2,0.00081,245118,98.85385,247960
3384,kuldeepjain,2,0.00081,245120,98.85465,247960
3385,kunalpatel1793,2,0.00081,245122,98.85546,247960
3386,KunWuLuan,2,0.00081,245124,98.85627,247960
3387,kylegc,2,0.00081,245126,98.85707,247960
3388,kyprifog,2,0.00081,245128,98.85788,247960
3389,kzh,2,0.00081,245130,98.85869,247960
3390,lambertsbennett,2,0.00081,245132,98.85949,247960
3391,Lance410247,2,0.00081,245134,98.86030,247960
3392,larry-lu-lu,2,0.00081,245136,98.86111,247960
3393,larsderidder,2,0.00081,245138,98.86191,247960
3394,LasalJayawardena,2,0.00081,245140,98.86272,247960
3395,laurentbastien,2,0.00081,245142,98.86353,247960
3396,LaurenzReitsam,2,0.00081,245144,98.86433,247960
3397,lawdpls,2,0.00081,245146,98.86514,247960
3398,lbatteau,2,0.00081,245148,98.86595,247960
3399,lc-billyfung,2,0.00081,245150,98.86675,247960
3400,LeBoyOrion,2,0.00081,245152,98.86756,247960
3401,leeqleeqleeq,2,0.00081,245154,98.86837,247960
3402,leorleor,2,0.00081,245156,98.86917,247960
3403,lfloeer,2,0.00081,245158,98.86998,247960
3404,lightingghost,2,0.00081,245160,98.87079,247960
3405,limotkl,2,0.00081,245162,98.87159,247960
3406,liu431,2,0.00081,245164,98.87240,247960
3407,liuchintao,2,0.00081,245166,98.87321,247960
3408,liujun121533,2,0.00081,245168,98.87401,247960
3409,liusy182,2,0.00081,245170,98.87482,247960
3410,LiuZhiYuan123456,2,0.00081,245172,98.87563,247960
3411,lixianfa,2,0.00081,245174,98.87643,247960
3412,lizzy220,2,0.00081,245176,98.87724,247960
3413,llKetanll,2,0.00081,245178,98.87804,247960
3414,Longwelwind,2,0.00081,245180,98.87885,247960
3415,Lord-V15,2,0.00081,245182,98.87966,247960
3416,Louanes1,2,0.00081,245184,98.88046,247960
3417,LouNauSRC,2,0.00081,245186,98.88127,247960
3418,lowc1012,2,0.00081,245188,98.88208,247960
3419,lppsuixn,2,0.00081,245190,98.88288,247960
3420,lucaseo90,2,0.00081,245192,98.88369,247960
3421,lucien-kejl,2,0.00081,245194,98.88450,247960
3422,ludans,2,0.00081,245196,98.88530,247960
3423,luigicr1965,2,0.00081,245198,98.88611,247960
3424,lukeogg,2,0.00081,245200,98.88692,247960
3425,lukkiddd,2,0.00081,245202,98.88772,247960
3426,LutzWeischerFujitsu,2,0.00081,245204,98.88853,247960
3427,lvbaouu,2,0.00081,245206,98.88934,247960
3428,Lyken17,2,0.00081,245208,98.89014,247960
3429,lynochka,2,0.00081,245210,98.89095,247960
3430,m10913044,2,0.00081,245212,98.89176,247960
3431,m1ghtym0,2,0.00081,245214,98.89256,247960
3432,magdalenakuhn,2,0.00081,245216,98.89337,247960
3433,magreiner,2,0.00081,245218,98.89418,247960
3434,majidaldo,2,0.00081,245220,98.89498,247960
3435,mannuscript,2,0.00081,245222,98.89579,247960
3436,maorzalt,2,0.00081,245224,98.89660,247960
3437,mapdegree,2,0.00081,245226,98.89740,247960
3438,marcoceppi,2,0.00081,245228,98.89821,247960
3439,marcusturewicz,2,0.00081,245230,98.89902,247960
3440,mareksuscak,2,0.00081,245232,98.89982,247960
3441,markbeierl,2,0.00081,245234,98.90063,247960
3442,marlow-h,2,0.00081,245236,98.90144,247960
3443,marsupialtail,2,0.00081,245238,98.90224,247960
3444,martinbomio,2,0.00081,245240,98.90305,247960
3445,martin-gorner,2,0.00081,245242,98.90386,247960
3446,martin-liu,2,0.00081,245244,98.90466,247960
3447,mat0pad,2,0.00081,245246,98.90547,247960
3448,matheusjericoo,2,0.00081,245248,98.90628,247960
3449,math-sasso,2,0.00081,245250,98.90708,247960
3450,mattcallanan,2,0.00081,245252,98.90789,247960
3451,mattdornfeld,2,0.00081,245254,98.90869,247960
3452,MatteoFelici,2,0.00081,245256,98.90950,247960
3453,matthiasfalk,2,0.00081,245258,98.91031,247960
3454,mattiasliljenzin,2,0.00081,245260,98.91111,247960
3455,mattmcclean,2,0.00081,245262,98.91192,247960
3456,maurizio-vitale,2,0.00081,245264,98.91273,247960
3457,mdruby,2,0.00081,245266,98.91353,247960
3458,mehrdadnd,2,0.00081,245268,98.91434,247960
3459,meneal,2,0.00081,245270,98.91515,247960
3460,mengxi-ascent,2,0.00081,245272,98.91595,247960
3461,merryzhou,2,0.00081,245274,98.91676,247960
3462,mfabdrabou,2,0.00081,245276,98.91757,247960
3463,mfruhner,2,0.00081,245278,98.91837,247960
3464,mgr2178,2,0.00081,245280,98.91918,247960
3465,micahjsmith,2,0.00081,245282,98.91999,247960
3466,michael-balint,2,0.00081,245284,98.92079,247960
3467,MiHess,2,0.00081,245286,98.92160,247960
3468,mikechengwei,2,0.00081,245288,98.92241,247960
3469,Minyus,2,0.00081,245290,98.92321,247960
3470,misohu,2,0.00081,245292,98.92402,247960
3471,misteliy,2,0.00081,245294,98.92483,247960
3472,MJ-Amway,2,0.00081,245296,98.92563,247960
3473,mjgrav2001,2,0.00081,245298,98.92644,247960
3474,ml6-liam,2,0.00081,245300,98.92725,247960
3475,Mlawrence95,2,0.00081,245302,98.92805,247960
3476,mlushpenko,2,0.00081,245304,98.92886,247960
3477,mmalviya,2,0.00081,245306,98.92967,247960
3478,mmochan,2,0.00081,245308,98.93047,247960
3479,mogthesprog,2,0.00081,245310,98.93128,247960
3480,mohamadmansourX,2,0.00081,245312,98.93209,247960
3481,mohamedFaris47,2,0.00081,245314,98.93289,247960
3482,monadic,2,0.00081,245316,98.93370,247960
3483,monil536,2,0.00081,245318,98.93451,247960
3484,montanier,2,0.00081,245320,98.93531,247960
3485,mouradmourafiq,2,0.00081,245322,98.93612,247960
3486,mparkhe,2,0.00081,245324,98.93693,247960
3487,mrjgamble,2,0.00081,245326,98.93773,247960
3488,mrudulan,2,0.00081,245328,98.93854,247960
3489,mshyeon,2,0.00081,245330,98.93935,247960
3490,msteiner-google,2,0.00081,245332,98.94015,247960
3491,mtparet,2,0.00081,245334,98.94096,247960
3492,mukul-mehta,2,0.00081,245336,98.94176,247960
3493,Mullefa,2,0.00081,245338,98.94257,247960
3494,muscovitebob,2,0.00081,245340,98.94338,247960
3495,Muzry,2,0.00081,245342,98.94418,247960
3496,Mykolaichenko,2,0.00081,245344,98.94499,247960
3497,n3011,2,0.00081,245346,98.94580,247960
3498,nabsabraham,2,0.00081,245348,98.94660,247960
3499,Naegionn,2,0.00081,245350,98.94741,247960
3500,namespace-io,2,0.00081,245352,98.94822,247960
3501,Nancy-Badran,2,0.00081,245354,98.94902,247960
3502,Nancylsell,2,0.00081,245356,98.94983,247960
3503,natalytvinova,2,0.00081,245358,98.95064,247960
3504,NateRoiger,2,0.00081,245360,98.95144,247960
3505,nathanwong91,2,0.00081,245362,98.95225,247960
3506,nbren12,2,0.00081,245364,98.95306,247960
3507,NeerajGulia,2,0.00081,245366,98.95386,247960
3508,neofarm473,2,0.00081,245368,98.95467,247960
3509,nephenthe,2,0.00081,245370,98.95548,247960
3510,nexemjail,2,0.00081,245372,98.95628,247960
3511,nicexxact,2,0.00081,245374,98.95709,247960
3512,nickiegk,2,0.00081,245376,98.95790,247960
3513,NickJasonLv,2,0.00081,245378,98.95870,247960
3514,nicosac97,2,0.00081,245380,98.95951,247960
3515,Nidhidamodaran,2,0.00081,245382,98.96032,247960
3516,nikan1996,2,0.00081,245384,98.96112,247960
3517,nikhil-dce,2,0.00081,245386,98.96193,247960
3518,nikhil-thomas,2,0.00081,245388,98.96274,247960
3519,Niko32,2,0.00081,245390,98.96354,247960
3520,nirmalsinghania2008,2,0.00081,245392,98.96435,247960
3521,niteshldd,2,0.00081,245394,98.96516,247960
3522,Nivedita-V,2,0.00081,245396,98.96596,247960
3523,nlaanait,2,0.00081,245398,98.96677,247960
3524,nowenL,2,0.00081,245400,98.96758,247960
3525,nphilou,2,0.00081,245402,98.96838,247960
3526,nschenone,2,0.00081,245404,98.96919,247960
3527,ns-jman,2,0.00081,245406,98.97000,247960
3528,oakkas,2,0.00081,245408,98.97080,247960
3529,obeyda,2,0.00081,245410,98.97161,247960
3530,ocdkube,2,0.00081,245412,98.97241,247960
3531,OfTheThorn,2,0.00081,245414,98.97322,247960
3532,oguzhanoyan,2,0.00081,245416,98.97403,247960
3533,omerfsen-gsnd,2,0.00081,245418,98.97483,247960
3534,onelittlenightmusic,2,0.00081,245420,98.97564,247960
3535,OnionSmile,2,0.00081,245422,98.97645,247960
3536,ooverandout,2,0.00081,245424,98.97725,247960
3537,OrenLeung,2,0.00081,245426,98.97806,247960
3538,osabobo,2,0.00081,245428,98.97887,247960
3539,oshep,2,0.00081,245430,98.97967,247960
3540,ozora-ogino,2,0.00081,245432,98.98048,247960
3541,pablogsal,2,0.00081,245434,98.98129,247960
3542,pankajxyz,2,0.00081,245436,98.98209,247960
3543,parano,2,0.00081,245438,98.98290,247960
3544,parthasarathi-pm,2,0.00081,245440,98.98371,247960
3545,patelmm79,2,0.00081,245442,98.98451,247960
3546,patrickmead,2,0.00081,245444,98.98532,247960
3547,paxinos,2,0.00081,245446,98.98613,247960
3548,pbrzostowski,2,0.00081,245448,98.98693,247960
3549,pedrocwb,2,0.00081,245450,98.98774,247960
3550,peidaqi,2,0.00081,245452,98.98855,247960
3551,peteboothroyd,2,0.00081,245454,98.98935,247960
3552,phanimarupaka,2,0.00081,245456,98.99016,247960
3553,phejimlin,2,0.00081,245458,98.99097,247960
3554,philipebuka,2,0.00081,245460,98.99177,247960
3555,PhilippeBarb,2,0.00081,245462,98.99258,247960
3556,philmln,2,0.00081,245464,98.99339,247960
3557,phonaylin,2,0.00081,245466,98.99419,247960
3558,piernikR,2,0.00081,245468,98.99500,247960
3559,PierrickPochelu,2,0.00081,245470,98.99581,247960
3560,piyushcse29,2,0.00081,245472,98.99661,247960
3561,pjsudharshan,2,0.00081,245474,98.99742,247960
3562,pkamath,2,0.00081,245476,98.99823,247960
3563,pkasson-ascena,2,0.00081,245478,98.99903,247960
3564,pmangg,2,0.00081,245480,98.99984,247960
3565,polsm91,2,0.00081,245482,99.00065,247960
3566,porridge,2,0.00081,245484,99.00145,247960
3567,porterdarby,2,0.00081,245486,99.00226,247960
3568,potix2,2,0.00081,245488,99.00307,247960
3569,pragadeeshraju,2,0.00081,245490,99.00387,247960
3570,pranasblk,2,0.00081,245492,99.00468,247960
3571,prateek1192,2,0.00081,245494,99.00548,247960
3572,prograhamer,2,0.00081,245496,99.00629,247960
3573,psc-dlt,2,0.00081,245498,99.00710,247960
3574,pshegde,2,0.00081,245500,99.00790,247960
3575,psisoft,2,0.00081,245502,99.00871,247960
3576,pugang1985,2,0.00081,245504,99.00952,247960
3577,pupilye,2,0.00081,245506,99.01032,247960
3578,qinshuaihua,2,0.00081,245508,99.01113,247960
3579,qiujian16,2,0.00081,245510,99.01194,247960
3580,radics93,2,0.00081,245512,99.01274,247960
3581,rafaascensao,2,0.00081,245514,99.01355,247960
3582,rafaelnovello,2,0.00081,245516,99.01436,247960
3583,rafalk0,2,0.00081,245518,99.01516,247960
3584,rairithesh123,2,0.00081,245520,99.01597,247960
3585,rajib76,2,0.00081,245522,99.01678,247960
3586,rami3e,2,0.00081,245524,99.01758,247960
3587,raphaelTrench,2,0.00081,245526,99.01839,247960
3588,Ravenp87,2,0.00081,245528,99.01920,247960
3589,rayan-roy,2,0.00081,245530,99.02000,247960
3590,rayymlai,2,0.00081,245532,99.02081,247960
3591,rcarrata,2,0.00081,245534,99.02162,247960
3592,rcillavicomtech,2,0.00081,245536,99.02242,247960
3593,rcleere,2,0.00081,245538,99.02323,247960
3594,rebeccamcfadden,2,0.00081,245540,99.02404,247960
3595,reed9999,2,0.00081,245542,99.02484,247960
3596,rehevkor5,2,0.00081,245544,99.02565,247960
3597,Reldan,2,0.00081,245546,99.02646,247960
3598,remyLarroye,2,0.00081,245548,99.02726,247960
3599,remyleone,2,0.00081,245550,99.02807,247960
3600,rexshang,2,0.00081,245552,99.02888,247960
3601,rexxar-liang,2,0.00081,245554,99.02968,247960
3602,richardliaw,2,0.00081,245556,99.03049,247960
3603,ricpet,2,0.00081,245558,99.03130,247960
3604,ritabanchowdhury319,2,0.00081,245560,99.03210,247960
3605,robertmujica,2,0.00081,245562,99.03291,247960
3606,robertstarmer,2,0.00081,245564,99.03372,247960
3607,robin5540,2,0.00081,245566,99.03452,247960
3608,robscc,2,0.00081,245568,99.03533,247960
3609,rochageorge,2,0.00081,245570,99.03613,247960
3610,RochanMehrotra,2,0.00081,245572,99.03694,247960
3611,rohitsroch,2,0.00081,245574,99.03775,247960
3612,romanwozniak,2,0.00081,245576,99.03855,247960
3613,RonsenbergVI,2,0.00081,245578,99.03936,247960
3614,rossella,2,0.00081,245580,99.04017,247960
3615,RoterDL,2,0.00081,245582,99.04097,247960
3616,roy-tonal,2,0.00081,245584,99.04178,247960
3617,rs9899,2,0.00081,245586,99.04259,247960
3618,rtkshahwar,2,0.00081,245588,99.04339,247960
3619,Rubiel1,2,0.00081,245590,99.04420,247960
3620,rujual,2,0.00081,245592,99.04501,247960
3621,ruoyu90,2,0.00081,245594,99.04581,247960
3622,ryan-ally,2,0.00081,245596,99.04662,247960
3623,RyanSiu1995,2,0.00081,245598,99.04743,247960
3624,sachdevayash1910,2,0.00081,245600,99.04823,247960
3625,saemaromoon,2,0.00081,245602,99.04904,247960
3626,sagarshrestha24,2,0.00081,245604,99.04985,247960
3627,sahilprasad,2,0.00081,245606,99.05065,247960
3628,saintyun,2,0.00081,245608,99.05146,247960
3629,saisona,2,0.00081,245610,99.05227,247960
3630,sajid-moinuddin,2,0.00081,245612,99.05307,247960
3631,samuda2019,2,0.00081,245614,99.05388,247960
3632,sasi-patha,2,0.00081,245616,99.05469,247960
3633,sathishvj,2,0.00081,245618,99.05549,247960
3634,satish-dops94,2,0.00081,245620,99.05630,247960
3635,sav116,2,0.00081,245622,99.05711,247960
3636,sciai-ai,2,0.00081,245624,99.05791,247960
3637,sculd,2,0.00081,245626,99.05872,247960
3638,sdeoras,2,0.00081,245628,99.05953,247960
3639,seekyiyi,2,0.00081,245630,99.06033,247960
3640,Sergiodiaz53-Dedalus,2,0.00081,245632,99.06114,247960
3641,sethjones,2,0.00081,245634,99.06195,247960
3642,sethjuarez,2,0.00081,245636,99.06275,247960
3643,sfc-gh-adlee,2,0.00081,245638,99.06356,247960
3644,ShahNewazKhan,2,0.00081,245640,99.06437,247960
3645,shankyz,2,0.00081,245642,99.06517,247960
3646,shivakumargowda12,2,0.00081,245644,99.06598,247960
3647,shreya-verma19,2,0.00081,245646,99.06678,247960
3648,shubamsharma,2,0.00081,245648,99.06759,247960
3649,ShuhanYan,2,0.00081,245650,99.06840,247960
3650,shuiqiangchen,2,0.00081,245652,99.06920,247960
3651,shunkakinoki,2,0.00081,245654,99.07001,247960
3652,silenceshell,2,0.00081,245656,99.07082,247960
3653,Sillians,2,0.00081,245658,99.07162,247960
3654,simdynamic,2,0.00081,245660,99.07243,247960
3655,sinban04,2,0.00081,245662,99.07324,247960
3656,sindhudeloitte,2,0.00081,245664,99.07404,247960
3657,SirBubbls,2,0.00081,245666,99.07485,247960
3658,sirkkalap,2,0.00081,245668,99.07566,247960
3659,siva2k16,2,0.00081,245670,99.07646,247960
3660,skliarpawlo,2,0.00081,245672,99.07727,247960
3661,skonto,2,0.00081,245674,99.07808,247960
3662,Sliceco,2,0.00081,245676,99.07888,247960
3663,smalhot9464,2,0.00081,245678,99.07969,247960
3664,smandrell-ec,2,0.00081,245680,99.08050,247960
3665,smartnose,2,0.00081,245682,99.08130,247960
3666,smathalikunnel,2,0.00081,245684,99.08211,247960
3667,Smlight,2,0.00081,245686,99.08292,247960
3668,snekkalapudi,2,0.00081,245688,99.08372,247960
3669,Sobolvitya,2,0.00081,245690,99.08453,247960
3670,soltysh,2,0.00081,245692,99.08534,247960
3671,soogui,2,0.00081,245694,99.08614,247960
3672,sravi999,2,0.00081,245696,99.08695,247960
3673,SrinivasGuntupalli,2,0.00081,245698,99.08776,247960
3674,srmeier,2,0.00081,245700,99.08856,247960
3675,ssbagalkar,2,0.00081,245702,99.08937,247960
3676,sssyyw,2,0.00081,245704,99.09018,247960
3677,stalamoni,2,0.00081,245706,99.09098,247960
3678,StAugust,2,0.00081,245708,99.09179,247960
3679,stevemanavalan,2,0.00081,245710,99.09260,247960
3680,stewartadam,2,0.00081,245712,99.09340,247960
3681,StianOvrevage,2,0.00081,245714,99.09421,247960
3682,strangiato,2,0.00081,245716,99.09502,247960
3683,strump,2,0.00081,245718,99.09582,247960
3684,subrnath,2,0.00081,245720,99.09663,247960
3685,subsid,2,0.00081,245722,99.09744,247960
3686,suluner,2,0.00081,245724,99.09824,247960
3687,sumanassarmathg,2,0.00081,245726,99.09905,247960
3688,suminb,2,0.00081,245728,99.09985,247960
3689,Sundragon1993,2,0.00081,245730,99.10066,247960
3690,sunsingerus,2,0.00081,245732,99.10147,247960
3691,supernan1994,2,0.00081,245734,99.10227,247960
3692,surajphulara,2,0.00081,245736,99.10308,247960
3693,suryabdev,2,0.00081,245738,99.10389,247960
3694,sushilkm,2,0.00081,245740,99.10469,247960
3695,svnoesis,2,0.00081,245742,99.10550,247960
3696,svz77,2,0.00081,245744,99.10631,247960
3697,swarajoturkar,2,0.00081,245746,99.10711,247960
3698,swartz-k,2,0.00081,245748,99.10792,247960
3699,sxbfundi,2,0.00081,245750,99.10873,247960
3700,syd-quant,2,0.00081,245752,99.10953,247960
3701,szczeles,2,0.00081,245754,99.11034,247960
3702,taffarel-gaivota,2,0.00081,245756,99.11115,247960
3703,tahesse,2,0.00081,245758,99.11195,247960
3704,TahirHayat,2,0.00081,245760,99.11276,247960
3705,talk2jaydip,2,0.00081,245762,99.11357,247960
3706,TanjaDuPlessis,2,0.00081,245764,99.11437,247960
3707,tanken,2,0.00081,245766,99.11518,247960
3708,TarunJana,2,0.00081,245768,99.11599,247960
3709,tautrimas,2,0.00081,245770,99.11679,247960
3710,taylanates24,2,0.00081,245772,99.11760,247960
3711,tchaton,2,0.00081,245774,99.11841,247960
3712,TDehaene,2,0.00081,245776,99.11921,247960
3713,techjacker,2,0.00081,245778,99.12002,247960
3714,telpirion,2,0.00081,245780,99.12083,247960
3715,tereketeketitaka,2,0.00081,245782,99.12163,247960
3716,thameemk612,2,0.00081,245784,99.12244,247960
3717,thanhpt55,2,0.00081,245786,99.12325,247960
3718,theathibm,2,0.00081,245788,99.12405,247960
3719,TheDutchDevil,2,0.00081,245790,99.12486,247960
3720,themummy,2,0.00081,245792,99.12567,247960
3721,thesandlord,2,0.00081,245794,99.12647,247960
3722,Tieriko,2,0.00081,245796,99.12728,247960
3723,tiffanyfay,2,0.00081,245798,99.12809,247960
3724,tim5chneider,2,0.00081,245800,99.12889,247960
3725,timofal,2,0.00081,245802,99.12970,247960
3726,tingzhang-ming,2,0.00081,245804,99.13050,247960
3727,tinkerer,2,0.00081,245806,99.13131,247960
3728,tirkarthi,2,0.00081,245808,99.13212,247960
3729,tjmonsi,2,0.00081,245810,99.13292,247960
3730,TKorr,2,0.00081,245812,99.13373,247960
3731,tmerrittsmith,2,0.00081,245814,99.13454,247960
3732,tomaszstachera,2,0.00081,245816,99.13534,247960
3733,tom-dd,2,0.00081,245818,99.13615,247960
3734,TomVanWemmel,2,0.00081,245820,99.13696,247960
3735,tonykim-moloco,2,0.00081,245822,99.13776,247960
3736,tonywang-sh,2,0.00081,245824,99.13857,247960
3737,TonyZZhang,2,0.00081,245826,99.13938,247960
3738,toricls,2,0.00081,245828,99.14018,247960
3739,trieuat,2,0.00081,245830,99.14099,247960
3740,TRINHHOANGANH,2,0.00081,245832,99.14180,247960
3741,trmbdevops,2,0.00081,245834,99.14260,247960
3742,tulsi0523,2,0.00081,245836,99.14341,247960
3743,turowicz,2,0.00081,245838,99.14422,247960
3744,Tutj,2,0.00081,245840,99.14502,247960
3745,tvkpz,2,0.00081,245842,99.14583,247960
3746,tvtv511,2,0.00081,245844,99.14664,247960
3747,tyg03485,2,0.00081,245846,99.14744,247960
3748,uipo78,2,0.00081,245848,99.14825,247960
3749,UllasShanthakumar,2,0.00081,245850,99.14906,247960
3750,unagaraju88,2,0.00081,245852,99.14986,247960
3751,unix-way,2,0.00081,245854,99.15067,247960
3752,unnown,2,0.00081,245856,99.15148,247960
3753,urekalion,2,0.00081,245858,99.15228,247960
3754,vahidtz,2,0.00081,245860,99.15309,247960
3755,ValentinVerkhohliad,2,0.00081,245862,99.15390,247960
3756,valeriano-manassero,2,0.00081,245864,99.15470,247960
3757,valiantljk,2,0.00081,245866,99.15551,247960
3758,vamshikrishna9505,2,0.00081,245868,99.15632,247960
3759,Vaskozl,2,0.00081,245870,99.15712,247960
3760,veiii,2,0.00081,245872,99.15793,247960
3761,victoriavilasb,2,0.00081,245874,99.15874,247960
3762,vietanhdev,2,0.00081,245876,99.15954,247960
3763,vigneshsolution,2,0.00081,245878,99.16035,247960
3764,vijayreddybo,2,0.00081,245880,99.16116,247960
3765,vikashg,2,0.00081,245882,99.16196,247960
3766,viktoriaas,2,0.00081,245884,99.16277,247960
3767,vimalkansal,2,0.00081,245886,99.16357,247960
3768,vishalsantv,2,0.00081,245888,99.16438,247960
3769,vivekjainmaiet,2,0.00081,245890,99.16519,247960
3770,vivekpd15,2,0.00081,245892,99.16599,247960
3771,vlordier,2,0.00081,245894,99.16680,247960
3772,v-loves-avocados,2,0.00081,245896,99.16761,247960
3773,vmarkovtsev,2,0.00081,245898,99.16841,247960
3774,vovawed,2,0.00081,245900,99.16922,247960
3775,vsoch,2,0.00081,245902,99.17003,247960
3776,vulong3896,2,0.00081,245904,99.17083,247960
3777,waelCh,2,0.00081,245906,99.17164,247960
3778,WalidMustapha,2,0.00081,245908,99.17245,247960
3779,walkerjian,2,0.00081,245910,99.17325,247960
3780,wallwind,2,0.00081,245912,99.17406,247960
3781,walterhuangio,2,0.00081,245914,99.17487,247960
3782,wangjun1974,2,0.00081,245916,99.17567,247960
3783,wangli1426,2,0.00081,245918,99.17648,247960
3784,wangpengfei984597422,2,0.00081,245920,99.17729,247960
3785,wangzy0327,2,0.00081,245922,99.17809,247960
3786,Wesley-Miller,2,0.00081,245924,99.17890,247960
3787,wfangchi,2,0.00081,245926,99.17971,247960
3788,whigy,2,0.00081,245928,99.18051,247960
3789,whycircle,2,0.00081,245930,99.18132,247960
3790,wiktorof,2,0.00081,245932,99.18213,247960
3791,wildermuthn,2,0.00081,245934,99.18293,247960
3792,will-gerard,2,0.00081,245936,99.18374,247960
3793,williamyeh,2,0.00081,245938,99.18455,247960
3794,windkit,2,0.00081,245940,99.18535,247960
3795,wlongxiang,2,0.00081,245942,99.18616,247960
3796,wuchen03,2,0.00081,245944,99.18697,247960
3797,wujie1993,2,0.00081,245946,99.18777,247960
3798,wuyinzhenjun,2,0.00081,245948,99.18858,247960
3799,wxyzyu,2,0.00081,245950,99.18939,247960
3800,WyattGorman,2,0.00081,245952,99.19019,247960
3801,wybaron,2,0.00081,245954,99.19100,247960
3802,wzamazon,2,0.00081,245956,99.19181,247960
3803,wzhou18,2,0.00081,245958,99.19261,247960
3804,xiaopang1001,2,0.00081,245960,99.19342,247960
3805,xujingyissa,2,0.00081,245962,99.19422,247960
3806,yadavvij,2,0.00081,245964,99.19503,247960
3807,yannhowe,2,0.00081,245966,99.19584,247960
3808,yanspirit,2,0.00081,245968,99.19664,247960
3809,yanwu2014,2,0.00081,245970,99.19745,247960
3810,yaser-hameed,2,0.00081,245972,99.19826,247960
3811,yasersakkaf,2,0.00081,245974,99.19906,247960
3812,ycsk02,2,0.00081,245976,99.19987,247960
3813,YiannisGkoufas,2,0.00081,245978,99.20068,247960
3814,yingfeng,2,0.00081,245980,99.20148,247960
3815,ykevinc,2,0.00081,245982,99.20229,247960
3816,ykoyfman,2,0.00081,245984,99.20310,247960
3817,youngMan4,2,0.00081,245986,99.20390,247960
3818,yousefis,2,0.00081,245988,99.20471,247960
3819,YousefRabi,2,0.00081,245990,99.20552,247960
3820,youxingtian,2,0.00081,245992,99.20632,247960
3821,yuezhilanyi,2,0.00081,245994,99.20713,247960
3822,Yu-Wang-Datatonic,2,0.00081,245996,99.20794,247960
3823,yuyue9284,2,0.00081,245998,99.20874,247960
3824,yuzhaojing,2,0.00081,246000,99.20955,247960
3825,yves-altaml,2,0.00081,246002,99.21036,247960
3826,YY007H,2,0.00081,246004,99.21116,247960
3827,YYStreet,2,0.00081,246006,99.21197,247960
3828,yzhangswingman,2,0.00081,246008,99.21278,247960
3829,zclyne,2,0.00081,246010,99.21358,247960
3830,zeeros,2,0.00081,246012,99.21439,247960
3831,zehni,2,0.00081,246014,99.21520,247960
3832,zeldebro,2,0.00081,246016,99.21600,247960
3833,zemarx,2,0.00081,246018,99.21681,247960
3834,ZhangYuguo,2,0.00081,246020,99.21762,247960
3835,Zhiyuancheng,2,0.00081,246022,99.21842,247960
3836,zrlaida,2,0.00081,246024,99.21923,247960
3837,zyxcambridge,2,0.00081,246026,99.22004,247960
3838,zzvara,2,0.00081,246028,99.22084,247960
3839,0snug0,1,0.00040,246029,99.22125,247960
3840,1202zhyl,1,0.00040,246030,99.22165,247960
3841,12DReflections,1,0.00040,246031,99.22205,247960
3842,15077693d,1,0.00040,246032,99.22246,247960
3843,15379180,1,0.00040,246033,99.22286,247960
3844,1920853199,1,0.00040,246034,99.22326,247960
3845,24king,1,0.00040,246035,99.22367,247960
3846,2sin18,1,0.00040,246036,99.22407,247960
3847,360DigiTMG-Training,1,0.00040,246037,99.22447,247960
3848,3Xpl0it3r,1,0.00040,246038,99.22487,247960
3849,4j4y,1,0.00040,246039,99.22528,247960
3850,4vik,1,0.00040,246040,99.22568,247960
3851,535727234,1,0.00040,246041,99.22608,247960
3852,5HAD0W-P1R4T3,1,0.00040,246042,99.22649,247960
3853,626626cdllp,1,0.00040,246043,99.22689,247960
3854,636,1,0.00040,246044,99.22729,247960
3855,912988434,1,0.00040,246045,99.22770,247960
3856,916264367,1,0.00040,246046,99.22810,247960
3857,980956031,1,0.00040,246047,99.22850,247960
3858,a097253,1,0.00040,246048,99.22891,247960
3859,Aachunella,1,0.00040,246049,99.22931,247960
3860,aadityak33,1,0.00040,246050,99.22971,247960
3861,aaron-nall,1,0.00040,246051,99.23012,247960
3862,AaronUST,1,0.00040,246052,99.23052,247960
3863,aarthipa,1,0.00040,246053,99.23092,247960
3864,AbdallahAboelela,1,0.00040,246054,99.23133,247960
3865,abdulari,1,0.00040,246055,99.23173,247960
3866,abdullah-saal,1,0.00040,246056,99.23213,247960
3867,abhijeetchauhan,1,0.00040,246057,99.23254,247960
3868,abhijitk123,1,0.00040,246058,99.23294,247960
3869,abhishekchakladar-tc,1,0.00040,246059,99.23334,247960
3870,abhishek-tyagi87,1,0.00040,246060,99.23375,247960
3871,abhishekvermasg,1,0.00040,246061,99.23415,247960
3872,abieler,1,0.00040,246062,99.23455,247960
3873,abinthomasonline,1,0.00040,246063,99.23496,247960
3874,AboorvaDevarajan,1,0.00040,246064,99.23536,247960
3875,ACAVJW4H,1,0.00040,246065,99.23576,247960
3876,accraze,1,0.00040,246066,99.23617,247960
3877,achikars,1,0.00040,246067,99.23657,247960
3878,achoreim,1,0.00040,246068,99.23697,247960
3879,ACodingfreak,1,0.00040,246069,99.23738,247960
3880,adampilz,1,0.00040,246070,99.23778,247960
3881,adam-wasserman,1,0.00040,246071,99.23818,247960
3882,Adedolapo-Akin,1,0.00040,246072,99.23859,247960
3883,AdeshKhandait,1,0.00040,246073,99.23899,247960
3884,aditipatil0711,1,0.00040,246074,99.23939,247960
3885,adobemomo,1,0.00040,246075,99.23980,247960
3886,adollar,1,0.00040,246076,99.24020,247960
3887,adrianchia,1,0.00040,246077,99.24060,247960
3888,afk42,1,0.00040,246078,99.24101,247960
3889,ag2-debug,1,0.00040,246079,99.24141,247960
3890,aganesan94,1,0.00040,246080,99.24181,247960
3891,agolomoodysaada,1,0.00040,246081,99.24222,247960
3892,AGrzes,1,0.00040,246082,99.24262,247960
3893,agup006,1,0.00040,246083,99.24302,247960
3894,agustinvinao,1,0.00040,246084,99.24343,247960
3895,ahakanbaba,1,0.00040,246085,99.24383,247960
3896,ahmedelmahy,1,0.00040,246086,99.24423,247960
3897,Ahsansyed713,1,0.00040,246087,99.24464,247960
3898,aidangomez,1,0.00040,246088,99.24504,247960
3899,aii-shanker-jj,1,0.00040,246089,99.24544,247960
3900,aikow,1,0.00040,246090,99.24585,247960
3901,aimldl,1,0.00040,246091,99.24625,247960
3902,aishwary09,1,0.00040,246092,99.24665,247960
3903,aivanou,1,0.00040,246093,99.24706,247960
3904,ajaykamal3,1,0.00040,246094,99.24746,247960
3905,ajpotts,1,0.00040,246095,99.24786,247960
3906,akangst,1,0.00040,246096,99.24827,247960
3907,akbari-ali,1,0.00040,246097,99.24867,247960
3908,akhilvinvent,1,0.00040,246098,99.24907,247960
3909,akilman,1,0.00040,246099,99.24948,247960
3910,akkolwalkar,1,0.00040,246100,99.24988,247960
3911,Akmazad,1,0.00040,246101,99.25028,247960
3912,akonneker,1,0.00040,246102,99.25069,247960
3913,akramIOT,1,0.00040,246103,99.25109,247960
3914,Aksh97,1,0.00040,246104,99.25149,247960
3915,akshayc11,1,0.00040,246105,99.25190,247960
3916,akulkailwoo,1,0.00040,246106,99.25230,247960
3917,alangordon258,1,0.00040,246107,99.25270,247960
3918,AlanHau,1,0.00040,246108,99.25311,247960
3919,alasdairtran,1,0.00040,246109,99.25351,247960
3920,albertshx,1,0.00040,246110,99.25391,247960
3921,Alec-Zebrick,1,0.00040,246111,99.25432,247960
3922,AlendeGeraldo,1,0.00040,246112,99.25472,247960
3923,Alessthana,1,0.00040,246113,99.25512,247960
3924,alexanderDoria,1,0.00040,246114,99.25553,247960
3925,Alexander-Rogin,1,0.00040,246115,99.25593,247960
3926,AlexBulankou,1,0.00040,246116,99.25633,247960
3927,alexchenfeng,1,0.00040,246117,99.25673,247960
3928,alexchrisramos,1,0.00040,246118,99.25714,247960
3929,alex-dixon,1,0.00040,246119,99.25754,247960
3930,alexellis,1,0.00040,246120,99.25794,247960
3931,AlexLuya,1,0.00040,246121,99.25835,247960
3932,alex-slynko,1,0.00040,246122,99.25875,247960
3933,alexvicegrab,1,0.00040,246123,99.25915,247960
3934,AlexZhangHF,1,0.00040,246124,99.25956,247960
3935,alexZsss,1,0.00040,246125,99.25996,247960
3936,alf-icc,1,0.00040,246126,99.26036,247960
3937,algermissen,1,0.00040,246127,99.26077,247960
3938,Ali771025,1,0.00040,246128,99.26117,247960
3939,aliasmee,1,0.00040,246129,99.26157,247960
3940,alikhurram42000,1,0.00040,246130,99.26198,247960
3941,alirezaahmadibeni,1,0.00040,246131,99.26238,247960
3942,alka-roy,1,0.00040,246132,99.26278,247960
3943,alokhom,1,0.00040,246133,99.26319,247960
3944,Altair3,1,0.00040,246134,99.26359,247960
3945,Alvin4550,1,0.00040,246135,99.26399,247960
3946,alvisememo,1,0.00040,246136,99.26440,247960
3947,AlwaysLearningMore,1,0.00040,246137,99.26480,247960
3948,Amaan5624,1,0.00040,246138,99.26520,247960
3949,amclay,1,0.00040,246139,99.26561,247960
3950,amercier-twt,1,0.00040,246140,99.26601,247960
3951,amigniox,1,0.00040,246141,99.26641,247960
3952,AmineHosni,1,0.00040,246142,99.26682,247960
3953,amitk75,1,0.00040,246143,99.26722,247960
3954,amitnjha,1,0.00040,246144,99.26762,247960
3955,amitza,1,0.00040,246145,99.26803,247960
3956,amorenocb,1,0.00040,246146,99.26843,247960
3957,a-m-thomas,1,0.00040,246147,99.26883,247960
3958,analyticalmonk,1,0.00040,246148,99.26924,247960
3959,AndersonML,1,0.00040,246149,99.26964,247960
3960,andjedani,1,0.00040,246150,99.27004,247960
3961,andodet,1,0.00040,246151,99.27045,247960
3962,andreasf,1,0.00040,246152,99.27085,247960
3963,andrejlukic,1,0.00040,246153,99.27125,247960
3964,Andreluizfc,1,0.00040,246154,99.27166,247960
3965,AndrewAlscher,1,0.00040,246155,99.27206,247960
3966,andrewcheny,1,0.00040,246156,99.27246,247960
3967,andrewisplinghoff,1,0.00040,246157,99.27287,247960
3968,andrewmorrison-sky,1,0.00040,246158,99.27327,247960
3969,andrewrreed,1,0.00040,246159,99.27367,247960
3970,andrewsykim,1,0.00040,246160,99.27408,247960
3971,andrew-veriga,1,0.00040,246161,99.27448,247960
3972,Andy546,1,0.00040,246162,99.27488,247960
3973,andytwigg,1,0.00040,246163,99.27529,247960
3974,andyz168,1,0.00040,246164,99.27569,247960
3975,aneeshc-c,1,0.00040,246165,99.27609,247960
3976,Anh-BK,1,0.00040,246166,99.27650,247960
3977,anil-pandey-mpf,1,0.00040,246167,99.27690,247960
3978,anirbanlahiri2017,1,0.00040,246168,99.27730,247960
3979,anirudhkm,1,0.00040,246169,99.27771,247960
3980,anitaokoh,1,0.00040,246170,99.27811,247960
3981,AnixPasBesoin,1,0.00040,246171,99.27851,247960
3982,AnkilP,1,0.00040,246172,99.27892,247960
3983,ankita4AI,1,0.00040,246173,99.27932,247960
3984,ankitaggarwal011,1,0.00040,246174,99.27972,247960
3985,AnkitRai-22,1,0.00040,246175,99.28013,247960
3986,ankitsingi,1,0.00040,246176,99.28053,247960
3987,Ankk98,1,0.00040,246177,99.28093,247960
3988,ankur6ue,1,0.00040,246178,99.28134,247960
3989,Anshuljh,1,0.00040,246179,99.28174,247960
3990,anskanwe,1,0.00040,246180,99.28214,247960
3991,Ans-pro,1,0.00040,246181,99.28255,247960
3992,answer3y,1,0.00040,246182,99.28295,247960
3993,anthonydillon,1,0.00040,246183,99.28335,247960
3994,anthonyvk,1,0.00040,246184,99.28376,247960
3995,antnsi,1,0.00040,246185,99.28416,247960
3996,anton-wundeman,1,0.00040,246186,99.28456,247960
3997,anupamag,1,0.00040,246187,99.28497,247960
3998,anyname2,1,0.00040,246188,99.28537,247960
3999,aoen,1,0.00040,246189,99.28577,247960
4000,aoliu95,1,0.00040,246190,99.28618,247960
4001,apc999,1,0.00040,246191,99.28658,247960
4002,apeccaud,1,0.00040,246192,99.28698,247960
4003,ApoorvaSuresh-Audi,1,0.00040,246193,99.28739,247960
4004,A-Pot,1,0.00040,246194,99.28779,247960
4005,AppleHolic,1,0.00040,246195,99.28819,247960
4006,Aqdashashmii,1,0.00040,246196,99.28859,247960
4007,Aravinviju,1,0.00040,246197,99.28900,247960
4008,archanainapudi,1,0.00040,246198,99.28940,247960
4009,areiner-novetta,1,0.00040,246199,99.28980,247960
4010,arkaitzj,1,0.00040,246200,99.29021,247960
4011,arpitsharma-hexad,1,0.00040,246201,99.29061,247960
4012,arshsidana98,1,0.00040,246202,99.29101,247960
4013,arturnn,1,0.00040,246203,99.29142,247960
4014,ArunRamakani,1,0.00040,246204,99.29182,247960
4015,arviCV,1,0.00040,246205,99.29222,247960
4016,arya-oss,1,0.00040,246206,99.29263,247960
4017,As20075,1,0.00040,246207,99.29303,247960
4018,asaff1,1,0.00040,246208,99.29343,247960
4019,ashishbhatnagar02,1,0.00040,246209,99.29384,247960
4020,ashishML,1,0.00040,246210,99.29424,247960
4021,AshutoshDongare,1,0.00040,246211,99.29464,247960
4022,ashvinmoro,1,0.00040,246212,99.29505,247960
4023,Ashwin-Ramesh2607,1,0.00040,246213,99.29545,247960
4024,asifdxtreme,1,0.00040,246214,99.29585,247960
4025,asiricml,1,0.00040,246215,99.29626,247960
4026,askaupup,1,0.00040,246216,99.29666,247960
4027,astanzys-vinted,1,0.00040,246217,99.29706,247960
4028,atch841,1,0.00040,246218,99.29747,247960
4029,atharva-18,1,0.00040,246219,99.29787,247960
4030,atrakriv,1,0.00040,246220,99.29827,247960
4031,Atreus-Technologies,1,0.00040,246221,99.29868,247960
4032,atsuik,1,0.00040,246222,99.29908,247960
4033,attackordie,1,0.00040,246223,99.29948,247960
4034,AtulKhomane,1,0.00040,246224,99.29989,247960
4035,atulyadavtech,1,0.00040,246225,99.30029,247960
4036,audriusrudalevicius,1,0.00040,246226,99.30069,247960
4037,augustogb,1,0.00040,246227,99.30110,247960
4038,authenticfake,1,0.00040,246228,99.30150,247960
4039,avanish-chaubey,1,0.00040,246229,99.30190,247960
4040,averagua,1,0.00040,246230,99.30231,247960
4041,a-vinod,1,0.00040,246231,99.30271,247960
4042,avintonOfficial,1,0.00040,246232,99.30311,247960
4043,avishniakov,1,0.00040,246233,99.30352,247960
4044,avizmil,1,0.00040,246234,99.30392,247960
4045,avloss,1,0.00040,246235,99.30432,247960
4046,AVShukshin,1,0.00040,246236,99.30473,247960
4047,awakia,1,0.00040,246237,99.30513,247960
4048,Axxxlllll,1,0.00040,246238,99.30553,247960
4049,ayoubelmimouni,1,0.00040,246239,99.30594,247960
4050,aytuns,1,0.00040,246240,99.30634,247960
4051,AzdinKab,1,0.00040,246241,99.30674,247960
4052,azelezni,1,0.00040,246242,99.30715,247960
4053,AzevedoB,1,0.00040,246243,99.30755,247960
4054,azuredevopsguy,1,0.00040,246244,99.30795,247960
4055,azurelysium,1,0.00040,246245,99.30836,247960
4056,b02202050,1,0.00040,246246,99.30876,247960
4057,babu-selector,1,0.00040,246247,99.30916,247960
4058,BabycolaYang,1,0.00040,246248,99.30957,247960
4059,backyes,1,0.00040,246249,99.30997,247960
4060,BACtaki,1,0.00040,246250,99.31037,247960
4061,BaisKasep012,1,0.00040,246251,99.31078,247960
4062,bajacondor,1,0.00040,246252,99.31118,247960
4063,bandi900811,1,0.00040,246253,99.31158,247960
4064,bandurin-strike,1,0.00040,246254,99.31199,247960
4065,bansal01yash,1,0.00040,246255,99.31239,247960
4066,Basirkhanofficial34,1,0.00040,246256,99.31279,247960
4067,bassel-z,1,0.00040,246257,99.31320,247960
4068,bassplay3r,1,0.00040,246258,99.31360,247960
4069,basti-j,1,0.00040,246259,99.31400,247960
4070,batigooal,1,0.00040,246260,99.31441,247960
4071,bauagonzo,1,0.00040,246261,99.31481,247960
4072,baxteran,1,0.00040,246262,99.31521,247960
4073,bd12,1,0.00040,246263,99.31562,247960
4074,Bear1110,1,0.00040,246264,99.31602,247960
4075,bellship24,1,0.00040,246265,99.31642,247960
4076,beltelml,1,0.00040,246266,99.31683,247960
4077,benbouillet,1,0.00040,246267,99.31723,247960
4078,benhamner,1,0.00040,246268,99.31763,247960
4079,benhyy,1,0.00040,246269,99.31804,247960
4080,benlaor38,1,0.00040,246270,99.31844,247960
4081,benmathes,1,0.00040,246271,99.31884,247960
4082,berglh,1,0.00040,246272,99.31925,247960
4083,bgossey,1,0.00040,246273,99.31965,247960
4084,bgpatel,1,0.00040,246274,99.32005,247960
4085,bharathkkb,1,0.00040,246275,99.32045,247960
4086,bigdatamlai,1,0.00040,246276,99.32086,247960
4087,bigdimple,1,0.00040,246277,99.32126,247960
4088,bimtauer,1,0.00040,246278,99.32166,247960
4089,bitcqs,1,0.00040,246279,99.32207,247960
4090,bix709,1,0.00040,246280,99.32247,247960
4091,bjones325,1,0.00040,246281,99.32287,247960
4092,blaisethom,1,0.00040,246282,99.32328,247960
4093,blancsw,1,0.00040,246283,99.32368,247960
4094,blazickjoe,1,0.00040,246284,99.32408,247960
4095,bligching512,1,0.00040,246285,99.32449,247960
4096,bmccord2,1,0.00040,246286,99.32489,247960
4097,bmorphism,1,0.00040,246287,99.32529,247960
4098,bmv3cg,1,0.00040,246288,99.32570,247960
4099,boczekbartek,1,0.00040,246289,99.32610,247960
4100,boersmamarcel,1,0.00040,246290,99.32650,247960
4101,BoHuang2018,1,0.00040,246291,99.32691,247960
4102,Boimkimi,1,0.00040,246292,99.32731,247960
4103,BonavincciAI2020,1,0.00040,246293,99.32771,247960
4104,Borda,1,0.00040,246294,99.32812,247960
4105,boriskovalev,1,0.00040,246295,99.32852,247960
4106,botasb,1,0.00040,246296,99.32892,247960
4107,botingw,1,0.00040,246297,99.32933,247960
4108,bottumjosh,1,0.00040,246298,99.32973,247960
4109,boufleur,1,0.00040,246299,99.33013,247960
4110,bpoti,1,0.00040,246300,99.33054,247960
4111,BrandonLiang,1,0.00040,246301,99.33094,247960
4112,brendangadd,1,0.00040,246302,99.33134,247960
4113,briandrutledge,1,0.00040,246303,99.33175,247960
4114,bricef,1,0.00040,246304,99.33215,247960
4115,brightlee6,1,0.00040,246305,99.33255,247960
4116,brilhana,1,0.00040,246306,99.33296,247960
4117,brt-timseries,1,0.00040,246307,99.33336,247960
4118,bruceche11,1,0.00040,246308,99.33376,247960
4119,bruceding,1,0.00040,246309,99.33417,247960
4120,BrunoChauvet,1,0.00040,246310,99.33457,247960
4121,bryant-rh,1,0.00040,246311,99.33497,247960
4122,bsingarayan,1,0.00040,246312,99.33538,247960
4123,Bud-ds,1,0.00040,246313,99.33578,247960
4124,buildlackey,1,0.00040,246314,99.33618,247960
4125,bumberboy,1,0.00040,246315,99.33659,247960
4126,burtenshaw,1,0.00040,246316,99.33699,247960
4127,bybatkhuu,1,0.00040,246317,99.33739,247960
4128,caijimin,1,0.00040,246318,99.33780,247960
4129,calvin11ung,1,0.00040,246319,99.33820,247960
4130,calvin-is-seksy,1,0.00040,246320,99.33860,247960
4131,camilamacedo86,1,0.00040,246321,99.33901,247960
4132,CandiedCode,1,0.00040,246322,99.33941,247960
4133,carlose2108,1,0.00040,246323,99.33981,247960
4134,carloVentrella,1,0.00040,246324,99.34022,247960
4135,caseware66,1,0.00040,246325,99.34062,247960
4136,casperyap,1,0.00040,246326,99.34102,247960
4137,Cass0n,1,0.00040,246327,99.34143,247960
4138,catblade,1,0.00040,246328,99.34183,247960
4139,cateto,1,0.00040,246329,99.34223,247960
4140,cbbba18,1,0.00040,246330,99.34264,247960
4141,cbchouinard,1,0.00040,246331,99.34304,247960
4142,cblecker,1,0.00040,246332,99.34344,247960
4143,ccastro-pedro,1,0.00040,246333,99.34385,247960
4144,ccdefreitas,1,0.00040,246334,99.34425,247960
4145,cenkbircanoglu,1,0.00040,246335,99.34465,247960
4146,cestum,1,0.00040,246336,99.34506,247960
4147,cf-chiang,1,0.00040,246337,99.34546,247960
4148,cfloressuazo,1,0.00040,246338,99.34586,247960
4149,cgawron1,1,0.00040,246339,99.34627,247960
4150,chadg818,1,0.00040,246340,99.34667,247960
4151,chajath,1,0.00040,246341,99.34707,247960
4152,championjared,1,0.00040,246342,99.34748,247960
4153,chandukotagiri1992,1,0.00040,246343,99.34788,247960
4154,chandurreddy91,1,0.00040,246344,99.34828,247960
4155,changchuming,1,0.00040,246345,99.34869,247960
4156,changhoekim,1,0.00040,246346,99.34909,247960
4157,changqing,1,0.00040,246347,99.34949,247960
4158,chanhz,1,0.00040,246348,99.34990,247960
4159,chardch,1,0.00040,246349,99.35030,247960
4160,charlesccychen,1,0.00040,246350,99.35070,247960
4161,charlieyang1557,1,0.00040,246351,99.35111,247960
4162,chboudry,1,0.00040,246352,99.35151,247960
4163,cheesev,1,0.00040,246353,99.35191,247960
4164,chelomontilla,1,0.00040,246354,99.35231,247960
4165,chengleqi,1,0.00040,246355,99.35272,247960
4166,chengsky-NTU,1,0.00040,246356,99.35312,247960
4167,chenjr0719,1,0.00040,246357,99.35352,247960
4168,chenwenyan,1,0.00040,246358,99.35393,247960
4169,cheny-alf,1,0.00040,246359,99.35433,247960
4170,chenyuzhi459,1,0.00040,246360,99.35473,247960
4171,chepkoyallan,1,0.00040,246361,99.35514,247960
4172,cheungringo,1,0.00040,246362,99.35554,247960
4173,chinaboy007,1,0.00040,246363,99.35594,247960
4174,chitravsnair,1,0.00040,246364,99.35635,247960
4175,chmielas,1,0.00040,246365,99.35675,247960
4176,chongkong,1,0.00040,246366,99.35715,247960
4177,chongwangcc,1,0.00040,246367,99.35756,247960
4178,chrisalbon,1,0.00040,246368,99.35796,247960
4179,chrishmorris,1,0.00040,246369,99.35836,247960
4180,chrisrana,1,0.00040,246370,99.35877,247960
4181,chris-sanders,1,0.00040,246371,99.35917,247960
4182,Christian-Jansen,1,0.00040,246372,99.35957,247960
4183,Christina-Young,1,0.00040,246373,99.35998,247960
4184,chris-zen,1,0.00040,246374,99.36038,247960
4185,chunfengzhao1,1,0.00040,246375,99.36078,247960
4186,chunjieChang,1,0.00040,246376,99.36119,247960
4187,Ciro-Taranto,1,0.00040,246377,99.36159,247960
4188,ciscoai-prowbot,1,0.00040,246378,99.36199,247960
4189,cjjain813,1,0.00040,246379,99.36240,247960
4190,closerforever,1,0.00040,246380,99.36280,247960
4191,cmhkjuwan,1,0.00040,246381,99.36320,247960
4192,cmontemuino,1,0.00040,246382,99.36361,247960
4193,cn007b,1,0.00040,246383,99.36401,247960
4194,cnegron-nv,1,0.00040,246384,99.36441,247960
4195,coalindiax,1,0.00040,246385,99.36482,247960
4196,codebeard1,1,0.00040,246386,99.36522,247960
4197,codebreach,1,0.00040,246387,99.36562,247960
4198,CodeLingoTeam,1,0.00040,246388,99.36603,247960
4199,coldtomatojuice,1,0.00040,246389,99.36643,247960
4200,colinfindlay-nz,1,0.00040,246390,99.36683,247960
4201,Collinbrown95,1,0.00040,246391,99.36724,247960
4202,colmantse,1,0.00040,246392,99.36764,247960
4203,ColmBhandal,1,0.00040,246393,99.36804,247960
4204,conchitagoogle,1,0.00040,246394,99.36845,247960
4205,ConnorDoyle,1,0.00040,246395,99.36885,247960
4206,connor-swanson,1,0.00040,246396,99.36925,247960
4207,cottrell,1,0.00040,246397,99.36966,247960
4208,cpcgoogle,1,0.00040,246398,99.37006,247960
4209,Cplo,1,0.00040,246399,99.37046,247960
4210,cquptEthan,1,0.00040,246400,99.37087,247960
4211,CR1SceNT,1,0.00040,246401,99.37127,247960
4212,craigjmidwinter,1,0.00040,246402,99.37167,247960
4213,creddy123,1,0.00040,246403,99.37208,247960
4214,cristifalcas,1,0.00040,246404,99.37248,247960
4215,cromagnonninja,1,0.00040,246405,99.37288,247960
4216,crsawyer314,1,0.00040,246406,99.37329,247960
4217,crwilcox,1,0.00040,246407,99.37369,247960
4218,CSberger,1,0.00040,246408,99.37409,247960
4219,cschieberle,1,0.00040,246409,99.37450,247960
4220,cslovell,1,0.00040,246410,99.37490,247960
4221,CSP197,1,0.00040,246411,99.37530,247960
4222,cutiechi,1,0.00040,246412,99.37571,247960
4223,cutlass90,1,0.00040,246413,99.37611,247960
4224,cwdsuzhou,1,0.00040,246414,99.37651,247960
4225,cwu24,1,0.00040,246415,99.37692,247960
4226,cy89,1,0.00040,246416,99.37732,247960
4227,CybervisionVolodymyrPogorelov,1,0.00040,246417,99.37772,247960
4228,cyliu0204,1,0.00040,246418,99.37813,247960
4229,cymarechal-devoteam,1,0.00040,246419,99.37853,247960
4230,cyniczhi,1,0.00040,246420,99.37893,247960
4231,cyprnose,1,0.00040,246421,99.37934,247960
4232,cyrano5614,1,0.00040,246422,99.37974,247960
4233,czz2018,1,0.00040,246423,99.38014,247960
4234,daanyalmalik,1,0.00040,246424,99.38055,247960
4235,daenuprobst,1,0.00040,246425,99.38095,247960
4236,daftping,1,0.00040,246426,99.38135,247960
4237,dagilgon,1,0.00040,246427,99.38176,247960
4238,dailong,1,0.00040,246428,99.38216,247960
4239,DaleSin,1,0.00040,246429,99.38256,247960
4240,dalvarezsmiet,1,0.00040,246430,99.38296,247960
4241,damien75,1,0.00040,246431,99.38337,247960
4242,damngamerz,1,0.00040,246432,99.38377,247960
4243,danasaur,1,0.00040,246433,99.38417,247960
4244,DanCech,1,0.00040,246434,99.38458,247960
4245,daniel985,1,0.00040,246435,99.38498,247960
4246,daniel-bejarano,1,0.00040,246436,99.38538,247960
4247,danielbraun89,1,0.00040,246437,99.38579,247960
4248,danielecordano,1,0.00040,246438,99.38619,247960
4249,danielmhair,1,0.00040,246439,99.38659,247960
4250,danielnorberg,1,0.00040,246440,99.38700,247960
4251,DanielSCon40,1,0.00040,246441,99.38740,247960
4252,danrzs,1,0.00040,246442,99.38780,247960
4253,danvaida,1,0.00040,246443,99.38821,247960
4254,darack1234,1,0.00040,246444,99.38861,247960
4255,darthkabelo,1,0.00040,246445,99.38901,247960
4256,datafuel,1,0.00040,246446,99.38942,247960
4257,data-infra,1,0.00040,246447,99.38982,247960
4258,datasciencedani,1,0.00040,246448,99.39022,247960
4259,davidawad,1,0.00040,246449,99.39063,247960
4260,davidbellemare,1,0.00040,246450,99.39103,247960
4261,David-Bess,1,0.00040,246451,99.39143,247960
4262,David-LiCause,1,0.00040,246452,99.39184,247960
4263,davidparks21,1,0.00040,246453,99.39224,247960
4264,dbuades,1,0.00040,246454,99.39264,247960
4265,debmalya4,1,0.00040,246455,99.39305,247960
4266,deeco,1,0.00040,246456,99.39345,247960
4267,deepakpate07,1,0.00040,246457,99.39385,247960
4268,DeepFlame-JR,1,0.00040,246458,99.39426,247960
4269,deepika-cpml,1,0.00040,246459,99.39466,247960
4270,DeepTalk19,1,0.00040,246460,99.39506,247960
4271,deinal,1,0.00040,246461,99.39547,247960
4272,dellelce,1,0.00040,246462,99.39587,247960
4273,denfromufa,1,0.00040,246463,99.39627,247960
4274,dengpanyin,1,0.00040,246464,99.39668,247960
4275,denispeyrusaubes,1,0.00040,246465,99.39708,247960
4276,denisvorotyntsevunity,1,0.00040,246466,99.39748,247960
4277,dennisTGC,1,0.00040,246467,99.39789,247960
4278,derenrich,1,0.00040,246468,99.39829,247960
4279,Deseram,1,0.00040,246469,99.39869,247960
4280,devilmetal,1,0.00040,246470,99.39910,247960
4281,devlp121,1,0.00040,246471,99.39950,247960
4282,devrivne,1,0.00040,246472,99.39990,247960
4283,deyuhua,1,0.00040,246473,99.40031,247960
4284,dfeldell,1,0.00040,246474,99.40071,247960
4285,dfisk,1,0.00040,246475,99.40111,247960
4286,dg424,1,0.00040,246476,99.40152,247960
4287,dgrahn,1,0.00040,246477,99.40192,247960
4288,DhanunjayElluri,1,0.00040,246478,99.40232,247960
4289,dhfromkorea,1,0.00040,246479,99.40273,247960
4290,dhirschfeld,1,0.00040,246480,99.40313,247960
4291,dholmesreed,1,0.00040,246481,99.40353,247960
4292,dhruvilmehta,1,0.00040,246482,99.40394,247960
4293,dhruvpratapsingh,1,0.00040,246483,99.40434,247960
4294,Dhull442,1,0.00040,246484,99.40474,247960
4295,dianeo-mit,1,0.00040,246485,99.40515,247960
4296,Dibel,1,0.00040,246486,99.40555,247960
4297,didier-durand,1,0.00040,246487,99.40595,247960
4298,diegolovison,1,0.00040,246488,99.40636,247960
4299,dirtyValera,1,0.00040,246489,99.40676,247960
4300,dithyrambe,1,0.00040,246490,99.40716,247960
4301,divjyotsinghanzx,1,0.00040,246491,99.40757,247960
4302,divyank000,1,0.00040,246492,99.40797,247960
4303,divyaprabha123,1,0.00040,246493,99.40837,247960
4304,divya-r-kamat,1,0.00040,246494,99.40878,247960
4305,Djmcflush,1,0.00040,246495,99.40918,247960
4306,djmcgreal,1,0.00040,246496,99.40958,247960
4307,djmcgreal-cc,1,0.00040,246497,99.40999,247960
4308,dkmiller,1,0.00040,246498,99.41039,247960
4309,dkowsley,1,0.00040,246499,99.41079,247960
4310,dlkaai,1,0.00040,246500,99.41120,247960
4311,dmerz75,1,0.00040,246501,99.41160,247960
4312,dmonson,1,0.00040,246502,99.41200,247960
4313,dmytro212,1,0.00040,246503,99.41241,247960
4314,dobrinsky,1,0.00040,246504,99.41281,247960
4315,dodizzle,1,0.00040,246505,99.41321,247960
4316,dojoeisuke,1,0.00040,246506,99.41362,247960
4317,DomenicoCostantino,1,0.00040,246507,99.41402,247960
4318,dommgifer,1,0.00040,246508,99.41442,247960
4319,dongzaimatou,1,0.00040,246509,99.41482,247960
4320,donnyv12,1,0.00040,246510,99.41523,247960
4321,dontmint,1,0.00040,246511,99.41563,247960
4322,DontWorry33,1,0.00040,246512,99.41603,247960
4323,dotnetpiper,1,0.00040,246513,99.41644,247960
4324,dping1,1,0.00040,246514,99.41684,247960
4325,dprotaso,1,0.00040,246515,99.41724,247960
4326,dragonofac,1,0.00040,246516,99.41765,247960
4327,dragonsongohan,1,0.00040,246517,99.41805,247960
4328,drsagitn,1,0.00040,246518,99.41845,247960
4329,drzl386,1,0.00040,246519,99.41886,247960
4330,dss77,1,0.00040,246520,99.41926,247960
4331,dt21e8,1,0.00040,246521,99.41966,247960
4332,dublincrow2020,1,0.00040,246522,99.42007,247960
4333,ducminhnguyen,1,0.00040,246523,99.42047,247960
4334,dumbjarvis,1,0.00040,246524,99.42087,247960
4335,Duske,1,0.00040,246525,99.42128,247960
4336,dvgopal,1,0.00040,246526,99.42168,247960
4337,dwhdai,1,0.00040,246527,99.42208,247960
4338,dwojcik92,1,0.00040,246528,99.42249,247960
4339,dwu926,1,0.00040,246529,99.42289,247960
4340,EALAAKH,1,0.00040,246530,99.42329,247960
4341,easadler,1,0.00040,246531,99.42370,247960
4342,easkerov,1,0.00040,246532,99.42410,247960
4343,echorocket,1,0.00040,246533,99.42450,247960
4344,edacostacambioupgrade,1,0.00040,246534,99.42491,247960
4345,edday1,1,0.00040,246535,99.42531,247960
4346,eddynelson,1,0.00040,246536,99.42571,247960
4347,edikmkoyan,1,0.00040,246537,99.42612,247960
4348,edmeister,1,0.00040,246538,99.42652,247960
4349,eduardchai,1,0.00040,246539,99.42692,247960
4350,EduardFazliev,1,0.00040,246540,99.42733,247960
4351,eduardovelludo,1,0.00040,246541,99.42773,247960
4352,edusporto,1,0.00040,246542,99.42813,247960
4353,edwardfung123,1,0.00040,246543,99.42854,247960
4354,edwardhuanghz,1,0.00040,246544,99.42894,247960
4355,edwardspc,1,0.00040,246545,99.42934,247960
4356,egkiastas,1,0.00040,246546,99.42975,247960
4357,ehborisov,1,0.00040,246547,99.43015,247960
4358,ehudyonasi,1,0.00040,246548,99.43055,247960
4359,elamaran11,1,0.00040,246549,99.43096,247960
4360,elanv,1,0.00040,246550,99.43136,247960
4361,elegendre3,1,0.00040,246551,99.43176,247960
4362,eliaslevy,1,0.00040,246552,99.43217,247960
4363,ElijahMingLiu,1,0.00040,246553,99.43257,247960
4364,elilienstein,1,0.00040,246554,99.43297,247960
4365,elizgarcia5,1,0.00040,246555,99.43338,247960
4366,elsud,1,0.00040,246556,99.43378,247960
4367,eltociear,1,0.00040,246557,99.43418,247960
4368,elvinzhusiyu,1,0.00040,246558,99.43459,247960
4369,Ema93sh,1,0.00040,246559,99.43499,247960
4370,EMCP,1,0.00040,246560,99.43539,247960
4371,emilecaron,1,0.00040,246561,99.43580,247960
4372,emilyyujieli,1,0.00040,246562,99.43620,247960
4373,em-pe,1,0.00040,246563,99.43660,247960
4374,EnasBasset,1,0.00040,246564,99.43701,247960
4375,endurancetest20380119,1,0.00040,246565,99.43741,247960
4376,engineeryashsaxena,1,0.00040,246566,99.43781,247960
4377,enisoc,1,0.00040,246567,99.43822,247960
4378,entrpn,1,0.00040,246568,99.43862,247960
4379,erik78se,1,0.00040,246569,99.43902,247960
4380,eriklincoln,1,0.00040,246570,99.43943,247960
4381,Erikzzz,1,0.00040,246571,99.43983,247960
4382,Erin-Servian,1,0.00040,246572,99.44023,247960
4383,esantix,1,0.00040,246573,99.44064,247960
4384,eslerm,1,0.00040,246574,99.44104,247960
4385,estelleaf,1,0.00040,246575,99.44144,247960
4386,estrellafelipe,1,0.00040,246576,99.44185,247960
4387,ethanscho,1,0.00040,246577,99.44225,247960
4388,ethanyanjiali,1,0.00040,246578,99.44265,247960
4389,eugenebnd,1,0.00040,246579,99.44306,247960
4390,eumentis-pawan,1,0.00040,246580,99.44346,247960
4391,eunjilee,1,0.00040,246581,99.44386,247960
4392,evan9637,1,0.00040,246582,99.44427,247960
4393,evandekieft,1,0.00040,246583,99.44467,247960
4394,evankanderson,1,0.00040,246584,99.44507,247960
4395,ever1022,1,0.00040,246585,99.44548,247960
4396,everettvody,1,0.00040,246586,99.44588,247960
4397,ewasserman,1,0.00040,246587,99.44628,247960
4398,Excelight,1,0.00040,246588,99.44668,247960
4399,F36,1,0.00040,246589,99.44709,247960
4400,fafa92,1,0.00040,246590,99.44749,247960
4401,fahdrazavi,1,0.00040,246591,99.44789,247960
4402,fajaryanw,1,0.00040,246592,99.44830,247960
4403,Fan-SJ,1,0.00040,246593,99.44870,247960
4404,fanzhe328,1,0.00040,246594,99.44910,247960
4405,FarshadMovahed-REISys,1,0.00040,246595,99.44951,247960
4406,FatalLin,1,0.00040,246596,99.44991,247960
4407,fatihkorhan,1,0.00040,246597,99.45031,247960
4408,fatkun,1,0.00040,246598,99.45072,247960
4409,fbraza,1,0.00040,246599,99.45112,247960
4410,fedeesku,1,0.00040,246600,99.45152,247960
4411,felix-exel,1,0.00040,246601,99.45193,247960
4412,FelixGruener,1,0.00040,246602,99.45233,247960
4413,FellowNico,1,0.00040,246603,99.45273,247960
4414,fenghejingchi,1,0.00040,246604,99.45314,247960
4415,fengpinghu,1,0.00040,246605,99.45354,247960
4416,ferenc-hechler,1,0.00040,246606,99.45394,247960
4417,fhirschmann,1,0.00040,246607,99.45435,247960
4418,filipe-cantarelli,1,0.00040,246608,99.45475,247960
4419,finallyRaunak,1,0.00040,246609,99.45515,247960
4420,fireproofsocks,1,0.00040,246610,99.45556,247960
4421,FishJoey,1,0.00040,246611,99.45596,247960
4422,flacombe,1,0.00040,246612,99.45636,247960
4423,fojtami1,1,0.00040,246613,99.45677,247960
4424,fooozhe,1,0.00040,246614,99.45717,247960
4425,francisfuzz,1,0.00040,246615,99.45757,247960
4426,francoisserra,1,0.00040,246616,99.45798,247960
4427,FranCorsini,1,0.00040,246617,99.45838,247960
4428,Franky12,1,0.00040,246618,99.45878,247960
4429,frederikfab,1,0.00040,246619,99.45919,247960
4430,Freezaa9,1,0.00040,246620,99.45959,247960
4431,frezbo,1,0.00040,246621,99.45999,247960
4432,fryzhykau,1,0.00040,246622,99.46040,247960
4433,FullDataAlchemist,1,0.00040,246623,99.46080,247960
4434,fullprocess,1,0.00040,246624,99.46120,247960
4435,futeng,1,0.00040,246625,99.46161,247960
4436,futurexskill,1,0.00040,246626,99.46201,247960
4437,Fvegini,1,0.00040,246627,99.46241,247960
4438,fzhurd,1,0.00040,246628,99.46282,247960
4439,gabrielgcbs,1,0.00040,246629,99.46322,247960
4440,gabriellemadden,1,0.00040,246630,99.46362,247960
4441,gabrielmbmb,1,0.00040,246631,99.46403,247960
4442,Gajendran27,1,0.00040,246632,99.46443,247960
4443,galebm1004,1,0.00040,246633,99.46483,247960
4444,GaneshHulyal,1,0.00040,246634,99.46524,247960
4445,GarethLewin,1,0.00040,246635,99.46564,247960
4446,gauravpawar13,1,0.00040,246636,99.46604,247960
4447,GayatriNair229,1,0.00040,246637,99.46645,247960
4448,GDegrove,1,0.00040,246638,99.46685,247960
4449,geier,1,0.00040,246639,99.46725,247960
4450,Gekho457,1,0.00040,246640,99.46766,247960
4451,geooff,1,0.00040,246641,99.46806,247960
4452,GeorgeGeng,1,0.00040,246642,99.46846,247960
4453,geota,1,0.00040,246643,99.46887,247960
4454,get2prab,1,0.00040,246644,99.46927,247960
4455,GezimSejdiu,1,0.00040,246645,99.46967,247960
4456,GG-yuki,1,0.00040,246646,99.47008,247960
4457,giladwa1,1,0.00040,246647,99.47048,247960
4458,GilGonong,1,0.00040,246648,99.47088,247960
4459,githubwua,1,0.00040,246649,99.47129,247960
4460,GiuliaMassimetti,1,0.00040,246650,99.47169,247960
4461,Glorf,1,0.00040,246651,99.47209,247960
4462,glotzerhotze,1,0.00040,246652,99.47250,247960
4463,gmatev,1,0.00040,246653,99.47290,247960
4464,gmjonker,1,0.00040,246654,99.47330,247960
4465,gniewus,1,0.00040,246655,99.47371,247960
4466,gnsantos,1,0.00040,246656,99.47411,247960
4467,goanto,1,0.00040,246657,99.47451,247960
4468,gokhancetinkaya,1,0.00040,246658,99.47492,247960
4469,goldenberg,1,0.00040,246659,99.47532,247960
4470,goloxxly,1,0.00040,246660,99.47572,247960
4471,gooddayforever,1,0.00040,246661,99.47613,247960
4472,gorinars,1,0.00040,246662,99.47653,247960
4473,gpfvic,1,0.00040,246663,99.47693,247960
4474,gpoulin-hopper,1,0.00040,246664,99.47734,247960
4475,greg-liner,1,0.00040,246665,99.47774,247960
4476,gringParis,1,0.00040,246666,99.47814,247960
4477,grmoktan,1,0.00040,246667,99.47854,247960
4478,Gross613,1,0.00040,246668,99.47895,247960
4479,gs-sam,1,0.00040,246669,99.47935,247960
4480,gstoner,1,0.00040,246670,99.47975,247960
4481,gtoullier,1,0.00040,246671,99.48016,247960
4482,guanghui0607,1,0.00040,246672,99.48056,247960
4483,guilhem,1,0.00040,246673,99.48096,247960
4484,guo897654050,1,0.00040,246674,99.48137,247960
4485,gyant,1,0.00040,246675,99.48177,247960
4486,h4gen,1,0.00040,246676,99.48217,247960
4487,habmat,1,0.00040,246677,99.48258,247960
4488,hacktmz,1,0.00040,246678,99.48298,247960
4489,hade94,1,0.00040,246679,99.48338,247960
4490,haifeng-jin,1,0.00040,246680,99.48379,247960
4491,haim-co-moonactive,1,0.00040,246681,99.48419,247960
4492,hakimliang,1,0.00040,246682,99.48459,247960
4493,halegreen,1,0.00040,246683,99.48500,247960
4494,HaloKim,1,0.00040,246684,99.48540,247960
4495,Hamidmsa,1,0.00040,246685,99.48580,247960
4496,hamko,1,0.00040,246686,99.48621,247960
4497,hanakawamomo,1,0.00040,246687,99.48661,247960
4498,hancelpv,1,0.00040,246688,99.48701,247960
4499,hank6086,1,0.00040,246689,99.48742,247960
4500,hannibalhuang,1,0.00040,246690,99.48782,247960
4501,haohao667788,1,0.00040,246691,99.48822,247960
4502,HaoWangDL,1,0.00040,246692,99.48863,247960
4503,HarborZeng,1,0.00040,246693,99.48903,247960
4504,harchali,1,0.00040,246694,99.48943,247960
4505,haresh-chudgar,1,0.00040,246695,99.48984,247960
4506,HarryCaveMan,1,0.00040,246696,99.49024,247960
4507,harryliu123,1,0.00040,246697,99.49064,247960
4508,harshalkwagh,1,0.00040,246698,99.49105,247960
4509,harshalmittal4,1,0.00040,246699,99.49145,247960
4510,HassaanAkbar,1,0.00040,246700,99.49185,247960
4511,hassanzia32,1,0.00040,246701,99.49226,247960
4512,hayato-maki,1,0.00040,246702,99.49266,247960
4513,Hayyk,1,0.00040,246703,99.49306,247960
4514,hbarrington,1,0.00040,246704,99.49347,247960
4515,Hedingber,1,0.00040,246705,99.49387,247960
4516,hejiahuan1412,1,0.00040,246706,99.49427,247960
4517,HelenCousins,1,0.00040,246707,99.49468,247960
4518,helkhalfi,1,0.00040,246708,99.49508,247960
4519,Hellekin87,1,0.00040,246709,99.49548,247960
4520,helloxjade,1,0.00040,246710,99.49589,247960
4521,hemildesai,1,0.00040,246711,99.49629,247960
4522,heoelri,1,0.00040,246712,99.49669,247960
4523,heqinw,1,0.00040,246713,99.49710,247960
4524,hexerei,1,0.00040,246714,99.49750,247960
4525,heyawhite,1,0.00040,246715,99.49790,247960
4526,hfurkanvural,1,0.00040,246716,99.49831,247960
4527,hienqnguyen,1,0.00040,246717,99.49871,247960
4528,HilbertSpecs,1,0.00040,246718,99.49911,247960
4529,himanshu238,1,0.00040,246719,99.49952,247960
4530,Hirosora,1,0.00040,246720,99.49992,247960
4531,hiyangbo,1,0.00040,246721,99.50032,247960
4532,hjyoite,1,0.00040,246722,99.50073,247960
4533,hlld3344,1,0.00040,246723,99.50113,247960
4534,hmdsatoshi,1,0.00040,246724,99.50153,247960
4535,hnakagawa,1,0.00040,246725,99.50194,247960
4536,hollyhutson,1,0.00040,246726,99.50234,247960
4537,hongzhao-signifyd,1,0.00040,246727,99.50274,247960
4538,horatiu-negutoiu,1,0.00040,246728,99.50315,247960
4539,Houyon,1,0.00040,246729,99.50355,247960
4540,howardjohn,1,0.00040,246730,99.50395,247960
4541,hpspringboy,1,0.00040,246731,99.50436,247960
4542,hridyeshpant,1,0.00040,246732,99.50476,247960
4543,Hrishkesh,1,0.00040,246733,99.50516,247960
4544,hsteude,1,0.00040,246734,99.50557,247960
4545,huangjiasingle,1,0.00040,246735,99.50597,247960
4546,hubchub,1,0.00040,246736,99.50637,247960
4547,hubertg1122,1,0.00040,246737,99.50678,247960
4548,hubrix,1,0.00040,246738,99.50718,247960
4549,hughmiao,1,0.00040,246739,99.50758,247960
4550,hugovk,1,0.00040,246740,99.50799,247960
4551,huihuang2015,1,0.00040,246741,99.50839,247960
4552,humantargetjoe,1,0.00040,246742,99.50879,247960
4553,hungrysushi,1,0.00040,246743,99.50920,247960
4554,HunterEl,1,0.00040,246744,99.50960,247960
4555,hydeta,1,0.00040,246745,99.51000,247960
4556,hylick,1,0.00040,246746,99.51040,247960
4557,hyoseon-agile,1,0.00040,246747,99.51081,247960
4558,hzy001,1,0.00040,246748,99.51121,247960
4559,ianmaddox,1,0.00040,246749,99.51161,247960
4560,iant04128591,1,0.00040,246750,99.51202,247960
4561,ianycxu,1,0.00040,246751,99.51242,247960
4562,iassenegal221,1,0.00040,246752,99.51282,247960
4563,ibnummuhammad,1,0.00040,246753,99.51323,247960
4564,ICDS-Offering,1,0.00040,246754,99.51363,247960
4565,ichbinjakes,1,0.00040,246755,99.51403,247960
4566,ido-trumer,1,0.00040,246756,99.51444,247960
4567,ifs-imaddjelaili,1,0.00040,246757,99.51484,247960
4568,iftachsc,1,0.00040,246758,99.51524,247960
4569,igmik,1,0.00040,246759,99.51565,247960
4570,igorvalko,1,0.00040,246760,99.51605,247960
4571,IgorZan,1,0.00040,246761,99.51645,247960
4572,ilaria-speranza,1,0.00040,246762,99.51686,247960
4573,ilkelma,1,0.00040,246763,99.51726,247960
4574,ILLUM1N0X,1,0.00040,246764,99.51766,247960
4575,ilyinon,1,0.00040,246765,99.51807,247960
4576,imamika,1,0.00040,246766,99.51847,247960
4577,imantha-a,1,0.00040,246767,99.51887,247960
4578,imilos,1,0.00040,246768,99.51928,247960
4579,imnotaqtpie,1,0.00040,246769,99.51968,247960
4580,impravin22,1,0.00040,246770,99.52008,247960
4581,imrehg,1,0.00040,246771,99.52049,247960
4582,imsazzad,1,0.00040,246772,99.52089,247960
4583,Imsurajkr,1,0.00040,246773,99.52129,247960
4584,InsertCoolNameHere,1,0.00040,246774,99.52170,247960
4585,inspurasc,1,0.00040,246775,99.52210,247960
4586,ipal0,1,0.00040,246776,99.52250,247960
4587,irabinovitch,1,0.00040,246777,99.52291,247960
4588,is185089,1,0.00040,246778,99.52331,247960
4589,Isaacwhyuenac,1,0.00040,246779,99.52371,247960
4590,itmwiw,1,0.00040,246780,99.52412,247960
4591,itshevtsov,1,0.00040,246781,99.52452,247960
4592,itsymbol,1,0.00040,246782,99.52492,247960
4593,IvySong2016,1,0.00040,246783,99.52533,247960
4594,izhaomeng,1,0.00040,246784,99.52573,247960
4595,j0hnL,1,0.00040,246785,99.52613,247960
4596,jackhawa,1,0.00040,246786,99.52654,247960
4597,jackhuang007,1,0.00040,246787,99.52694,247960
4598,jackielyc,1,0.00040,246788,99.52734,247960
4599,jackskj,1,0.00040,246789,99.52775,247960
4600,jackychow,1,0.00040,246790,99.52815,247960
4601,jackyin68,1,0.00040,246791,99.52855,247960
4602,jacquev6,1,0.00040,246792,99.52896,247960
4603,jaejuning,1,0.00040,246793,99.52936,247960
4604,jagan120,1,0.00040,246794,99.52976,247960
4605,jagusztinl,1,0.00040,246795,99.53017,247960
4606,jai,1,0.00040,246796,99.53057,247960
4607,jaKjH101,1,0.00040,246797,99.53097,247960
4608,jamesdhope,1,0.00040,246798,99.53138,247960
4609,jamylak,1,0.00040,246799,99.53178,247960
4610,jarednielsen,1,0.00040,246800,99.53218,247960
4611,jariolehtonen,1,0.00040,246801,99.53259,247960
4612,jart,1,0.00040,246802,99.53299,247960
4613,JasonChen86899,1,0.00040,246803,99.53339,247960
4614,jasongrout,1,0.00040,246804,99.53380,247960
4615,JasonLee925,1,0.00040,246805,99.53420,247960
4616,JasonTam,1,0.00040,246806,99.53460,247960
4617,jay-manday,1,0.00040,246807,99.53501,247960
4618,jaypipes,1,0.00040,246808,99.53541,247960
4619,jberkus,1,0.00040,246809,99.53581,247960
4620,jbx,1,0.00040,246810,99.53622,247960
4621,jchaudari,1,0.00040,246811,99.53662,247960
4622,jchavezar,1,0.00040,246812,99.53702,247960
4623,jckwon,1,0.00040,246813,99.53743,247960
4624,jdstrand,1,0.00040,246814,99.53783,247960
4625,jenoOvchi,1,0.00040,246815,99.53823,247960
4626,Jenya95,1,0.00040,246816,99.53864,247960
4627,jeremiahkellick,1,0.00040,246817,99.53904,247960
4628,JeremyKeusters,1,0.00040,246818,99.53944,247960
4629,jerriezhou,1,0.00040,246819,99.53985,247960
4630,jerrygb,1,0.00040,246820,99.54025,247960
4631,jessehu,1,0.00040,246821,99.54065,247960
4632,jetmuffin,1,0.00040,246822,99.54106,247960
4633,jfantell,1,0.00040,246823,99.54146,247960
4634,jgerardsimcock,1,0.00040,246824,99.54186,247960
4635,jgiannuzzi,1,0.00040,246825,99.54226,247960
4636,JGoo1,1,0.00040,246826,99.54267,247960
4637,jgoodman8,1,0.00040,246827,99.54307,247960
4638,jhdxr,1,0.00040,246828,99.54347,247960
4639,jhisse,1,0.00040,246829,99.54388,247960
4640,jhkcia,1,0.00040,246830,99.54428,247960
4641,jhtobigs,1,0.00040,246831,99.54468,247960
4642,jianwu-github,1,0.00040,246832,99.54509,247960
4643,JiaxuanYang,1,0.00040,246833,99.54549,247960
4644,jie8357IOII,1,0.00040,246834,99.54589,247960
4645,JIElite,1,0.00040,246835,99.54630,247960
4646,jieunchoi1120,1,0.00040,246836,99.54670,247960
4647,jimmyguerrero,1,0.00040,246837,99.54710,247960
4648,jingong2105,1,0.00040,246838,99.54751,247960
4649,jinoobaek-qz,1,0.00040,246839,99.54791,247960
4650,jintojose72,1,0.00040,246840,99.54831,247960
4651,jiuchen1986,1,0.00040,246841,99.54872,247960
4652,jj-794,1,0.00040,246842,99.54912,247960
4653,jjhursey,1,0.00040,246843,99.54952,247960
4654,jkeen871,1,0.00040,246844,99.54993,247960
4655,jkl0898,1,0.00040,246845,99.55033,247960
4656,jkwak3,1,0.00040,246846,99.55073,247960
4657,jlu1202,1,0.00040,246847,99.55114,247960
4658,jlzhang93,1,0.00040,246848,99.55154,247960
4659,jmreicha,1,0.00040,246849,99.55194,247960
4660,jmurphs14,1,0.00040,246850,99.55235,247960
4661,jocelynbaduria,1,0.00040,246851,99.55275,247960
4662,jocieA,1,0.00040,246852,99.55315,247960
4663,jodavis-suse,1,0.00040,246853,99.55356,247960
4664,Jodo-skywalker,1,0.00040,246854,99.55396,247960
4665,joeatlas007,1,0.00040,246855,99.55436,247960
4666,joemal1234,1,0.00040,246856,99.55477,247960
4667,joerg84,1,0.00040,246857,99.55517,247960
4668,joeyaza,1,0.00040,246858,99.55557,247960
4669,JohnMBrandt,1,0.00040,246859,99.55598,247960
4670,John-Tate,1,0.00040,246860,99.55638,247960
4671,johnzhou2011,1,0.00040,246861,99.55678,247960
4672,joinalahmed,1,0.00040,246862,99.55719,247960
4673,jojomomo88754,1,0.00040,246863,99.55759,247960
4674,jonashartwig,1,0.00040,246864,99.55799,247960
4675,JonasTischer,1,0.00040,246865,99.55840,247960
4676,jonathan1920,1,0.00040,246866,99.55880,247960
4677,jonathan-bendov,1,0.00040,246867,99.55920,247960
4678,joncwong,1,0.00040,246868,99.55961,247960
4679,jondoering,1,0.00040,246869,99.56001,247960
4680,joneepenk,1,0.00040,246870,99.56041,247960
4681,jonf78,1,0.00040,246871,99.56082,247960
4682,Joon-L,1,0.00040,246872,99.56122,247960
4683,joostgp,1,0.00040,246873,99.56162,247960
4684,Joostrothweiler,1,0.00040,246874,99.56203,247960
4685,jordyantunes,1,0.00040,246875,99.56243,247960
4686,jorge07,1,0.00040,246876,99.56283,247960
4687,josepalafox,1,0.00040,246877,99.56324,247960
4688,journey-wang,1,0.00040,246878,99.56364,247960
4689,jpetazzo,1,0.00040,246879,99.56404,247960
4690,jppgks,1,0.00040,246880,99.56445,247960
4691,jpweber,1,0.00040,246881,99.56485,247960
4692,jramos,1,0.00040,246882,99.56525,247960
4693,jrgirona,1,0.00040,246883,99.56566,247960
4694,jsga,1,0.00040,246884,99.56606,247960
4695,jtanios,1,0.00040,246885,99.56646,247960
4696,Juandavi1,1,0.00040,246886,99.56687,247960
4697,judyliou,1,0.00040,246887,99.56727,247960
4698,JulesBelveze,1,0.00040,246888,99.56767,247960
4699,julianmack,1,0.00040,246889,99.56808,247960
4700,Julian-Mata,1,0.00040,246890,99.56848,247960
4701,Juntai,1,0.00040,246891,99.56888,247960
4702,just-an-intern,1,0.00040,246892,99.56929,247960
4703,Justin-Blau,1,0.00040,246893,99.56969,247960
4704,justincormack,1,0.00040,246894,99.57009,247960
4705,jwkim912,1,0.00040,246895,99.57050,247960
4706,jynx10,1,0.00040,246896,99.57090,247960
4707,Jyothipyxis,1,0.00040,246897,99.57130,247960
4708,jzf2101,1,0.00040,246898,99.57171,247960
4709,k1m743hyun,1,0.00040,246899,99.57211,247960
4710,k3aibot,1,0.00040,246900,99.57251,247960
4711,kaben,1,0.00040,246901,99.57291,247960
4712,kachris,1,0.00040,246902,99.57332,247960
4713,kai910120,1,0.00040,246903,99.57372,247960
4714,kaiwaehner,1,0.00040,246904,99.57412,247960
4715,Kaka1127,1,0.00040,246905,99.57453,247960
4716,KakarotSonGokuShenron,1,0.00040,246906,99.57493,247960
4717,kandrio,1,0.00040,246907,99.57533,247960
4718,KannanThiru,1,0.00040,246908,99.57574,247960
4719,kannon92,1,0.00040,246909,99.57614,247960
4720,kant,1,0.00040,246910,99.57654,247960
4721,kaoutar55,1,0.00040,246911,99.57695,247960
4722,Kapalov,1,0.00040,246912,99.57735,247960
4723,KaranKhirsariya,1,0.00040,246913,99.57775,247960
4724,karan-kumar-by,1,0.00040,246914,99.57816,247960
4725,KarolisKont,1,0.00040,246915,99.57856,247960
4726,Katherinechenlove,1,0.00040,246916,99.57896,247960
4727,katherinez22,1,0.00040,246917,99.57937,247960
4728,katsiapis,1,0.00040,246918,99.57977,247960
4729,katylava,1,0.00040,246919,99.58017,247960
4730,KaulitzGuimaraes,1,0.00040,246920,99.58058,247960
4731,kavanshukla,1,0.00040,246921,99.58098,247960
4732,Kavee30,1,0.00040,246922,99.58138,247960
4733,KaviyaPeriyasamy,1,0.00040,246923,99.58179,247960
4734,kawai-kobold,1,0.00040,246924,99.58219,247960
4735,kawo123,1,0.00040,246925,99.58259,247960
4736,ka-zo,1,0.00040,246926,99.58300,247960
4737,kbd2011,1,0.00040,246927,99.58340,247960
4738,kbegiedza,1,0.00040,246928,99.58380,247960
4739,kciy,1,0.00040,246929,99.58421,247960
4740,kdecyllene,1,0.00040,246930,99.58461,247960
4741,kdrivas,1,0.00040,246931,99.58501,247960
4742,kdunee,1,0.00040,246932,99.58542,247960
4743,kedarX,1,0.00040,246933,99.58582,247960
4744,keeyzar,1,0.00040,246934,99.58622,247960
4745,keiichiroy,1,0.00040,246935,99.58663,247960
4746,keisuke-umezawa,1,0.00040,246936,99.58703,247960
4747,keithpij,1,0.00040,246937,99.58743,247960
4748,kelaban,1,0.00040,246938,99.58784,247960
4749,kellen,1,0.00040,246939,99.58824,247960
4750,kenlmf,1,0.00040,246940,99.58864,247960
4751,keremgocen,1,0.00040,246941,99.58905,247960
4752,k-e-r-n-e-l-p-a-n-i-c,1,0.00040,246942,99.58945,247960
4753,kevin2107,1,0.00040,246943,99.58985,247960
4754,kevin-bates,1,0.00040,246944,99.59026,247960
4755,kevinleewy,1,0.00040,246945,99.59066,247960
4756,kfkelvinng,1,0.00040,246946,99.59106,247960
4757,kg-ops,1,0.00040,246947,99.59147,247960
4758,khoward,1,0.00040,246948,99.59187,247960
4759,khteh,1,0.00040,246949,99.59227,247960
4760,kiddie92,1,0.00040,246950,99.59268,247960
4761,kilmarnock,1,0.00040,246951,99.59308,247960
4762,KION-ThomasMay,1,0.00040,246952,99.59348,247960
4763,KIShaoKIS,1,0.00040,246953,99.59389,247960
4764,kitamura-tetsuo,1,0.00040,246954,99.59429,247960
4765,kjaugustin,1,0.00040,246955,99.59469,247960
4766,kkumar137,1,0.00040,246956,99.59510,247960
4767,klaimane,1,0.00040,246957,99.59550,247960
4768,klee989,1,0.00040,246958,99.59590,247960
4769,klentabistado,1,0.00040,246959,99.59631,247960
4770,klolos,1,0.00040,246960,99.59671,247960
4771,knjk04,1,0.00040,246961,99.59711,247960
4772,knlp,1,0.00040,246962,99.59752,247960
4773,kong62,1,0.00040,246963,99.59792,247960
4774,kozhukalov,1,0.00040,246964,99.59832,247960
4775,Kr0n0,1,0.00040,246965,99.59873,247960
4776,krish7919,1,0.00040,246966,99.59913,247960
4777,Krishanu2001,1,0.00040,246967,99.59953,247960
4778,krishnakarra,1,0.00040,246968,99.59994,247960
4779,ksheerasagar17,1,0.00040,246969,99.60034,247960
4780,kshithijiyer,1,0.00040,246970,99.60074,247960
4781,kudla,1,0.00040,246971,99.60115,247960
4782,kujon,1,0.00040,246972,99.60155,247960
4783,kujyp,1,0.00040,246973,99.60195,247960
4784,kungfuchicken,1,0.00040,246974,99.60236,247960
4785,kuromt,1,0.00040,246975,99.60276,247960
4786,kusirajiv,1,0.00040,246976,99.60316,247960
4787,kylebeni,1,0.00040,246977,99.60357,247960
4788,kyzy540,1,0.00040,246978,99.60397,247960
4789,kzygmans,1,0.00040,246979,99.60437,247960
4790,lachie83,1,0.00040,246980,99.60477,247960
4791,laibruce,1,0.00040,246981,99.60518,247960
4792,lamberta,1,0.00040,246982,99.60558,247960
4793,LamoraHolmes,1,0.00040,246983,99.60598,247960
4794,LaoLiulaoliu,1,0.00040,246984,99.60639,247960
4795,laurenskz,1,0.00040,246985,99.60679,247960
4796,laurentgrangeau,1,0.00040,246986,99.60719,247960
4797,l-baker,1,0.00040,246987,99.60760,247960
4798,leafmulch,1,0.00040,246988,99.60800,247960
4799,LeBaronDean,1,0.00040,246989,99.60840,247960
4800,lebiathan,1,0.00040,246990,99.60881,247960
4801,Legion2,1,0.00040,246991,99.60921,247960
4802,leigh-johnson,1,0.00040,246992,99.60961,247960
4803,lenaherrmann-dfki,1,0.00040,246993,99.61002,247960
4804,leoliang1988,1,0.00040,246994,99.61042,247960
4805,leomzhong,1,0.00040,246995,99.61082,247960
4806,LeonardoEssence,1,0.00040,246996,99.61123,247960
4807,LetaoCh,1,0.00040,246997,99.61163,247960
4808,levitomer,1,0.00040,246998,99.61203,247960
4809,Lewiky,1,0.00040,246999,99.61244,247960
4810,lfourie,1,0.00040,247000,99.61284,247960
4811,lgarithm,1,0.00040,247001,99.61324,247960
4812,lhkkk,1,0.00040,247002,99.61365,247960
4813,liangxibing,1,0.00040,247003,99.61405,247960
4814,liaosiyang,1,0.00040,247004,99.61445,247960
4815,libgy8zli,1,0.00040,247005,99.61486,247960
4816,lifeandrew80,1,0.00040,247006,99.61526,247960
4817,liguodongiot,1,0.00040,247007,99.61566,247960
4818,liguodongIOT,1,0.00040,247008,99.61607,247960
4819,lildonpancho,1,0.00040,247009,99.61647,247960
4820,limbuu,1,0.00040,247010,99.61687,247960
4821,lindhe,1,0.00040,247011,99.61728,247960
4822,lions1988,1,0.00040,247012,99.61768,247960
4823,LisaFC,1,0.00040,247013,99.61808,247960
4824,liudongqing,1,0.00040,247014,99.61849,247960
4825,liuyl,1,0.00040,247015,99.61889,247960
4826,livegenic-akyrychek,1,0.00040,247016,99.61929,247960
4827,liyinan926,1,0.00040,247017,99.61970,247960
4828,ljstrnadiii,1,0.00040,247018,99.62010,247960
4829,lkoenigsberger,1,0.00040,247019,99.62050,247960
4830,lkr2des,1,0.00040,247020,99.62091,247960
4831,llhuii,1,0.00040,247021,99.62131,247960
4832,lokeshjain279,1,0.00040,247022,99.62171,247960
4833,lonnix,1,0.00040,247023,99.62212,247960
4834,lostangel556,1,0.00040,247024,99.62252,247960
4835,LoveQSYang,1,0.00040,247025,99.62292,247960
4836,loveunk,1,0.00040,247026,99.62333,247960
4837,lsh2366254,1,0.00040,247027,99.62373,247960
4838,ltdo111,1,0.00040,247028,99.62413,247960
4839,ltomes,1,0.00040,247029,99.62454,247960
4840,lucasc896,1,0.00040,247030,99.62494,247960
4841,lucastan5596,1,0.00040,247031,99.62534,247960
4842,lucastheis,1,0.00040,247032,99.62575,247960
4843,lucasvbalves,1,0.00040,247033,99.62615,247960
4844,luckyops,1,0.00040,247034,99.62655,247960
4845,luistrange,1,0.00040,247035,99.62696,247960
4846,lukepfister,1,0.00040,247036,99.62736,247960
4847,lukeyan2023,1,0.00040,247037,99.62776,247960
4848,lumi-docs,1,0.00040,247038,99.62817,247960
4849,luoxiaoxun,1,0.00040,247039,99.62857,247960
4850,Luxas98,1,0.00040,247040,99.62897,247960
4851,m0hit-aggarwal,1,0.00040,247041,99.62938,247960
4852,m3at,1,0.00040,247042,99.62978,247960
4853,maartenpants,1,0.00040,247043,99.63018,247960
4854,Mack-y,1,0.00040,247044,99.63059,247960
4855,madfrog,1,0.00040,247045,99.63099,247960
4856,MadsAdrian,1,0.00040,247046,99.63139,247960
4857,mageru,1,0.00040,247047,99.63180,247960
4858,maggiemhanna,1,0.00040,247048,99.63220,247960
4859,magreenberg,1,0.00040,247049,99.63260,247960
4860,maiconmattos,1,0.00040,247050,99.63301,247960
4861,maitra100,1,0.00040,247051,99.63341,247960
4862,manishsingh003,1,0.00040,247052,99.63381,247960
4863,manojb7,1,0.00040,247053,99.63422,247960
4864,manolis-andr,1,0.00040,247054,99.63462,247960
4865,mapsacosta,1,0.00040,247055,99.63502,247960
4866,MarcandreBoulon,1,0.00040,247056,99.63543,247960
4867,marciojv,1,0.00040,247057,99.63583,247960
4868,marcossony,1,0.00040,247058,99.63623,247960
4869,marcredhat,1,0.00040,247059,99.63663,247960
4870,markbluhm,1,0.00040,247060,99.63704,247960
4871,markcberman,1,0.00040,247061,99.63744,247960
4872,markellos-orfanos,1,0.00040,247062,99.63784,247960
4873,Markfelixm,1,0.00040,247063,99.63825,247960
4874,markhulia,1,0.00040,247064,99.63865,247960
4875,MarkusThill,1,0.00040,247065,99.63905,247960
4876,marlonmBoti,1,0.00040,247066,99.63946,247960
4877,martfl,1,0.00040,247067,99.63986,247960
4878,masapasa,1,0.00040,247068,99.64026,247960
4879,masonlr,1,0.00040,247069,99.64067,247960
4880,masoumi76,1,0.00040,247070,99.64107,247960
4881,massih10,1,0.00040,247071,99.64147,247960
4882,MasterofBisaster,1,0.00040,247072,99.64188,247960
4883,mat-ej,1,0.00040,247073,99.64228,247960
4884,mateusz-szczesny,1,0.00040,247074,99.64268,247960
4885,mathetes87,1,0.00040,247075,99.64309,247960
4886,matheusjerico,1,0.00040,247076,99.64349,247960
4887,MatheusPush,1,0.00040,247077,99.64389,247960
4888,mathis-marcotte,1,0.00040,247078,99.64430,247960
4889,matphilippe,1,0.00040,247079,99.64470,247960
4890,MatthewTafazoli,1,0.00040,247080,99.64510,247960
4891,Matthias-Winkeler-Fluke,1,0.00040,247081,99.64551,247960
4892,MauGeo,1,0.00040,247082,99.64591,247960
4893,maurogonzalez,1,0.00040,247083,99.64631,247960
4894,mausch,1,0.00040,247084,99.64672,247960
4895,MaxBlanck,1,0.00040,247085,99.64712,247960
4896,MaxGdr,1,0.00040,247086,99.64752,247960
4897,maximmold,1,0.00040,247087,99.64793,247960
4898,MaximumQuasar,1,0.00040,247088,99.64833,247960
4899,maxisawesome,1,0.00040,247089,99.64873,247960
4900,maxjacu,1,0.00040,247090,99.64914,247960
4901,maxkaustav,1,0.00040,247091,99.64954,247960
4902,max-sixty,1,0.00040,247092,99.64994,247960
4903,maxspanning,1,0.00040,247093,99.65035,247960
4904,maxtaq,1,0.00040,247094,99.65075,247960
4905,Mayuraggarwal1992,1,0.00040,247095,99.65115,247960
4906,Mayurji,1,0.00040,247096,99.65156,247960
4907,mbelang,1,0.00040,247097,99.65196,247960
4908,mbellphd,1,0.00040,247098,99.65236,247960
4909,mbittmann,1,0.00040,247099,99.65277,247960
4910,MBKraus,1,0.00040,247100,99.65317,247960
4911,mcberma,1,0.00040,247101,99.65357,247960
4912,mcristina422,1,0.00040,247102,99.65398,247960
4913,MDARBAAJ,1,0.00040,247103,99.65438,247960
4914,mdemiy,1,0.00040,247104,99.65478,247960
4915,MedhaCS1010,1,0.00040,247105,99.65519,247960
4916,medined,1,0.00040,247106,99.65559,247960
4917,Meet-Vaishnav,1,0.00040,247107,99.65599,247960
4918,megawidget,1,0.00040,247108,99.65640,247960
4919,mehdiasefi,1,0.00040,247109,99.65680,247960
4920,mehul1811,1,0.00040,247110,99.65720,247960
4921,MeisterUrian,1,0.00040,247111,99.65761,247960
4922,meken,1,0.00040,247112,99.65801,247960
4923,melih-sqsp,1,0.00040,247113,99.65841,247960
4924,MEllis-github,1,0.00040,247114,99.65882,247960
4925,metafeather,1,0.00040,247115,99.65922,247960
4926,Metal-joker,1,0.00040,247116,99.65962,247960
4927,metanouvelle,1,0.00040,247117,99.66003,247960
4928,mFat7y,1,0.00040,247118,99.66043,247960
4929,mf-lit,1,0.00040,247119,99.66083,247960
4930,MGSousa,1,0.00040,247120,99.66124,247960
4931,mhh12121,1,0.00040,247121,99.66164,247960
4932,michaelbeaumont,1,0.00040,247122,99.66204,247960
4933,michael-EIP,1,0.00040,247123,99.66245,247960
4934,miguelalba96,1,0.00040,247124,99.66285,247960
4935,miguelvcsoares,1,0.00040,247125,99.66325,247960
4936,mihuross,1,0.00040,247126,99.66366,247960
4937,mikeaadd,1,0.00040,247127,99.66406,247960
4938,Mikedu1988,1,0.00040,247128,99.66446,247960
4939,mikeedjones,1,0.00040,247129,99.66487,247960
4940,Mike-no,1,0.00040,247130,99.66527,247960
4941,mikezuniga,1,0.00040,247131,99.66567,247960
4942,millstx,1,0.00040,247132,99.66608,247960
4943,minaadel,1,0.00040,247133,99.66648,247960
4944,minchang,1,0.00040,247134,99.66688,247960
4945,mingnet,1,0.00040,247135,99.66729,247960
4946,mingweiLIU,1,0.00040,247136,99.66769,247960
4947,mingyyy,1,0.00040,247137,99.66809,247960
4948,MingzhouZhou,1,0.00040,247138,99.66849,247960
4949,minhdang241,1,0.00040,247139,99.66890,247960
4950,MinhManPham,1,0.00040,247140,99.66930,247960
4951,minrk,1,0.00040,247141,99.66970,247960
4952,missedone,1,0.00040,247142,99.67011,247960
4953,mistadrumma,1,0.00040,247143,99.67051,247960
4954,mitsuan,1,0.00040,247144,99.67091,247960
4955,miutamihai,1,0.00040,247145,99.67132,247960
4956,mjw2194,1,0.00040,247146,99.67172,247960
4957,mkrakow,1,0.00040,247147,99.67212,247960
4958,MLOpsWC,1,0.00040,247148,99.67253,247960
4959,mlu4679,1,0.00040,247149,99.67293,247960
4960,mlujan-strive,1,0.00040,247150,99.67333,247960
4961,mmlmahesh,1,0.00040,247151,99.67374,247960
4962,MoAmrYehia,1,0.00040,247152,99.67414,247960
4963,mobin102,1,0.00040,247153,99.67454,247960
4964,mohakamg,1,0.00040,247154,99.67495,247960
4965,mohamedakelportfolio,1,0.00040,247155,99.67535,247960
4966,mohamed-fazil-saleem,1,0.00040,247156,99.67575,247960
4967,mohamedniyaz1996,1,0.00040,247157,99.67616,247960
4968,mohandeepzumen,1,0.00040,247158,99.67656,247960
4969,mohdashifkhan,1,0.00040,247159,99.67696,247960
4970,momomobinx,1,0.00040,247160,99.67737,247960
4971,mongoose54,1,0.00040,247161,99.67777,247960
4972,monicatao,1,0.00040,247162,99.67817,247960
4973,MonikaVen,1,0.00040,247163,99.67858,247960
4974,moose007,1,0.00040,247164,99.67898,247960
4975,morelen17,1,0.00040,247165,99.67938,247960
4976,morningcloud,1,0.00040,247166,99.67979,247960
4977,mortezaalizadeh,1,0.00040,247167,99.68019,247960
4978,mostafabayat,1,0.00040,247168,99.68059,247960
4979,MotoRZR,1,0.00040,247169,99.68100,247960
4980,mpietrzy,1,0.00040,247170,99.68140,247960
4981,mpsapps,1,0.00040,247171,99.68180,247960
4982,MrMwalker2,1,0.00040,247172,99.68221,247960
4983,mro-aaskandani,1,0.00040,247173,99.68261,247960
4984,mrslnv,1,0.00040,247174,99.68301,247960
4985,msalehiNV,1,0.00040,247175,99.68342,247960
4986,msalvaris,1,0.00040,247176,99.68382,247960
4987,MSchauperl,1,0.00040,247177,99.68422,247960
4988,msiegler-google,1,0.00040,247178,99.68463,247960
4989,msinghg123,1,0.00040,247179,99.68503,247960
4990,msmendoza,1,0.00040,247180,99.68543,247960
4991,msteffen,1,0.00040,247181,99.68584,247960
4992,MStopa,1,0.00040,247182,99.68624,247960
4993,MTD-Telus,1,0.00040,247183,99.68664,247960
4994,mtoslalibu,1,0.00040,247184,99.68705,247960
4995,mukulikak,1,0.00040,247185,99.68745,247960
4996,munro,1,0.00040,247186,99.68785,247960
4997,murilommen,1,0.00040,247187,99.68826,247960
4998,muyajil,1,0.00040,247188,99.68866,247960
4999,muzhi1991,1,0.00040,247189,99.68906,247960
5000,mvisonneau,1,0.00040,247190,99.68947,247960
5001,mvk,1,0.00040,247191,99.68987,247960
5002,mwarzynski,1,0.00040,247192,99.69027,247960
5003,mwielgus,1,0.00040,247193,99.69068,247960
5004,mygulamali,1,0.00040,247194,99.69108,247960
5005,myoshimu,1,0.00040,247195,99.69148,247960
5006,mysunshine92,1,0.00040,247196,99.69189,247960
5007,nadamakram,1,0.00040,247197,99.69229,247960
5008,naeemkhan12,1,0.00040,247198,99.69269,247960
5009,nagautier,1,0.00040,247199,99.69310,247960
5010,naimadg,1,0.00040,247200,99.69350,247960
5011,nandita853,1,0.00040,247201,99.69390,247960
5012,naresh4u-gitrepo,1,0.00040,247202,99.69431,247960
5013,narfian,1,0.00040,247203,99.69471,247960
5014,narijeong,1,0.00040,247204,99.69511,247960
5015,natalian98,1,0.00040,247205,99.69552,247960
5016,Nateyo,1,0.00040,247206,99.69592,247960
5017,NathanDeMaria,1,0.00040,247207,99.69632,247960
5018,NathanNZ,1,0.00040,247208,99.69673,247960
5019,Nathicanaa,1,0.00040,247209,99.69713,247960
5020,navado,1,0.00040,247210,99.69753,247960
5021,Naveen-Jayaram,1,0.00040,247211,99.69794,247960
5022,Naveenkhasyap,1,0.00040,247212,99.69834,247960
5023,Naveenlbg,1,0.00040,247213,99.69874,247960
5024,navinger,1,0.00040,247214,99.69915,247960
5025,navneetkrc-aj,1,0.00040,247215,99.69955,247960
5026,naz19,1,0.00040,247216,99.69995,247960
5027,n-batalha,1,0.00040,247217,99.70035,247960
5028,neeharika4,1,0.00040,247218,99.70076,247960
5029,neelasha-09,1,0.00040,247219,99.70116,247960
5030,neerajkaushik,1,0.00040,247220,99.70156,247960
5031,nehakapila94,1,0.00040,247221,99.70197,247960
5032,nehal3731,1,0.00040,247222,99.70237,247960
5033,nelson2000,1,0.00040,247223,99.70277,247960
5034,Nenrikido,1,0.00040,247224,99.70318,247960
5035,nfelt,1,0.00040,247225,99.70358,247960
5036,nicbillen,1,0.00040,247226,99.70398,247960
5037,nichoio,1,0.00040,247227,99.70439,247960
5038,nick4fake,1,0.00040,247228,99.70479,247960
5039,nicklausZJF,1,0.00040,247229,99.70519,247960
5040,niderhoff,1,0.00040,247230,99.70560,247960
5041,nieksand,1,0.00040,247231,99.70600,247960
5042,nielsdewulf,1,0.00040,247232,99.70640,247960
5043,nielsuit227,1,0.00040,247233,99.70681,247960
5044,NieRonghua,1,0.00040,247234,99.70721,247960
5045,nikhilbandi,1,0.00040,247235,99.70761,247960
5046,nikhil-das-katonic,1,0.00040,247236,99.70802,247960
5047,NikhilKanda,1,0.00040,247237,99.70842,247960
5048,nikitosl,1,0.00040,247238,99.70882,247960
5049,nilanjana2015,1,0.00040,247239,99.70923,247960
5050,ninja-tester,1,0.00040,247240,99.70963,247960
5051,Nintorac,1,0.00040,247241,99.71003,247960
5052,NiravSo,1,0.00040,247242,99.71044,247960
5053,NirmalAnandKuzhandaivel,1,0.00040,247243,99.71084,247960
5054,nishi-t,1,0.00040,247244,99.71124,247960
5055,nithinkanil1,1,0.00040,247245,99.71165,247960
5056,nitishkrishna,1,0.00040,247246,99.71205,247960
5057,niuqg,1,0.00040,247247,99.71245,247960
5058,niya3,1,0.00040,247248,99.71286,247960
5059,njriasan,1,0.00040,247249,99.71326,247960
5060,nlin-kobold,1,0.00040,247250,99.71366,247960
5061,nm2107,1,0.00040,247251,99.71407,247960
5062,NonStatic2014,1,0.00040,247252,99.71447,247960
5063,novakg,1,0.00040,247253,99.71487,247960
5064,nrdlngr,1,0.00040,247254,99.71528,247960
5065,nsshah1288,1,0.00040,247255,99.71568,247960
5066,n-stout,1,0.00040,247256,99.71608,247960
5067,ntakouris,1,0.00040,247257,99.71649,247960
5068,ntenenz,1,0.00040,247258,99.71689,247960
5069,nturner-maritz,1,0.00040,247259,99.71729,247960
5070,Nuniemsis,1,0.00040,247260,99.71770,247960
5071,NurFaizin,1,0.00040,247261,99.71810,247960
5072,nurvenur12,1,0.00040,247262,99.71850,247960
5073,nyejon,1,0.00040,247263,99.71891,247960
5074,nzhang0430,1,0.00040,247264,99.71931,247960
5075,oak-tree,1,0.00040,247265,99.71971,247960
5076,odovad,1,0.00040,247266,99.72012,247960
5077,okeynikky,1,0.00040,247267,99.72052,247960
5078,okonmarcin,1,0.00040,247268,99.72092,247960
5079,olicantin,1,0.00040,247269,99.72133,247960
5080,oluies,1,0.00040,247270,99.72173,247960
5081,omar16100,1,0.00040,247271,99.72213,247960
5082,OmGraja,1,0.00040,247272,99.72254,247960
5083,ommmid,1,0.00040,247273,99.72294,247960
5084,OnTheRicky,1,0.00040,247274,99.72334,247960
5085,OonjuoO,1,0.00040,247275,99.72375,247960
5086,openbsod,1,0.00040,247276,99.72415,247960
5087,openrory,1,0.00040,247277,99.72455,247960
5088,opensrn,1,0.00040,247278,99.72496,247960
5089,openthings,1,0.00040,247279,99.72536,247960
5090,oquere,1,0.00040,247280,99.72576,247960
5091,Oranst,1,0.00040,247281,99.72617,247960
5092,ornew,1,0.00040,247282,99.72657,247960
5093,OrrAvrech,1,0.00040,247283,99.72697,247960
5094,OscarLlorente,1,0.00040,247284,99.72738,247960
5095,oscarvilla,1,0.00040,247285,99.72778,247960
5096,oskar-j,1,0.00040,247286,99.72818,247960
5097,ottodolfo,1,0.00040,247287,99.72859,247960
5098,ovarene,1,0.00040,247288,99.72899,247960
5099,o-vexler,1,0.00040,247289,99.72939,247960
5100,owmasch,1,0.00040,247290,99.72980,247960
5101,ozen,1,0.00040,247291,99.73020,247960
5102,ozert,1,0.00040,247292,99.73060,247960
5103,ozturkosu,1,0.00040,247293,99.73101,247960
5104,pa8mm,1,0.00040,247294,99.73141,247960
5105,padrian,1,0.00040,247295,99.73181,247960
5106,pangiann,1,0.00040,247296,99.73221,247960
5107,pantelis,1,0.00040,247297,99.73262,247960
5108,parakhjain,1,0.00040,247298,99.73302,247960
5109,parallelo,1,0.00040,247299,99.73342,247960
5110,patel-om,1,0.00040,247300,99.73383,247960
5111,patsadow2,1,0.00040,247301,99.73423,247960
5112,paulbehrisch,1,0.00040,247302,99.73463,247960
5113,paulcrowley,1,0.00040,247303,99.73504,247960
5114,paulk8s,1,0.00040,247304,99.73544,247960
5115,paulkarayan,1,0.00040,247305,99.73584,247960
5116,paulomach,1,0.00040,247306,99.73625,247960
5117,PaulQbFeng,1,0.00040,247307,99.73665,247960
5118,pavelzhurov,1,0.00040,247308,99.73705,247960
5119,pcdas,1,0.00040,247309,99.73746,247960
5120,pencilerazzer,1,0.00040,247310,99.73786,247960
5121,peng09,1,0.00040,247311,99.73826,247960
5122,perdurabo93,1,0.00040,247312,99.73867,247960
5123,perseusyang1997,1,0.00040,247313,99.73907,247960
5124,peterbarty,1,0.00040,247314,99.73947,247960
5125,pgrimaud,1,0.00040,247315,99.73988,247960
5126,phatlast96,1,0.00040,247316,99.74028,247960
5127,Phelan164,1,0.00040,247317,99.74068,247960
5128,phiamazon,1,0.00040,247318,99.74109,247960
5129,PhilippeMarcotte,1,0.00040,247319,99.74149,247960
5130,philtremblay,1,0.00040,247320,99.74189,247960
5131,PhoenixLuo2,1,0.00040,247321,99.74230,247960
5132,phsiao,1,0.00040,247322,99.74270,247960
5133,piaobeizu,1,0.00040,247323,99.74310,247960
5134,pikadef,1,0.00040,247324,99.74351,247960
5135,piyongze,1,0.00040,247325,99.74391,247960
5136,pjh4993,1,0.00040,247326,99.74431,247960
5137,Planck0591,1,0.00040,247327,99.74472,247960
5138,plankthom,1,0.00040,247328,99.74512,247960
5139,Plataformaalgoritmica,1,0.00040,247329,99.74552,247960
5140,PLeusmann,1,0.00040,247330,99.74593,247960
5141,Poggecci,1,0.00040,247331,99.74633,247960
5142,porimol,1,0.00040,247332,99.74673,247960
5143,porimolchandro,1,0.00040,247333,99.74714,247960
5144,PouriaNikvand,1,0.00040,247334,99.74754,247960
5145,pourquoi42,1,0.00040,247335,99.74794,247960
5146,ppkube,1,0.00040,247336,99.74835,247960
5147,prabhat04011998,1,0.00040,247337,99.74875,247960
5148,prabhatsharma,1,0.00040,247338,99.74915,247960
5149,prabhu,1,0.00040,247339,99.74956,247960
5150,pradeepbhadani,1,0.00040,247340,99.74996,247960
5151,pradnyaborkar900,1,0.00040,247341,99.75036,247960
5152,prakashsingh21,1,0.00040,247342,99.75077,247960
5153,prameshj,1,0.00040,247343,99.75117,247960
5154,pranavaninadam,1,0.00040,247344,99.75157,247960
5155,pranay-ar,1,0.00040,247345,99.75198,247960
5156,pranaysawant,1,0.00040,247346,99.75238,247960
5157,prasannakumar-coupa,1,0.00040,247347,99.75278,247960
5158,prasannavj,1,0.00040,247348,99.75319,247960
5159,prashant2402,1,0.00040,247349,99.75359,247960
5160,pratikgujjar,1,0.00040,247350,99.75399,247960
5161,PratikStar,1,0.00040,247351,99.75440,247960
5162,pratyushpanda,1,0.00040,247352,99.75480,247960
5163,preska,1,0.00040,247353,99.75520,247960
5164,Priapos1004,1,0.00040,247354,99.75561,247960
5165,PrincewillIroka,1,0.00040,247355,99.75601,247960
5166,Priyanka4pc,1,0.00040,247356,99.75641,247960
5167,priyawadhwa,1,0.00040,247357,99.75682,247960
5168,ProvoK,1,0.00040,247358,99.75722,247960
5169,prutkin,1,0.00040,247359,99.75762,247960
5170,PsHughes,1,0.00040,247360,99.75803,247960
5171,pskindel,1,0.00040,247361,99.75843,247960
5172,psmoros,1,0.00040,247362,99.75883,247960
5173,psyhtest,1,0.00040,247363,99.75924,247960
5174,psykidellic,1,0.00040,247364,99.75964,247960
5175,ptartan21,1,0.00040,247365,99.76004,247960
5176,ptone,1,0.00040,247366,99.76045,247960
5177,pulpo,1,0.00040,247367,99.76085,247960
5178,pushkarv,1,0.00040,247368,99.76125,247960
5179,pyalex,1,0.00040,247369,99.76166,247960
5180,pymia,1,0.00040,247370,99.76206,247960
5181,Python35,1,0.00040,247371,99.76246,247960
5182,pyxelr,1,0.00040,247372,99.76286,247960
5183,Qasim-Aziz,1,0.00040,247373,99.76327,247960
5184,qiaqiatic,1,0.00040,247374,99.76367,247960
5185,qijia2045579,1,0.00040,247375,99.76407,247960
5186,Qingwt,1,0.00040,247376,99.76448,247960
5187,QinjieLin-NU,1,0.00040,247377,99.76488,247960
5188,QipengZhou,1,0.00040,247378,99.76528,247960
5189,qlniu,1,0.00040,247379,99.76569,247960
5190,qqsun8819,1,0.00040,247380,99.76609,247960
5191,quan-dang,1,0.00040,247381,99.76649,247960
5192,queguan,1,0.00040,247382,99.76690,247960
5193,QuesarVII,1,0.00040,247383,99.76730,247960
5194,r0mk1,1,0.00040,247384,99.76770,247960
5195,Radhika108,1,0.00040,247385,99.76811,247960
5196,rafaelalou,1,0.00040,247386,99.76851,247960
5197,rafaelalouka-bai,1,0.00040,247387,99.76891,247960
5198,rafaelgildin,1,0.00040,247388,99.76932,247960
5199,raghav20,1,0.00040,247389,99.76972,247960
5200,raghavendramanandi,1,0.00040,247390,99.77012,247960
5201,raghulkrishna,1,0.00040,247391,99.77053,247960
5202,rahcode7,1,0.00040,247392,99.77093,247960
5203,rahul99,1,0.00040,247393,99.77133,247960
5204,rahulkhatry4,1,0.00040,247394,99.77174,247960
5205,rahulunair,1,0.00040,247395,99.77214,247960
5206,Raiyan111,1,0.00040,247396,99.77254,247960
5207,rajanjitenpatel,1,0.00040,247397,99.77295,247960
5208,rajivsam,1,0.00040,247398,99.77335,247960
5209,rajsrujan77,1,0.00040,247399,99.77375,247960
5210,rakshithpai2108,1,0.00040,247400,99.77416,247960
5211,rakshithvsk,1,0.00040,247401,99.77456,247960
5212,ramjinokia,1,0.00040,247402,99.77496,247960
5213,ranajoy-dutta,1,0.00040,247403,99.77537,247960
5214,rand,1,0.00040,247404,99.77577,247960
5215,ranjithmr,1,0.00040,247405,99.77617,247960
5216,RaphPfister,1,0.00040,247406,99.77658,247960
5217,rapuckett,1,0.00040,247407,99.77698,247960
5218,rayuron,1,0.00040,247408,99.77738,247960
5219,raztud,1,0.00040,247409,99.77779,247960
5220,rcarmstrong,1,0.00040,247410,99.77819,247960
5221,rculbertson,1,0.00040,247411,99.77859,247960
5222,rdoume,1,0.00040,247412,99.77900,247960
5223,reach4nk,1,0.00040,247413,99.77940,247960
5224,realsushi-official,1,0.00040,247414,99.77980,247960
5225,redcican,1,0.00040,247415,99.78021,247960
5226,reevelau,1,0.00040,247416,99.78061,247960
5227,reinhouthooft,1,0.00040,247417,99.78101,247960
5228,remche,1,0.00040,247418,99.78142,247960
5229,remde,1,0.00040,247419,99.78182,247960
5230,remoyson,1,0.00040,247420,99.78222,247960
5231,RemyLarroye-o,1,0.00040,247421,99.78263,247960
5232,renat-abbyazov,1,0.00040,247422,99.78303,247960
5233,renqiang2016,1,0.00040,247423,99.78343,247960
5234,RensDimmendaal,1,0.00040,247424,99.78384,247960
5235,renuraj18,1,0.00040,247425,99.78424,247960
5236,RE-Wolfe,1,0.00040,247426,99.78464,247960
5237,rexlow,1,0.00040,247427,99.78505,247960
5238,reyhane1998,1,0.00040,247428,99.78545,247960
5239,rfan-debug,1,0.00040,247429,99.78585,247960
5240,rgupta1234,1,0.00040,247430,99.78626,247960
5241,rguso,1,0.00040,247431,99.78666,247960
5242,rhatol,1,0.00040,247432,99.78706,247960
5243,rhugga,1,0.00040,247433,99.78747,247960
5244,RichardBronosky,1,0.00040,247434,99.78787,247960
5245,richardburakowski,1,0.00040,247435,99.78827,247960
5246,riibeirogabriel,1,0.00040,247436,99.78868,247960
5247,riteshkarval,1,0.00040,247437,99.78908,247960
5248,riteshpallod,1,0.00040,247438,99.78948,247960
5249,rjEks,1,0.00040,247439,99.78989,247960
5250,rmbrad,1,0.00040,247440,99.79029,247960
5251,rnkhouse,1,0.00040,247441,99.79069,247960
5252,robbiedow,1,0.00040,247442,99.79110,247960
5253,robertofierimonte,1,0.00040,247443,99.79150,247960
5254,robertschweizer,1,0.00040,247444,99.79190,247960
5255,robincher,1,0.00040,247445,99.79231,247960
5256,robinvanschaik,1,0.00040,247446,99.79271,247960
5257,robotaref,1,0.00040,247447,99.79311,247960
5258,rock-town-coder,1,0.00040,247448,99.79352,247960
5259,rohitgujral,1,0.00040,247449,99.79392,247960
5260,romanbilenko174,1,0.00040,247450,99.79432,247960
5261,ronsingler,1,0.00040,247451,99.79472,247960
5262,ronytesler,1,0.00040,247452,99.79513,247960
5263,Rory602,1,0.00040,247453,99.79553,247960
5264,rosawant,1,0.00040,247454,99.79593,247960
5265,Roshrini,1,0.00040,247455,99.79634,247960
5266,rovechkin,1,0.00040,247456,99.79674,247960
5267,Roymprog,1,0.00040,247457,99.79714,247960
5268,RoyOsaki,1,0.00040,247458,99.79755,247960
5269,rp4fx12,1,0.00040,247459,99.79795,247960
5270,rsassPwC,1,0.00040,247460,99.79835,247960
5271,rscottwatson,1,0.00040,247461,99.79876,247960
5272,rsepassi,1,0.00040,247462,99.79916,247960
5273,rsinghtc,1,0.00040,247463,99.79956,247960
5274,rsr23,1,0.00040,247464,99.79997,247960
5275,ruanxingbaozi,1,0.00040,247465,99.80037,247960
5276,RubensZimbres,1,0.00040,247466,99.80077,247960
5277,ruckc,1,0.00040,247467,99.80118,247960
5278,ruodingt,1,0.00040,247468,99.80158,247960
5279,RUOK90,1,0.00040,247469,99.80198,247960
5280,RustamyF,1,0.00040,247470,99.80239,247960
5281,rwathena,1,0.00040,247471,99.80279,247960
5282,ryan-nervana,1,0.00040,247472,99.80319,247960
5283,ryanwcyin,1,0.00040,247473,99.80360,247960
5284,rystadedgaras,1,0.00040,247474,99.80400,247960
5285,RyuSA,1,0.00040,247475,99.80440,247960
5286,rzillerueloatgoogle,1,0.00040,247476,99.80481,247960
5287,saamalik,1,0.00040,247477,99.80521,247960
5288,sabarikannan-ai,1,0.00040,247478,99.80561,247960
5289,sabarnwal,1,0.00040,247479,99.80602,247960
5290,sabya39,1,0.00040,247480,99.80642,247960
5291,sachin-ac,1,0.00040,247481,99.80682,247960
5292,sadakeita,1,0.00040,247482,99.80723,247960
5293,sai196,1,0.00040,247483,99.80763,247960
5294,saiakhil2012,1,0.00040,247484,99.80803,247960
5295,saidsef,1,0.00040,247485,99.80844,247960
5296,saigirishgilly98,1,0.00040,247486,99.80884,247960
5297,SaiKiranBurle,1,0.00040,247487,99.80924,247960
5298,salexashenko,1,0.00040,247488,99.80965,247960
5299,sallamander,1,0.00040,247489,99.81005,247960
5300,saltazaur,1,0.00040,247490,99.81045,247960
5301,sam360digitmg,1,0.00040,247491,99.81086,247960
5302,samcaetano,1,0.00040,247492,99.81126,247960
5303,sam-h-bean,1,0.00040,247493,99.81166,247960
5304,samithaj,1,0.00040,247494,99.81207,247960
5305,SanderRednas,1,0.00040,247495,99.81247,247960
5306,sanjikasehgal,1,0.00040,247496,99.81287,247960
5307,sanjshres,1,0.00040,247497,99.81328,247960
5308,sanjshrestha,1,0.00040,247498,99.81368,247960
5309,santhosh261190,1,0.00040,247499,99.81408,247960
5310,Santosh1176,1,0.00040,247500,99.81449,247960
5311,SaraSaffari,1,0.00040,247501,99.81489,247960
5312,Sarrouna,1,0.00040,247502,99.81529,247960
5313,sashavcat,1,0.00040,247503,99.81570,247960
5314,sassyn,1,0.00040,247504,99.81610,247960
5315,satata-clgx,1,0.00040,247505,99.81650,247960
5316,satheeshbc,1,0.00040,247506,99.81691,247960
5317,Sathvik777,1,0.00040,247507,99.81731,247960
5318,satriawadhipurusa,1,0.00040,247508,99.81771,247960
5319,saurabh1043,1,0.00040,247509,99.81812,247960
5320,saurav2608,1,0.00040,247510,99.81852,247960
5321,savingoyal,1,0.00040,247511,99.81892,247960
5322,Sayed-Imran,1,0.00040,247512,99.81933,247960
5323,sbko,1,0.00040,247513,99.81973,247960
5324,Scagin,1,0.00040,247514,99.82013,247960
5325,scale-itx,1,0.00040,247515,99.82054,247960
5326,schmidt-jake,1,0.00040,247516,99.82094,247960
5327,scotttam,1,0.00040,247517,99.82134,247960
5328,scttl,1,0.00040,247518,99.82175,247960
5329,sdgs72,1,0.00040,247519,99.82215,247960
5330,seanlin1326,1,0.00040,247520,99.82255,247960
5331,seattleplus,1,0.00040,247521,99.82296,247960
5332,sebastianbarry-sms,1,0.00040,247522,99.82336,247960
5333,seboktamas,1,0.00040,247523,99.82376,247960
5334,SeibertronSSS,1,0.00040,247524,99.82417,247960
5335,seoyeonhwng,1,0.00040,247525,99.82457,247960
5336,SergeyCherman,1,0.00040,247526,99.82497,247960
5337,SergeyKanzhelev,1,0.00040,247527,99.82538,247960
5338,sethmcagit,1,0.00040,247528,99.82578,247960
5339,sevro,1,0.00040,247529,99.82618,247960
5340,Shabrinath,1,0.00040,247530,99.82658,247960
5341,shadowdsp,1,0.00040,247531,99.82699,247960
5342,shadowmodder,1,0.00040,247532,99.82739,247960
5343,shag123,1,0.00040,247533,99.82779,247960
5344,ShaneZhong,1,0.00040,247534,99.82820,247960
5345,shanisma,1,0.00040,247535,99.82860,247960
5346,shankarpm,1,0.00040,247536,99.82900,247960
5347,Sharat-Innodatatics,1,0.00040,247537,99.82941,247960
5348,sharjeelaziz,1,0.00040,247538,99.82981,247960
5349,sharm294,1,0.00040,247539,99.83021,247960
5350,shashank0202,1,0.00040,247540,99.83062,247960
5351,ShashankBlr,1,0.00040,247541,99.83102,247960
5352,ShaswataJash,1,0.00040,247542,99.83142,247960
5353,shayancanonical,1,0.00040,247543,99.83183,247960
5354,shekhar0413,1,0.00040,247544,99.83223,247960
5355,shekhar-ms123,1,0.00040,247545,99.83263,247960
5356,shengkaixuan,1,0.00040,247546,99.83304,247960
5357,shengy90,1,0.00040,247547,99.83344,247960
5358,shengzhou1216,1,0.00040,247548,99.83384,247960
5359,shenkejie15,1,0.00040,247549,99.83425,247960
5360,shikhabitgrit,1,0.00040,247550,99.83465,247960
5361,shilf1,1,0.00040,247551,99.83505,247960
5362,shivam19991,1,0.00040,247552,99.83546,247960
5363,shiyu15,1,0.00040,247553,99.83586,247960
5364,shravspy,1,0.00040,247554,99.83626,247960
5365,ShreyPandit,1,0.00040,247555,99.83667,247960
5366,ShrikanthSingh,1,0.00040,247556,99.83707,247960
5367,shrinidhisuresha,1,0.00040,247557,99.83747,247960
5368,shrivs3,1,0.00040,247558,99.83788,247960
5369,shrutich91,1,0.00040,247559,99.83828,247960
5370,shuklashashank,1,0.00040,247560,99.83868,247960
5371,shurain,1,0.00040,247561,99.83909,247960
5372,sibleyd,1,0.00040,247562,99.83949,247960
5373,Siddarth-Pattnaik,1,0.00040,247563,99.83989,247960
5374,siddhant235,1,0.00040,247564,99.84030,247960
5375,Siddika1278,1,0.00040,247565,99.84070,247960
5376,siddsuresh97,1,0.00040,247566,99.84110,247960
5377,Sidebook,1,0.00040,247567,99.84151,247960
5378,sidiksoleman,1,0.00040,247568,99.84191,247960
5379,sidnaik1975,1,0.00040,247569,99.84231,247960
5380,SilDev-zz,1,0.00040,247570,99.84272,247960
5381,simanw304,1,0.00040,247571,99.84312,247960
5382,simanwangSC,1,0.00040,247572,99.84352,247960
5383,Simon-Harris-IBM,1,0.00040,247573,99.84393,247960
5384,Sinba7,1,0.00040,247574,99.84433,247960
5385,sitakantachaudhury,1,0.00040,247575,99.84473,247960
5386,sivachama,1,0.00040,247576,99.84514,247960
5387,sixinshuier,1,0.00040,247577,99.84554,247960
5388,sjaek,1,0.00040,247578,99.84594,247960
5389,sjmccorm1993,1,0.00040,247579,99.84635,247960
5390,skmaingi,1,0.00040,247580,99.84675,247960
5391,sleep-404,1,0.00040,247581,99.84715,247960
5392,slowlove1995,1,0.00040,247582,99.84756,247960
5393,SmartInWhut,1,0.00040,247583,99.84796,247960
5394,smeyer12,1,0.00040,247584,99.84836,247960
5395,smijar,1,0.00040,247585,99.84877,247960
5396,SMillerDev,1,0.00040,247586,99.84917,247960
5397,sml0820,1,0.00040,247587,99.84957,247960
5398,smnama,1,0.00040,247588,99.84998,247960
5399,Smokrow,1,0.00040,247589,99.85038,247960
5400,smthpickboy,1,0.00040,247590,99.85078,247960
5401,sneharth37,1,0.00040,247591,99.85119,247960
5402,snowmanbamm,1,0.00040,247592,99.85159,247960
5403,snps-sagarrao,1,0.00040,247593,99.85199,247960
5404,sofam,1,0.00040,247594,99.85240,247960
5405,sofsms,1,0.00040,247595,99.85280,247960
5406,Softsapiens,1,0.00040,247596,99.85320,247960
5407,sohailanjum97,1,0.00040,247597,99.85361,247960
5408,SoheilSalehian,1,0.00040,247598,99.85401,247960
5409,solomatov,1,0.00040,247599,99.85441,247960
5410,somnath1077,1,0.00040,247600,99.85482,247960
5411,sonfire86,1,0.00040,247601,99.85522,247960
5412,Soonmok,1,0.00040,247602,99.85562,247960
5413,sorowakers,1,0.00040,247603,99.85603,247960
5414,SoujanyaSan,1,0.00040,247604,99.85643,247960
5415,soumentrivedi,1,0.00040,247605,99.85683,247960
5416,soumith,1,0.00040,247606,99.85724,247960
5417,soumyadipDe,1,0.00040,247607,99.85764,247960
5418,Space-Banana-42,1,0.00040,247608,99.85804,247960
5419,spaghettifunk,1,0.00040,247609,99.85844,247960
5420,spatre,1,0.00040,247610,99.85885,247960
5421,SpeedCoder5,1,0.00040,247611,99.85925,247960
5422,speg03,1,0.00040,247612,99.85965,247960
5423,spiffxp,1,0.00040,247613,99.86006,247960
5424,spinelsun,1,0.00040,247614,99.86046,247960
5425,sporterman,1,0.00040,247615,99.86086,247960
5426,springcoil,1,0.00040,247616,99.86127,247960
5427,SputnikTea,1,0.00040,247617,99.86167,247960
5428,squaricdot,1,0.00040,247618,99.86207,247960
5429,srados,1,0.00040,247619,99.86248,247960
5430,sramirez,1,0.00040,247620,99.86288,247960
5431,sravanikollipara,1,0.00040,247621,99.86328,247960
5432,sreddybr3,1,0.00040,247622,99.86369,247960
5433,sreenivasmrpivot,1,0.00040,247623,99.86409,247960
5434,sriharikarnam,1,0.00040,247624,99.86449,247960
5435,srikantt,1,0.00040,247625,99.86490,247960
5436,srinivascreddy,1,0.00040,247626,99.86530,247960
5437,srishti0190,1,0.00040,247627,99.86570,247960
5438,ssabat,1,0.00040,247628,99.86611,247960
5439,ssabnis,1,0.00040,247629,99.86651,247960
5440,ssbhat,1,0.00040,247630,99.86691,247960
5441,ssharpe42,1,0.00040,247631,99.86732,247960
5442,StarCoral,1,0.00040,247632,99.86772,247960
5443,staturecrane,1,0.00040,247633,99.86812,247960
5444,stdec,1,0.00040,247634,99.86853,247960
5445,Steboss89,1,0.00040,247635,99.86893,247960
5446,stefanalund,1,0.00040,247636,99.86933,247960
5447,StefanFreshLand,1,0.00040,247637,99.86974,247960
5448,stepanhruda,1,0.00040,247638,99.87014,247960
5449,StephennFernandes,1,0.00040,247639,99.87054,247960
5450,SteveHoggNZ,1,0.00040,247640,99.87095,247960
5451,stevekuznetsov,1,0.00040,247641,99.87135,247960
5452,stevencasey,1,0.00040,247642,99.87175,247960
5453,stevenzhang-support,1,0.00040,247643,99.87216,247960
5454,stevezkw1998,1,0.00040,247644,99.87256,247960
5455,steviecash,1,0.00040,247645,99.87296,247960
5456,stradigi-andres-de-castro,1,0.00040,247646,99.87337,247960
5457,strangemonad,1,0.00040,247647,99.87377,247960
5458,su0625,1,0.00040,247648,99.87417,247960
5459,subramankala,1,0.00040,247649,99.87458,247960
5460,sucanthudu,1,0.00040,247650,99.87498,247960
5461,sumanraja,1,0.00040,247651,99.87538,247960
5462,sumeet1989,1,0.00040,247652,99.87579,247960
5463,Sumenia,1,0.00040,247653,99.87619,247960
5464,sunandosamaddar,1,0.00040,247654,99.87659,247960
5465,SunFromEast,1,0.00040,247655,99.87700,247960
5466,sunshine-zyl,1,0.00040,247656,99.87740,247960
5467,SuperKogito,1,0.00040,247657,99.87780,247960
5468,surabhikannan,1,0.00040,247658,99.87821,247960
5469,suredream,1,0.00040,247659,99.87861,247960
5470,suzusuzu,1,0.00040,247660,99.87901,247960
5471,svilenvul,1,0.00040,247661,99.87942,247960
5472,swapdebarshi,1,0.00040,247662,99.87982,247960
5473,swarnaditya,1,0.00040,247663,99.88022,247960
5474,SwathiAunooru,1,0.00040,247664,99.88063,247960
5475,switchfootsid,1,0.00040,247665,99.88103,247960
5476,swjung94,1,0.00040,247666,99.88143,247960
5477,syeo,1,0.00040,247667,99.88184,247960
5478,Sygyzmundovych,1,0.00040,247668,99.88224,247960
5479,syvlabs,1,0.00040,247669,99.88264,247960
5480,szha,1,0.00040,247670,99.88305,247960
5481,szpnygo,1,0.00040,247671,99.88345,247960
5482,TabbieD,1,0.00040,247672,99.88385,247960
5483,Taehun,1,0.00040,247673,99.88426,247960
5484,taghoutigomycode,1,0.00040,247674,99.88466,247960
5485,talal-sen,1,0.00040,247675,99.88506,247960
5486,talaman,1,0.00040,247676,99.88547,247960
5487,talexander,1,0.00040,247677,99.88587,247960
5488,talgos1,1,0.00040,247678,99.88627,247960
5489,tam0201,1,0.00040,247679,99.88668,247960
5490,tama-biro,1,0.00040,247680,99.88708,247960
5491,tania-python-dev,1,0.00040,247681,99.88748,247960
5492,tanmayv25,1,0.00040,247682,99.88789,247960
5493,tanvithakur94,1,0.00040,247683,99.88829,247960
5494,tanzb33r,1,0.00040,247684,99.88869,247960
5495,tan-z-tan,1,0.00040,247685,99.88910,247960
5496,taoyonggang,1,0.00040,247686,99.88950,247960
5497,taragu,1,0.00040,247687,99.88990,247960
5498,TaranSinghania,1,0.00040,247688,99.89030,247960
5499,tarekabouzeid,1,0.00040,247689,99.89071,247960
5500,tarun0,1,0.00040,247690,99.89111,247960
5501,tavinashb,1,0.00040,247691,99.89151,247960
5502,tayritenour,1,0.00040,247692,99.89192,247960
5503,tayyabmaqsood,1,0.00040,247693,99.89232,247960
5504,tbeatty,1,0.00040,247694,99.89272,247960
5505,tboquet,1,0.00040,247695,99.89313,247960
5506,tcarland,1,0.00040,247696,99.89353,247960
5507,tczhao,1,0.00040,247697,99.89393,247960
5508,tdevopsottawa,1,0.00040,247698,99.89434,247960
5509,techgnosis,1,0.00040,247699,99.89474,247960
5510,techgopal,1,0.00040,247700,99.89514,247960
5511,techjournalist,1,0.00040,247701,99.89555,247960
5512,Techn0logic,1,0.00040,247702,99.89595,247960
5513,TechR10n,1,0.00040,247703,99.89635,247960
5514,techwithshadab,1,0.00040,247704,99.89676,247960
5515,Techyuvi,1,0.00040,247705,99.89716,247960
5516,teetangh,1,0.00040,247706,99.89756,247960
5517,tejashpe,1,0.00040,247707,99.89797,247960
5518,tesla3,1,0.00040,247708,99.89837,247960
5519,testphys,1,0.00040,247709,99.89877,247960
5520,Te-YuanLiu,1,0.00040,247710,99.89918,247960
5521,the5solae,1,0.00040,247711,99.89958,247960
5522,thenovices,1,0.00040,247712,99.89998,247960
5523,Theocrat,1,0.00040,247713,99.90039,247960
5524,TheOtherOsama,1,0.00040,247714,99.90079,247960
5525,thethiny,1,0.00040,247715,99.90119,247960
5526,thetume,1,0.00040,247716,99.90160,247960
5527,thi-low,1,0.00040,247717,99.90200,247960
5528,thirdeye-jarvis,1,0.00040,247718,99.90240,247960
5529,ThisIsANiceName,1,0.00040,247719,99.90281,247960
5530,thkim0022,1,0.00040,247720,99.90321,247960
5531,thms-ngn,1,0.00040,247721,99.90361,247960
5532,tholor,1,0.00040,247722,99.90402,247960
5533,thomasfricke,1,0.00040,247723,99.90442,247960
5534,Thomasillo,1,0.00040,247724,99.90482,247960
5535,ThomasRot,1,0.00040,247725,99.90523,247960
5536,thomasSve,1,0.00040,247726,99.90563,247960
5537,thor3333,1,0.00040,247727,99.90603,247960
5538,thundergolfer,1,0.00040,247728,99.90644,247960
5539,thunderhill,1,0.00040,247729,99.90684,247960
5540,Tiddl1991,1,0.00040,247730,99.90724,247960
5541,TimCookny,1,0.00040,247731,99.90765,247960
5542,timothy-mugayi,1,0.00040,247732,99.90805,247960
5543,timothymugayi,1,0.00040,247733,99.90845,247960
5544,tinahbu,1,0.00040,247734,99.90886,247960
5545,tiopramayudi,1,0.00040,247735,99.90926,247960
5546,TiraO,1,0.00040,247736,99.90966,247960
5547,tjhgit,1,0.00040,247737,99.91007,247960
5548,tjingrant,1,0.00040,247738,99.91047,247960
5549,tmattio,1,0.00040,247739,99.91087,247960
5550,tmbluth,1,0.00040,247740,99.91128,247960
5551,tmnhat2001,1,0.00040,247741,99.91168,247960
5552,tmreic,1,0.00040,247742,99.91208,247960
5553,tobiasimbus,1,0.00040,247743,99.91249,247960
5554,toddlerds,1,0.00040,247744,99.91289,247960
5555,tomdurrant,1,0.00040,247745,99.91329,247960
5556,TomLaMantia,1,0.00040,247746,99.91370,247960
5557,TomReidNZ,1,0.00040,247747,99.91410,247960
5558,tomstockton,1,0.00040,247748,99.91450,247960
5559,Tomxin,1,0.00040,247749,99.91491,247960
5560,tongchao199,1,0.00040,247750,99.91531,247960
5561,tonyaw,1,0.00040,247751,99.91571,247960
5562,tpepper,1,0.00040,247752,99.91612,247960
5563,TPP2,1,0.00040,247753,99.91652,247960
5564,trackq,1,0.00040,247754,99.91692,247960
5565,traino82,1,0.00040,247755,99.91733,247960
5566,Trezorro,1,0.00040,247756,99.91773,247960
5567,TrieuLe0801,1,0.00040,247757,99.91813,247960
5568,trn84,1,0.00040,247758,99.91854,247960
5569,TrubadurOsman,1,0.00040,247759,99.91894,247960
5570,trusch,1,0.00040,247760,99.91934,247960
5571,tsukky67,1,0.00040,247761,99.91975,247960
5572,TT310,1,0.00040,247762,99.92015,247960
5573,tu-infra-tests,1,0.00040,247763,99.92055,247960
5574,tuliodesouza,1,0.00040,247764,99.92095,247960
5575,tuukkasarvi,1,0.00040,247765,99.92136,247960
5576,TylerBrabham,1,0.00040,247766,99.92176,247960
5577,Udayaprasad,1,0.00040,247767,99.92216,247960
5578,Ulov888,1,0.00040,247768,99.92257,247960
5579,unijoy,1,0.00040,247769,99.92297,247960
5580,UnionGlobal,1,0.00040,247770,99.92337,247960
5581,utkrs,1,0.00040,247771,99.92378,247960
5582,Vafilor,1,0.00040,247772,99.92418,247960
5583,VaibhavPage,1,0.00040,247773,99.92458,247960
5584,vaibhavrtk,1,0.00040,247774,99.92499,247960
5585,vakrat1,1,0.00040,247775,99.92539,247960
5586,valeneiko,1,0.00040,247776,99.92579,247960
5587,valentindbdg,1,0.00040,247777,99.92620,247960
5588,valko073,1,0.00040,247778,99.92660,247960
5589,vanaraj-az,1,0.00040,247779,99.92700,247960
5590,vancromy,1,0.00040,247780,99.92741,247960
5591,Vanithanow,1,0.00040,247781,99.92781,247960
5592,VariableDeclared,1,0.00040,247782,99.92821,247960
5593,varun111111,1,0.00040,247783,99.92862,247960
5594,varunchandan2,1,0.00040,247784,99.92902,247960
5595,vasco989k,1,0.00040,247785,99.92942,247960
5596,vasireddyvkl,1,0.00040,247786,99.92983,247960
5597,V-Bhadauriya,1,0.00040,247787,99.93023,247960
5598,vbucaj,1,0.00040,247788,99.93063,247960
5599,vdiravka,1,0.00040,247789,99.93104,247960
5600,vecorro,1,0.00040,247790,99.93144,247960
5601,veggiemonk,1,0.00040,247791,99.93184,247960
5602,venkatagedda,1,0.00040,247792,99.93225,247960
5603,vfontama,1,0.00040,247793,99.93265,247960
5604,vgopal,1,0.00040,247794,99.93305,247960
5605,vhosakot,1,0.00040,247795,99.93346,247960
5606,viethung1234q,1,0.00040,247796,99.93386,247960
5607,vijayb47,1,0.00040,247797,99.93426,247960
5608,VIjayHP,1,0.00040,247798,99.93467,247960
5609,vijaytrainer,1,0.00040,247799,99.93507,247960
5610,Vikash082,1,0.00040,247800,99.93547,247960
5611,vikasmenon,1,0.00040,247801,99.93588,247960
5612,Vikram486,1,0.00040,247802,99.93628,247960
5613,viksharma1987,1,0.00040,247803,99.93668,247960
5614,vinaydel,1,0.00040,247804,99.93709,247960
5615,vinaykumargudi,1,0.00040,247805,99.93749,247960
5616,VindhyaSRajan,1,0.00040,247806,99.93789,247960
5617,vinhdiesal,1,0.00040,247807,99.93830,247960
5618,viraja1,1,0.00040,247808,99.93870,247960
5619,ViralParikh22,1,0.00040,247809,99.93910,247960
5620,vishalsmb,1,0.00040,247810,99.93951,247960
5621,vishal-wiai,1,0.00040,247811,99.93991,247960
5622,vitaly-om,1,0.00040,247812,99.94031,247960
5623,VithikShah,1,0.00040,247813,99.94072,247960
5624,vivekanandpoojari,1,0.00040,247814,99.94112,247960
5625,vivekbhadouria,1,0.00040,247815,99.94152,247960
5626,vivekkum94,1,0.00040,247816,99.94193,247960
5627,viyer7,1,0.00040,247817,99.94233,247960
5628,vochicong,1,0.00040,247818,99.94273,247960
5629,volkermauel,1,0.00040,247819,99.94314,247960
5630,Volkimd,1,0.00040,247820,99.94354,247960
5631,vovkanaz,1,0.00040,247821,99.94394,247960
5632,vr140,1,0.00040,247822,99.94435,247960
5633,vsatpathy,1,0.00040,247823,99.94475,247960
5634,vsriniv-git,1,0.00040,247824,99.94515,247960
5635,vule24,1,0.00040,247825,99.94556,247960
5636,wafaaabdelhafez,1,0.00040,247826,99.94596,247960
5637,wallyworld,1,0.00040,247827,99.94636,247960
5638,WangCHX,1,0.00040,247828,99.94677,247960
5639,WangHexie,1,0.00040,247829,99.94717,247960
5640,wanglong001,1,0.00040,247830,99.94757,247960
5641,Wansh619,1,0.00040,247831,99.94798,247960
5642,waynehsei,1,0.00040,247832,99.94838,247960
5643,wdma,1,0.00040,247833,99.94878,247960
5644,we10710aa,1,0.00040,247834,99.94919,247960
5645,weicheng8626,1,0.00040,247835,99.94959,247960
5646,welcomemandeep,1,0.00040,247836,99.94999,247960
5647,wenjing,1,0.00040,247837,99.95040,247960
5648,wenjinsitu,1,0.00040,247838,99.95080,247960
5649,wenxinax,1,0.00040,247839,99.95120,247960
5650,wfchair,1,0.00040,247840,99.95161,247960
5651,whappybara,1,0.00040,247841,99.95201,247960
5652,whitlockjc,1,0.00040,247842,99.95241,247960
5653,William8Work,1,0.00040,247843,99.95281,247960
5654,willturner-gs,1,0.00040,247844,99.95322,247960
5655,willypicard,1,0.00040,247845,99.95362,247960
5656,wing328,1,0.00040,247846,99.95402,247960
5657,wintwoo,1,0.00040,247847,99.95443,247960
5658,wiszniowski-t,1,0.00040,247848,99.95483,247960
5659,WJayesh,1,0.00040,247849,99.95523,247960
5660,wjimenez5271,1,0.00040,247850,99.95564,247960
5661,wlzzZ,1,0.00040,247851,99.95604,247960
5662,wmikolajczyk,1,0.00040,247852,99.95644,247960
5663,wnowak10,1,0.00040,247853,99.95685,247960
5664,woof,1,0.00040,247854,99.95725,247960
5665,worsecoder,1,0.00040,247855,99.95765,247960
5666,wskinner,1,0.00040,247856,99.95806,247960
5667,wtermini,1,0.00040,247857,99.95846,247960
5668,wufly,1,0.00040,247858,99.95886,247960
5669,wulikai1993,1,0.00040,247859,99.95927,247960
5670,wutianhao910,1,0.00040,247860,99.95967,247960
5671,wuurrd,1,0.00040,247861,99.96007,247960
5672,wuxinglai,1,0.00040,247862,99.96048,247960
5673,wuyexixi,1,0.00040,247863,99.96088,247960
5674,wuzhiye7,1,0.00040,247864,99.96128,247960
5675,xalekx,1,0.00040,247865,99.96169,247960
5676,xcloud-carl,1,0.00040,247866,99.96209,247960
5677,xiangninglyu,1,0.00040,247867,99.96249,247960
5678,xianlubird,1,0.00040,247868,99.96290,247960
5679,xiehaoina,1,0.00040,247869,99.96330,247960
5680,xiezhw3,1,0.00040,247870,99.96370,247960
5681,xinghalo,1,0.00040,247871,99.96411,247960
5682,Xingyuan-Chen,1,0.00040,247872,99.96451,247960
5683,xnoar747,1,0.00040,247873,99.96491,247960
5684,xq2005,1,0.00040,247874,99.96532,247960
5685,xsatishx,1,0.00040,247875,99.96572,247960
5686,xsqian,1,0.00040,247876,99.96612,247960
5687,xuchenCN,1,0.00040,247877,99.96653,247960
5688,xushaoxiao,1,0.00040,247878,99.96693,247960
5689,xwyangjshb,1,0.00040,247879,99.96733,247960
5690,xxf09th,1,0.00040,247880,99.96774,247960
5691,xzy0223,1,0.00040,247881,99.96814,247960
5692,y2kenny,1,0.00040,247882,99.96854,247960
5693,yangaang,1,0.00040,247883,99.96895,247960
5694,yangjinlogic,1,0.00040,247884,99.96935,247960
5695,yangoos57,1,0.00040,247885,99.96975,247960
5696,yangpeng1994,1,0.00040,247886,99.97016,247960
5697,yangSignifyd,1,0.00040,247887,99.97056,247960
5698,yangyu2013,1,0.00040,247888,99.97096,247960
5699,yankunsam,1,0.00040,247889,99.97137,247960
5700,YannisPap,1,0.00040,247890,99.97177,247960
5701,yanyanwang1,1,0.00040,247891,99.97217,247960
5702,yaobaiwei,1,0.00040,247892,99.97258,247960
5703,yarikoptic,1,0.00040,247893,99.97298,247960
5704,yaseenisolated,1,0.00040,247894,99.97338,247960
5705,yczheng0,1,0.00040,247895,99.97379,247960
5706,yecohn,1,0.00040,247896,99.97419,247960
5707,YGuyomar,1,0.00040,247897,99.97459,247960
5708,yike5460,1,0.00040,247898,99.97500,247960
5709,yisampi,1,0.00040,247899,99.97540,247960
5710,yizhexu,1,0.00040,247900,99.97580,247960
5711,ykacer,1,0.00040,247901,99.97621,247960
5712,ykale,1,0.00040,247902,99.97661,247960
5713,yliu989,1,0.00040,247903,99.97701,247960
5714,yonaroze,1,0.00040,247904,99.97742,247960
5715,YongtaoHuang1994,1,0.00040,247905,99.97782,247960
5716,yooki0328,1,0.00040,247906,99.97822,247960
5717,yostao,1,0.00040,247907,99.97863,247960
5718,young-957,1,0.00040,247908,99.97903,247960
5719,YoungjuWang,1,0.00040,247909,99.97943,247960
5720,YPCC,1,0.00040,247910,99.97984,247960
5721,yphanikumar1995,1,0.00040,247911,99.98024,247960
5722,yshalabi,1,0.00040,247912,99.98064,247960
5723,yshimizu37,1,0.00040,247913,99.98105,247960
5724,yuanhunglo,1,0.00040,247914,99.98145,247960
5725,yuanzac,1,0.00040,247915,99.98185,247960
5726,yuc8939,1,0.00040,247916,99.98226,247960
5727,yudiprasetya24,1,0.00040,247917,99.98266,247960
5728,yueno06,1,0.00040,247918,99.98306,247960
5729,yuna878,1,0.00040,247919,99.98347,247960
5730,yurigilf,1,0.00040,247920,99.98387,247960
5731,yuvaldrori,1,0.00040,247921,99.98427,247960
5732,Yuvraj2300,1,0.00040,247922,99.98467,247960
5733,yydzhou,1,0.00040,247923,99.98508,247960
5734,yzc1114,1,0.00040,247924,99.98548,247960
5735,zacharymostowsky,1,0.00040,247925,99.98588,247960
5736,zachgrayio,1,0.00040,247926,99.98629,247960
5737,ZahraEconomist,1,0.00040,247927,99.98669,247960
5738,zchunhai,1,0.00040,247928,99.98709,247960
5739,zdzd123123,1,0.00040,247929,99.98750,247960
5740,ZeeshanAnwar15,1,0.00040,247930,99.98790,247960
5741,zhangnew,1,0.00040,247931,99.98830,247960
5742,zhangxueren9,1,0.00040,247932,99.98871,247960
5743,zhao1157,1,0.00040,247933,99.98911,247960
5744,zhaoxq,1,0.00040,247934,99.98951,247960
5745,zhch12121,1,0.00040,247935,99.98992,247960
5746,zhenlohuang,1,0.00040,247936,99.99032,247960
5747,zhenyulin,1,0.00040,247937,99.99072,247960
5748,Zhihan1996,1,0.00040,247938,99.99113,247960
5749,ZhiqiangWangICT,1,0.00040,247939,99.99153,247960
5750,ZhiqinYang,1,0.00040,247940,99.99193,247960
5751,zhou-harry,1,0.00040,247941,99.99234,247960
5752,zhreshold,1,0.00040,247942,99.99274,247960
5753,zhypku,1,0.00040,247943,99.99314,247960
5754,ziyou987,1,0.00040,247944,99.99355,247960
5755,zmoon111,1,0.00040,247945,99.99395,247960
5756,zmunro,1,0.00040,247946,99.99435,247960
5757,zoefyz12,1,0.00040,247947,99.99476,247960
5758,ZorkMaster,1,0.00040,247948,99.99516,247960
5759,zorrofox,1,0.00040,247949,99.99556,247960
5760,zqyi,1,0.00040,247950,99.99597,247960
5761,zsatterfield,1,0.00040,247951,99.99637,247960
5762,zuiurs,1,0.00040,247952,99.99677,247960
5763,Zveroloff,1,0.00040,247953,99.99718,247960
5764,zw39125432,1,0.00040,247954,99.99758,247960
5765,zxh326,1,0.00040,247955,99.99798,247960
5766,zyanichaimaa,1,0.00040,247956,99.99839,247960
5767,zyedManai,1,0.00040,247957,99.99879,247960
5768,zyfzjsc988,1,0.00040,247958,99.99919,247960
5769,zzaareer,1,0.00040,247959,99.99960,247960
5770,zzxvictor,1,0.00040,247960,100.00000,247960
