rank_number,actor,contributions,percent,cumulative_sum,cumulative_percent,all_contributions
1,chensun,5736,2.24461,5736,2.24461,255546
2,sarahmaddox,5300,2.07399,11036,4.31860,255546
3,zijianjoy,4065,1.59071,15101,5.90931,255546
4,connor-mccarthy,3408,1.33362,18509,7.24292,255546
5,numerology,3197,1.25105,21706,8.49397,255546
6,kkasravi,2318,0.90708,24024,9.40105,255546
7,8bitmp3,1937,0.75798,25961,10.15903,255546
8,gabrielwen,1748,0.68403,27709,10.84306,255546
9,neuromage,1666,0.65194,29375,11.49500,255546
10,abhi-g,1400,0.54785,30775,12.04284,255546
11,Linchin,1375,0.53806,32150,12.58091,255546
12,rmgogogo,1296,0.50715,33446,13.08805,255546
13,gkcalat,1283,0.50206,34729,13.59012,255546
14,joeliedtke,1241,0.48563,35970,14.07574,255546
15,jingzhang36,1214,0.47506,37184,14.55080,255546
16,hongye-sun,1207,0.47232,38391,15.02313,255546
17,capri-xiyue,1127,0.44102,39518,15.46414,255546
18,RFMVasconcelos,1114,0.43593,40632,15.90007,255546
19,avdaredevil,1067,0.41754,41699,16.31761,255546
20,SinaChavoshi,1029,0.40267,42728,16.72028,255546
21,ckadner,1024,0.40071,43752,17.12099,255546
22,prodonjs,857,0.33536,44609,17.45635,255546
23,jlyaoyuli,842,0.32949,45451,17.78584,255546
24,surajkota,839,0.32832,46290,18.11416,255546
25,texasmichelle,721,0.28214,47011,18.39630,255546
26,karthikv2k,539,0.21092,47550,18.60722,255546
27,zw0610,498,0.19488,48048,18.80209,255546
28,yuzliu,432,0.16905,48480,18.97114,255546
29,janeman98,431,0.16866,48911,19.13980,255546
30,zabbasi,429,0.16788,49340,19.30768,255546
31,james-jwu,415,0.16240,49755,19.47008,255546
32,ji-yaqi,397,0.15535,50152,19.62543,255546
33,zpChris,388,0.15183,50540,19.77726,255546
34,eterna2,375,0.14674,50915,19.92401,255546
35,ajchili,360,0.14087,51275,20.06488,255546
36,pvaneck,359,0.14048,51634,20.20536,255546
37,chongyouquan,333,0.13031,51967,20.33567,255546
38,adrian555,332,0.12992,52299,20.46559,255546
39,ashahba,303,0.11857,52602,20.58416,255546
40,cwbeitel,295,0.11544,52897,20.69960,255546
41,dushyanthsc,295,0.11544,53192,20.81504,255546
42,Udiknedormin,279,0.10918,53471,20.92422,255546
43,happy2048,278,0.10879,53749,21.03300,255546
44,holdenk,260,0.10174,54009,21.13475,255546
45,activatedgeek,258,0.10096,54267,21.23571,255546
46,kwasi,256,0.10018,54523,21.33588,255546
47,shannonbradshaw,254,0.09940,54777,21.43528,255546
48,drewbutlerbb4,251,0.09822,55028,21.53350,255546
49,qimingj,245,0.09587,55273,21.62937,255546
50,nrchakradhar,215,0.08413,55488,21.71351,255546
51,haoxins,197,0.07709,55685,21.79060,255546
52,subodh101,197,0.07709,55882,21.86769,255546
53,abchoo,185,0.07239,56067,21.94008,255546
54,jagadeeshi2i,182,0.07122,56249,22.01130,255546
55,sperlingxx,180,0.07044,56429,22.08174,255546
56,js-ts,173,0.06770,56602,22.14944,255546
57,Swikar,167,0.06535,56769,22.21479,255546
58,puneith,166,0.06496,56935,22.27975,255546
59,chauhang,162,0.06339,57097,22.34314,255546
60,orfeas-k,161,0.06300,57258,22.40614,255546
61,c-bata,159,0.06222,57417,22.46836,255546
62,ryansteakley,159,0.06222,57576,22.53058,255546
63,difince,158,0.06183,57734,22.59241,255546
64,munagekar,158,0.06183,57892,22.65424,255546
65,JOCSTAA,155,0.06065,58047,22.71489,255546
66,sasha-gitg,154,0.06026,58201,22.77516,255546
67,wsxiaozhang,154,0.06026,58355,22.83542,255546
68,elenzio9,152,0.05948,58507,22.89490,255546
69,chrisheecho,147,0.05752,58654,22.95242,255546
70,ifilonenko,143,0.05596,58797,23.00838,255546
71,kevinyu98,141,0.05518,58938,23.06356,255546
72,mbaijal,140,0.05478,59078,23.11834,255546
73,luotigerlsx,136,0.05322,59214,23.17156,255546
74,shrinath-suresh,135,0.05283,59349,23.22439,255546
75,zichuan-scott-xu,135,0.05283,59484,23.27722,255546
76,ajinkya933,132,0.05165,59616,23.32887,255546
77,Jimexist,132,0.05165,59748,23.38053,255546
78,kevinbache,125,0.04891,59873,23.42944,255546
79,tasos-ale,125,0.04891,59998,23.47836,255546
80,rpasricha,124,0.04852,60122,23.52688,255546
81,ananth102,123,0.04813,60245,23.57501,255546
82,sen-sam,121,0.04735,60366,23.62236,255546
83,vkoukis,120,0.04696,60486,23.66932,255546
84,cspavlou,119,0.04657,60605,23.71589,255546
85,mameshini,118,0.04618,60723,23.76206,255546
86,paveldournov,117,0.04578,60840,23.80785,255546
87,kuizhiqing,116,0.04539,60956,23.85324,255546
88,yupbank,115,0.04500,61071,23.89824,255546
89,ddutta,113,0.04422,61184,23.94246,255546
90,jal06,113,0.04422,61297,23.98668,255546
91,carmine,112,0.04383,61409,24.03051,255546
92,casassg,109,0.04265,61518,24.07316,255546
93,dsdinter,107,0.04187,61625,24.11503,255546
94,woop,107,0.04187,61732,24.15690,255546
95,ConverJens,105,0.04109,61837,24.19799,255546
96,jc2729,102,0.03991,61939,24.23791,255546
97,abcdefgs0324,101,0.03952,62040,24.27743,255546
98,jiaqianjing,101,0.03952,62141,24.31695,255546
99,DanSanche,100,0.03913,62241,24.35608,255546
100,elviraux,100,0.03913,62341,24.39522,255546
101,deepak-muley,98,0.03835,62439,24.43357,255546
102,NickLoukas,98,0.03835,62537,24.47192,255546
103,xiaozhouX,97,0.03796,62634,24.50987,255546
104,ajayalfred,96,0.03757,62730,24.54744,255546
105,alecglassford,96,0.03757,62826,24.58501,255546
106,JakeTheWise,96,0.03757,62922,24.62257,255546
107,ca-scribner,95,0.03718,63017,24.65975,255546
108,midhun1998,92,0.03600,63109,24.69575,255546
109,lynnmatrix,91,0.03561,63200,24.73136,255546
110,evan-hataishi,88,0.03444,63288,24.76580,255546
111,LaynePeng,88,0.03444,63376,24.80023,255546
112,dldaisy,85,0.03326,63461,24.83349,255546
113,ewilderj,85,0.03326,63546,24.86676,255546
114,lowang-bh,85,0.03326,63631,24.90002,255546
115,SaschaHeyer,85,0.03326,63716,24.93328,255546
116,xfate123,85,0.03326,63801,24.96654,255546
117,zanedurante,84,0.03287,63885,24.99941,255546
118,cyrilthank,83,0.03248,63968,25.03189,255546
119,cvenets,81,0.03170,64049,25.06359,255546
120,parthmishra,81,0.03170,64130,25.09529,255546
121,xhejtman,81,0.03170,64211,25.12698,255546
122,a9p,80,0.03131,64291,25.15829,255546
123,tduffy000,80,0.03131,64371,25.18959,255546
124,yashjakhotiya,80,0.03131,64451,25.22090,255546
125,KevinBNaughton,78,0.03052,64529,25.25142,255546
126,shaikmanu797,78,0.03052,64607,25.28195,255546
127,jackwhelpton,77,0.03013,64684,25.31208,255546
128,yilun-msft,77,0.03013,64761,25.34221,255546
129,nagar-ajay,76,0.02974,64837,25.37195,255546
130,wukong1992,76,0.02974,64913,25.40169,255546
131,aniruddhachoudhury,75,0.02935,64988,25.43104,255546
132,derekhh,75,0.02935,65063,25.46039,255546
133,OfficePop,75,0.02935,65138,25.48974,255546
134,shaowei-su,75,0.02935,65213,25.51908,255546
135,AlanFokCo,74,0.02896,65287,25.54804,255546
136,cleveryg,74,0.02896,65361,25.57700,255546
137,dreamryx,72,0.02817,65433,25.60517,255546
138,willb,72,0.02817,65505,25.63335,255546
139,AlexandreBrown,71,0.02778,65576,25.66113,255546
140,kd303,70,0.02739,65646,25.68853,255546
141,TobiasGoerke,69,0.02700,65715,25.71553,255546
142,toshi-k,69,0.02700,65784,25.74253,255546
143,QxiaoQ,68,0.02661,65852,25.76914,255546
144,yixinshi,68,0.02661,65920,25.79575,255546
145,Ajay191191,67,0.02622,65987,25.82197,255546
146,adriangonz,65,0.02544,66052,25.84740,255546
147,DeeperMind,65,0.02544,66117,25.87284,255546
148,rd-pong,65,0.02544,66182,25.89827,255546
149,tingweiwu,65,0.02544,66247,25.92371,255546
150,d-gol,63,0.02465,66310,25.94836,255546
151,jay-saldanha,63,0.02465,66373,25.97301,255546
152,nkashy1,63,0.02465,66436,25.99767,255546
153,radcheb,63,0.02465,66499,26.02232,255546
154,pingsutw,62,0.02426,66561,26.04658,255546
155,SeibertronSS,62,0.02426,66623,26.07084,255546
156,deadeyegoodwin,61,0.02387,66684,26.09471,255546
157,heluocs,61,0.02387,66745,26.11859,255546
158,tomalbrecht,61,0.02387,66806,26.14246,255546
159,judahrand,60,0.02348,66866,26.16593,255546
160,edi-bice-by,59,0.02309,66925,26.18902,255546
161,mofanke,59,0.02309,66984,26.21211,255546
162,AnyISalIn,58,0.02270,67042,26.23481,255546
163,toshiiw,58,0.02270,67100,26.25750,255546
164,asispatra,57,0.02231,67157,26.27981,255546
165,dwightjl,56,0.02191,67213,26.30172,255546
166,tiru1930,56,0.02191,67269,26.32364,255546
167,willingc,56,0.02191,67325,26.34555,255546
168,HeGaoYuan,55,0.02152,67380,26.36707,255546
169,PeterChg,55,0.02152,67435,26.38860,255546
170,raviranjan0309,55,0.02152,67490,26.41012,255546
171,jiyongjung0,54,0.02113,67544,26.43125,255546
172,edenbuaa,53,0.02074,67597,26.45199,255546
173,kelvins,53,0.02074,67650,26.47273,255546
174,kim-sardine,53,0.02074,67703,26.49347,255546
175,supertetelman,53,0.02074,67756,26.51421,255546
176,axel7083,52,0.02035,67808,26.53456,255546
177,Ruminateer,52,0.02035,67860,26.55491,255546
178,rummens,52,0.02035,67912,26.57525,255546
179,boarder7395,51,0.01996,67963,26.59521,255546
180,qiankunli,50,0.01957,68013,26.61478,255546
181,daikeshi,49,0.01917,68062,26.63395,255546
182,jdplatt,49,0.01917,68111,26.65313,255546
183,ldcastell,49,0.01917,68160,26.67230,255546
184,wdhorton,49,0.01917,68209,26.69148,255546
185,jsondai,48,0.01878,68257,26.71026,255546
186,prem0912,48,0.01878,68305,26.72904,255546
187,Realsen,48,0.01878,68353,26.74783,255546
188,sheevy,48,0.01878,68401,26.76661,255546
189,PatrickGhosn,47,0.01839,68448,26.78500,255546
190,rarkins,47,0.01839,68495,26.80339,255546
191,Shuai-Xie,47,0.01839,68542,26.82179,255546
192,akgraner,46,0.01800,68588,26.83979,255546
193,danishsamad,46,0.01800,68634,26.85779,255546
194,TimZaman,46,0.01800,68680,26.87579,255546
195,warf34,46,0.01800,68726,26.89379,255546
196,hlu09,45,0.01761,68771,26.91140,255546
197,amitripshtos,44,0.01722,68815,26.92862,255546
198,Hmr-ramzi,44,0.01722,68859,26.94583,255546
199,shuesc1,44,0.01722,68903,26.96305,255546
200,fxue,43,0.01683,68946,26.97988,255546
201,MATRIX4284,43,0.01683,68989,26.99671,255546
202,shotarok,43,0.01683,69032,27.01353,255546
203,bokleung,42,0.01644,69074,27.02997,255546
204,hackerboy01,42,0.01644,69116,27.04640,255546
205,jkuruba,42,0.01644,69158,27.06284,255546
206,ontheway16,42,0.01644,69200,27.07927,255546
207,ssheng,42,0.01644,69242,27.09571,255546
208,TrsNium,42,0.01644,69284,27.11214,255546
209,adilhusain-s,41,0.01604,69325,27.12819,255546
210,asahalyft,41,0.01604,69366,27.14423,255546
211,zlcnju,41,0.01604,69407,27.16028,255546
212,amitmukati-2604,40,0.01565,69447,27.17593,255546
213,jsitu777,40,0.01565,69487,27.19158,255546
214,mpvartak,40,0.01565,69527,27.20723,255546
215,shikha130vv,39,0.01526,69566,27.22250,255546
216,ynqa,39,0.01526,69605,27.23776,255546
217,Subreptivus,38,0.01487,69643,27.25263,255546
218,TheMichaelHu,38,0.01487,69681,27.26750,255546
219,vinayan3,38,0.01487,69719,27.28237,255546
220,asdfsx,37,0.01448,69756,27.29685,255546
221,chinmay22897,37,0.01448,69793,27.31133,255546
222,devxoxo,37,0.01448,69830,27.32580,255546
223,thedriftofwords,37,0.01448,69867,27.34028,255546
224,tingshua-yts,37,0.01448,69904,27.35476,255546
225,votti,37,0.01448,69941,27.36924,255546
226,yph152,37,0.01448,69978,27.38372,255546
227,372046933,36,0.01409,70014,27.39781,255546
228,aaron-arellano,36,0.01409,70050,27.41189,255546
229,anneum,36,0.01409,70086,27.42598,255546
230,haibingzhao,36,0.01409,70122,27.44007,255546
231,lehrig,36,0.01409,70158,27.45416,255546
232,pahask8,36,0.01409,70194,27.46824,255546
233,wengyao04,36,0.01409,70230,27.48233,255546
234,wg102,36,0.01409,70266,27.49642,255546
235,yoni-taranis,36,0.01409,70302,27.51051,255546
236,yzhaozh,36,0.01409,70338,27.52459,255546
237,carolynwang,35,0.01370,70373,27.53829,255546
238,jmsking,35,0.01370,70408,27.55199,255546
239,magencio,35,0.01370,70443,27.56568,255546
240,susan-shu-c,35,0.01370,70478,27.57938,255546
241,terrykong,35,0.01370,70513,27.59308,255546
242,vit-,35,0.01370,70548,27.60677,255546
243,yantriks-edi-bice,35,0.01370,70583,27.62047,255546
244,bartgras,34,0.01330,70617,27.63377,255546
245,jzp1025,34,0.01330,70651,27.64708,255546
246,libbyandhelen,34,0.01330,70685,27.66038,255546
247,plaffitte,34,0.01330,70719,27.67369,255546
248,seong7,34,0.01330,70753,27.68699,255546
249,shanidchamal,34,0.01330,70787,27.70030,255546
250,Utkagr,34,0.01330,70821,27.71360,255546
251,axelgobletbdr,33,0.01291,70854,27.72651,255546
252,ernestmartinez,33,0.01291,70887,27.73943,255546
253,leoncamel,33,0.01291,70920,27.75234,255546
254,rem20806,33,0.01291,70953,27.76526,255546
255,robbertvdg,33,0.01291,70986,27.77817,255546
256,royxue,33,0.01291,71019,27.79108,255546
257,ashahab,32,0.01252,71051,27.80360,255546
258,axelborja,32,0.01252,71083,27.81613,255546
259,b675987273,32,0.01252,71115,27.82865,255546
260,Dampolo03,32,0.01252,71147,27.84117,255546
261,hsinhoyeh,32,0.01252,71179,27.85369,255546
262,praveen049,32,0.01252,71211,27.86622,255546
263,rbrishabh,32,0.01252,71243,27.87874,255546
264,rc-coderepo,32,0.01252,71275,27.89126,255546
265,UrmsOne,32,0.01252,71307,27.90378,255546
266,vaskokj,32,0.01252,71339,27.91630,255546
267,ccarpentiere,31,0.01213,71370,27.92844,255546
268,codeflitting,31,0.01213,71401,27.94057,255546
269,connected-bsamadi,31,0.01213,71432,27.95270,255546
270,daganida88,31,0.01213,71463,27.96483,255546
271,descampsk,31,0.01213,71494,27.97696,255546
272,IMBurbank,31,0.01213,71525,27.98909,255546
273,janvdvegt,31,0.01213,71556,28.00122,255546
274,josepholaide,31,0.01213,71587,28.01335,255546
275,Manvi07,31,0.01213,71618,28.02548,255546
276,slenky,31,0.01213,71649,28.03761,255546
277,yylin1,31,0.01213,71680,28.04974,255546
278,arshashi,30,0.01174,71710,28.06148,255546
279,crmne,30,0.01174,71740,28.07322,255546
280,sulabh2000,30,0.01174,71770,28.08496,255546
281,XinkaiWang515,30,0.01174,71800,28.09670,255546
282,abkosar,29,0.01135,71829,28.10805,255546
283,frozeNinK,29,0.01135,71858,28.11940,255546
284,judyheflin,29,0.01135,71887,28.13075,255546
285,kindomLee,29,0.01135,71916,28.14210,255546
286,marrrcin,29,0.01135,71945,28.15344,255546
287,tedhtchang,29,0.01135,71974,28.16479,255546
288,wuchunghsuan,29,0.01135,72003,28.17614,255546
289,cloudbow,28,0.01096,72031,28.18710,255546
290,dwhitena,28,0.01096,72059,28.19805,255546
291,haijohn,28,0.01096,72087,28.20901,255546
292,kevinb9n,28,0.01096,72115,28.21997,255546
293,MaanavD,28,0.01096,72143,28.23093,255546
294,marcindulak,28,0.01096,72171,28.24188,255546
295,mszacillo,28,0.01096,72199,28.25284,255546
296,r-matsuzaka,28,0.01096,72227,28.26380,255546
297,simmscg,28,0.01096,72255,28.27475,255546
298,631068264,27,0.01057,72282,28.28532,255546
299,Josepholaidepetro,27,0.01057,72309,28.29588,255546
300,kosehy,27,0.01057,72336,28.30645,255546
301,Shaked,27,0.01057,72363,28.31702,255546
302,ShilpaGopal,27,0.01057,72390,28.32758,255546
303,wyljpn,27,0.01057,72417,28.33815,255546
304,zhangchunsheng,27,0.01057,72444,28.34871,255546
305,zhixian82,27,0.01057,72471,28.35928,255546
306,amrobbins,26,0.01017,72497,28.36945,255546
307,devgrok,26,0.01017,72523,28.37963,255546
308,faweis,26,0.01017,72549,28.38980,255546
309,jacobmalmberg,26,0.01017,72575,28.39997,255546
310,karthikvadla,26,0.01017,72601,28.41015,255546
311,micemuni,26,0.01017,72627,28.42032,255546
312,mtickoobb,26,0.01017,72653,28.43050,255546
313,pvgbabu,26,0.01017,72679,28.44067,255546
314,rky0930,26,0.01017,72705,28.45085,255546
315,rtrobin,26,0.01017,72731,28.46102,255546
316,shalberd,26,0.01017,72757,28.47120,255546
317,thuzhf,26,0.01017,72783,28.48137,255546
318,ucdmkt,26,0.01017,72809,28.49154,255546
319,valentin-stefan-popa,26,0.01017,72835,28.50172,255546
320,wyong16,26,0.01017,72861,28.51189,255546
321,alexandraj777,25,0.00978,72886,28.52168,255546
322,alsrgv,25,0.00978,72911,28.53146,255546
323,czheng94,25,0.00978,72936,28.54124,255546
324,decewei,25,0.00978,72961,28.55102,255546
325,ianhellstrom,25,0.00978,72986,28.56081,255546
326,khoa-ho,25,0.00978,73011,28.57059,255546
327,majorinche,25,0.00978,73036,28.58037,255546
328,mayankjuneja,25,0.00978,73061,28.59016,255546
329,panchul,25,0.00978,73086,28.59994,255546
330,samuelvl,25,0.00978,73111,28.60972,255546
331,solovyevt,25,0.00978,73136,28.61950,255546
332,ssiegel95,25,0.00978,73161,28.62929,255546
333,svalleru,25,0.00978,73186,28.63907,255546
334,Eric-Zhang1990,24,0.00939,73210,28.64846,255546
335,gilbeckers,24,0.00939,73234,28.65785,255546
336,g-votte,24,0.00939,73258,28.66725,255546
337,JavaDerek,24,0.00939,73282,28.67664,255546
338,jeremievallee,24,0.00939,73306,28.68603,255546
339,jiwang576,24,0.00939,73330,28.69542,255546
340,KingOnTheStar,24,0.00939,73354,28.70481,255546
341,kvalev,24,0.00939,73378,28.71420,255546
342,OyutianO,24,0.00939,73402,28.72360,255546
343,Peilun-Li,24,0.00939,73426,28.73299,255546
344,pvsousalima,24,0.00939,73450,28.74238,255546
345,ryantd,24,0.00939,73474,28.75177,255546
346,swamat,24,0.00939,73498,28.76116,255546
347,tmckayus,24,0.00939,73522,28.77055,255546
348,alongzhi,23,0.00900,73545,28.77955,255546
349,b4sus,23,0.00900,73568,28.78855,255546
350,chinhuang007,23,0.00900,73591,28.79756,255546
351,dalbhanj,23,0.00900,73614,28.80656,255546
352,huixa,23,0.00900,73637,28.81556,255546
353,jokerwenxiao,23,0.00900,73660,28.82456,255546
354,matthen,23,0.00900,73683,28.83356,255546
355,umialpha,23,0.00900,73706,28.84256,255546
356,umka1332,23,0.00900,73729,28.85156,255546
357,Aaronchoo,22,0.00861,73751,28.86017,255546
358,acesir,22,0.00861,73773,28.86878,255546
359,browningjp-datatonic,22,0.00861,73795,28.87738,255546
360,capt2101akash,22,0.00861,73817,28.88599,255546
361,cndaimin,22,0.00861,73839,28.89460,255546
362,DanaHan,22,0.00861,73861,28.90321,255546
363,Felihong,22,0.00861,73883,28.91182,255546
364,grapefruitL,22,0.00861,73905,28.92043,255546
365,JohnPaton,22,0.00861,73927,28.92904,255546
366,kramachandran,22,0.00861,73949,28.93765,255546
367,maanur,22,0.00861,73971,28.94626,255546
368,marwan116,22,0.00861,73993,28.95487,255546
369,ogre0403,22,0.00861,74015,28.96347,255546
370,oikomi,22,0.00861,74037,28.97208,255546
371,pranavpandit1,22,0.00861,74059,28.98069,255546
372,sahilmalav,22,0.00861,74081,28.98930,255546
373,vtlrazin,22,0.00861,74103,28.99791,255546
374,yurkoff-mv,22,0.00861,74125,29.00652,255546
375,AK-ayush,21,0.00822,74146,29.01474,255546
376,bvboca,21,0.00822,74167,29.02295,255546
377,Chaos-Ju,21,0.00822,74188,29.03117,255546
378,chongchuanbing,21,0.00822,74209,29.03939,255546
379,dzungductran,21,0.00822,74230,29.04761,255546
380,grobbie,21,0.00822,74251,29.05583,255546
381,hiyangbo,21,0.00822,74272,29.06404,255546
382,jizg,21,0.00822,74293,29.07226,255546
383,Julianxo,21,0.00822,74314,29.08048,255546
384,jwwandy,21,0.00822,74335,29.08870,255546
385,kbentaleb,21,0.00822,74356,29.09691,255546
386,mfojtak,21,0.00822,74377,29.10513,255546
387,mvartakAtVerta,21,0.00822,74398,29.11335,255546
388,prcastro,21,0.00822,74419,29.12157,255546
389,Ursanon,21,0.00822,74440,29.12978,255546
390,vaskozl,21,0.00822,74461,29.13800,255546
391,Windfarer,21,0.00822,74482,29.14622,255546
392,ysk24ok,21,0.00822,74503,29.15444,255546
393,ankan94,20,0.00783,74523,29.16226,255546
394,Arvind-Ideas2IT,20,0.00783,74543,29.17009,255546
395,dilzeem,20,0.00783,74563,29.17792,255546
396,happyhuman,20,0.00783,74583,29.18574,255546
397,kandrio98,20,0.00783,74603,29.19357,255546
398,Luke035,20,0.00783,74623,29.20140,255546
399,matty1979,20,0.00783,74643,29.20922,255546
400,otaviocv,20,0.00783,74663,29.21705,255546
401,tanguycdls,20,0.00783,74683,29.22488,255546
402,ulrikpl,20,0.00783,74703,29.23270,255546
403,xiaohanhuang,20,0.00783,74723,29.24053,255546
404,yassine-labidi,20,0.00783,74743,29.24835,255546
405,YesterdayxD,20,0.00783,74763,29.25618,255546
406,amalts,19,0.00744,74782,29.26362,255546
407,anifort,19,0.00744,74801,29.27105,255546
408,arllanos,19,0.00744,74820,29.27849,255546
409,CBischke,19,0.00744,74839,29.28592,255546
410,FlempTW,19,0.00744,74858,29.29336,255546
411,hno2,19,0.00744,74877,29.30079,255546
412,Iuiu1234,19,0.00744,74896,29.30823,255546
413,jmdevcs,19,0.00744,74915,29.31566,255546
414,lqj679ssn,19,0.00744,74934,29.32310,255546
415,plang85,19,0.00744,74953,29.33053,255546
416,pselden,19,0.00744,74972,29.33797,255546
417,smsperitus,19,0.00744,74991,29.34540,255546
418,strawberrypie,19,0.00744,75010,29.35284,255546
419,Syntax3rror404,19,0.00744,75029,29.36027,255546
420,szinck1,19,0.00744,75048,29.36771,255546
421,ytetra,19,0.00744,75067,29.37514,255546
422,allenc97,18,0.00704,75085,29.38219,255546
423,allenzfan,18,0.00704,75103,29.38923,255546
424,cfregly,18,0.00704,75121,29.39627,255546
425,chauvenne,18,0.00704,75139,29.40332,255546
426,Davidnet,18,0.00704,75157,29.41036,255546
427,hellobiek,18,0.00704,75175,29.41740,255546
428,himanshu9345,18,0.00704,75193,29.42445,255546
429,hitesh1907nayyar,18,0.00704,75211,29.43149,255546
430,juangon,18,0.00704,75229,29.43854,255546
431,leela-uppuluri,18,0.00704,75247,29.44558,255546
432,leonardosul,18,0.00704,75265,29.45262,255546
433,meibenjin,18,0.00704,75283,29.45967,255546
434,mochiliu3000,18,0.00704,75301,29.46671,255546
435,opus111,18,0.00704,75319,29.47375,255546
436,pthalasta,18,0.00704,75337,29.48080,255546
437,ptitzler,18,0.00704,75355,29.48784,255546
438,Rishit-dagli,18,0.00704,75373,29.49489,255546
439,SebBlin,18,0.00704,75391,29.50193,255546
440,SpontaneousDuck,18,0.00704,75409,29.50897,255546
441,vanpelt,18,0.00704,75427,29.51602,255546
442,wardVD,18,0.00704,75445,29.52306,255546
443,zoux86,18,0.00704,75463,29.53010,255546
444,andre-lx,17,0.00665,75480,29.53676,255546
445,cyzhangchenya,17,0.00665,75497,29.54341,255546
446,deepdad,17,0.00665,75514,29.55006,255546
447,dhodun,17,0.00665,75531,29.55671,255546
448,georgkaleido,17,0.00665,75548,29.56337,255546
449,Junaid-Ahmed94,17,0.00665,75565,29.57002,255546
450,ketangangal,17,0.00665,75582,29.57667,255546
451,kunalyogenshah,17,0.00665,75599,29.58332,255546
452,kweinmeister,17,0.00665,75616,29.58998,255546
453,larssuanet,17,0.00665,75633,29.59663,255546
454,panpanli521,17,0.00665,75650,29.60328,255546
455,PrathamSolanki,17,0.00665,75667,29.60993,255546
456,rimolive,17,0.00665,75684,29.61659,255546
457,sadeel,17,0.00665,75701,29.62324,255546
458,sm-hawkfish,17,0.00665,75718,29.62989,255546
459,vsk2015,17,0.00665,75735,29.63654,255546
460,wjddyd66,17,0.00665,75752,29.64320,255546
461,aakashbajaj,16,0.00626,75768,29.64946,255546
462,akchinSTC,16,0.00626,75784,29.65572,255546
463,alexeykaplin,16,0.00626,75800,29.66198,255546
464,ChenjunZou,16,0.00626,75816,29.66824,255546
465,chethanmahadevaiah,16,0.00626,75832,29.67450,255546
466,ckchow,16,0.00626,75848,29.68076,255546
467,fdasilva59,16,0.00626,75864,29.68702,255546
468,gabornyerges,16,0.00626,75880,29.69328,255546
469,gabrielvcbessa,16,0.00626,75896,29.69955,255546
470,gogogwwb,16,0.00626,75912,29.70581,255546
471,hackenzheng,16,0.00626,75928,29.71207,255546
472,halvgaard,16,0.00626,75944,29.71833,255546
473,jiaxuanzhou,16,0.00626,75960,29.72459,255546
474,jobvarkey,16,0.00626,75976,29.73085,255546
475,jspenc72,16,0.00626,75992,29.73711,255546
476,kairos03,16,0.00626,76008,29.74337,255546
477,meizabel,16,0.00626,76024,29.74963,255546
478,melihsqsp,16,0.00626,76040,29.75590,255546
479,michaelliqx,16,0.00626,76056,29.76216,255546
480,mmatiaschek,16,0.00626,76072,29.76842,255546
481,narennadig,16,0.00626,76088,29.77468,255546
482,prasadkyp7,16,0.00626,76104,29.78094,255546
483,RDelg,16,0.00626,76120,29.78720,255546
484,Rohithzr,16,0.00626,76136,29.79346,255546
485,SimonCqk,16,0.00626,76152,29.79972,255546
486,solarist,16,0.00626,76168,29.80598,255546
487,TaylorHere,16,0.00626,76184,29.81225,255546
488,typeness,16,0.00626,76200,29.81851,255546
489,wadhah101,16,0.00626,76216,29.82477,255546
490,wenmin-wu,16,0.00626,76232,29.83103,255546
491,AGKhalil,15,0.00587,76247,29.83690,255546
492,aheeruru,15,0.00587,76262,29.84277,255546
493,Akashdesarda,15,0.00587,76277,29.84864,255546
494,athamark,15,0.00587,76292,29.85451,255546
495,bkungfoo,15,0.00587,76307,29.86038,255546
496,chetanoruganti,15,0.00587,76322,29.86625,255546
497,dagondagon666,15,0.00587,76337,29.87212,255546
498,dalfos,15,0.00587,76352,29.87799,255546
499,dkajtoch,15,0.00587,76367,29.88386,255546
500,dtrawins,15,0.00587,76382,29.88973,255546
501,HongHuangNeu,15,0.00587,76397,29.89560,255546
502,kimkihoon0515,15,0.00587,76412,29.90147,255546
503,knave07,15,0.00587,76427,29.90734,255546
504,kpouget,15,0.00587,76442,29.91321,255546
505,LearnKen,15,0.00587,76457,29.91908,255546
506,martialblog,15,0.00587,76472,29.92495,255546
507,mohona17,15,0.00587,76487,29.93081,255546
508,mokpolar,15,0.00587,76502,29.93668,255546
509,omesser,15,0.00587,76517,29.94255,255546
510,rostam-github,15,0.00587,76532,29.94842,255546
511,RudraprakashR,15,0.00587,76547,29.95429,255546
512,sameerbhadouria,15,0.00587,76562,29.96016,255546
513,SheharyarTkxel,15,0.00587,76577,29.96603,255546
514,sports75482,15,0.00587,76592,29.97190,255546
515,summerisc,15,0.00587,76607,29.97777,255546
516,tretos53,15,0.00587,76622,29.98364,255546
517,vackysh,15,0.00587,76637,29.98951,255546
518,wajeehulhassanvii,15,0.00587,76652,29.99538,255546
519,wronk,15,0.00587,76667,30.00125,255546
520,wstian,15,0.00587,76682,30.00712,255546
521,yuhuishi-convect,15,0.00587,76697,30.01299,255546
522,zxsimple,15,0.00587,76712,30.01886,255546
523,aarondietz234,14,0.00548,76726,30.02434,255546
524,alexiguazio,14,0.00548,76740,30.02982,255546
525,anjalisood,14,0.00548,76754,30.03530,255546
526,BBK-PiJ-2015-41,14,0.00548,76768,30.04078,255546
527,ChethanUK,14,0.00548,76782,30.04625,255546
528,CraigSterrett,14,0.00548,76796,30.05173,255546
529,dandawg,14,0.00548,76810,30.05721,255546
530,dav009,14,0.00548,76824,30.06269,255546
531,DdMad,14,0.00548,76838,30.06817,255546
532,doschkinow,14,0.00548,76852,30.07365,255546
533,Everret-moon,14,0.00548,76866,30.07912,255546
534,farisfirenze,14,0.00548,76880,30.08460,255546
535,Farrellow,14,0.00548,76894,30.09008,255546
536,fyuan1316,14,0.00548,76908,30.09556,255546
537,GarnettWang,14,0.00548,76922,30.10104,255546
538,gogasca,14,0.00548,76936,30.10652,255546
539,gracechristina,14,0.00548,76950,30.11200,255546
540,gregbarkerdcsg,14,0.00548,76964,30.11747,255546
541,hwk42,14,0.00548,76978,30.12295,255546
542,iuiu34,14,0.00548,76992,30.12843,255546
543,jiahaoc1993,14,0.00548,77006,30.13391,255546
544,jiuntian,14,0.00548,77020,30.13939,255546
545,kangwoo,14,0.00548,77034,30.14487,255546
546,mkkb473,14,0.00548,77048,30.15034,255546
547,neolunar7,14,0.00548,77062,30.15582,255546
548,nlarusstone,14,0.00548,77076,30.16130,255546
549,owlet42,14,0.00548,77090,30.16678,255546
550,portellaa,14,0.00548,77104,30.17226,255546
551,post2web,14,0.00548,77118,30.17774,255546
552,Rstar1998,14,0.00548,77132,30.18322,255546
553,sabiroid,14,0.00548,77146,30.18869,255546
554,saffaalvi,14,0.00548,77160,30.19417,255546
555,skogsbrus,14,0.00548,77174,30.19965,255546
556,tarat44,14,0.00548,77188,30.20513,255546
557,tcnt,14,0.00548,77202,30.21061,255546
558,tlkh,14,0.00548,77216,30.21609,255546
559,toyow,14,0.00548,77230,30.22156,255546
560,wangkeqiang123,14,0.00548,77244,30.22704,255546
561,xawangyd,14,0.00548,77258,30.23252,255546
562,Youki,14,0.00548,77272,30.23800,255546
563,yuku,14,0.00548,77286,30.24348,255546
564,zzmao,14,0.00548,77300,30.24896,255546
565,Adarsh2910,13,0.00509,77313,30.25404,255546
566,aleb,13,0.00509,77326,30.25913,255546
567,alexisgaziello,13,0.00509,77339,30.26422,255546
568,ammarn911,13,0.00509,77352,30.26931,255546
569,anatolyzolotar,13,0.00509,77365,30.27439,255546
570,andrewsmartin,13,0.00509,77378,30.27948,255546
571,benoitdr,13,0.00509,77391,30.28457,255546
572,charlescurt,13,0.00509,77404,30.28965,255546
573,chingandy,13,0.00509,77417,30.29474,255546
574,DanielQujun,13,0.00509,77430,30.29983,255546
575,deepio-oc,13,0.00509,77443,30.30492,255546
576,dpaks,13,0.00509,77456,30.31000,255546
577,edhenry,13,0.00509,77469,30.31509,255546
578,edwardzjl,13,0.00509,77482,30.32018,255546
579,fboylu,13,0.00509,77495,30.32526,255546
580,fischor,13,0.00509,77508,30.33035,255546
581,gaodan-fang,13,0.00509,77521,30.33544,255546
582,hexiaoting,13,0.00509,77534,30.34053,255546
583,hyche,13,0.00509,77547,30.34561,255546
584,imiller445,13,0.00509,77560,30.35070,255546
585,jlzhao27,13,0.00509,77573,30.35579,255546
586,jmendesky,13,0.00509,77586,30.36087,255546
587,jrykr,13,0.00509,77599,30.36596,255546
588,kimchitsigai,13,0.00509,77612,30.37105,255546
589,krajasek,13,0.00509,77625,30.37614,255546
590,kylepad,13,0.00509,77638,30.38122,255546
591,lcax200000,13,0.00509,77651,30.38631,255546
592,LEDfan,13,0.00509,77664,30.39140,255546
593,Lijo050,13,0.00509,77677,30.39648,255546
594,ljainker,13,0.00509,77690,30.40157,255546
595,LY-today,13,0.00509,77703,30.40666,255546
596,Maerville,13,0.00509,77716,30.41175,255546
597,mockdone,13,0.00509,77729,30.41683,255546
598,mosn,13,0.00509,77742,30.42192,255546
599,mttcnnff,13,0.00509,77755,30.42701,255546
600,nachogarciam,13,0.00509,77768,30.43209,255546
601,NKUCodingCat,13,0.00509,77781,30.43718,255546
602,ohke,13,0.00509,77794,30.44227,255546
603,pablofiumara-azumo,13,0.00509,77807,30.44736,255546
604,RunOrVeith,13,0.00509,77820,30.45244,255546
605,rustam-ashurov-mcx,13,0.00509,77833,30.45753,255546
606,ryan-williams,13,0.00509,77846,30.46262,255546
607,SarathChandran,13,0.00509,77859,30.46770,255546
608,Shasvat0601,13,0.00509,77872,30.47279,255546
609,sidpalas,13,0.00509,77885,30.47788,255546
610,TrevorM15,13,0.00509,77898,30.48297,255546
611,webD97,13,0.00509,77911,30.48805,255546
612,XXXXIEHF,13,0.00509,77924,30.49314,255546
613,yingding,13,0.00509,77937,30.49823,255546
614,ykeuter,13,0.00509,77950,30.50331,255546
615,zoyun,13,0.00509,77963,30.50840,255546
616,0olwzo0,12,0.00470,77975,30.51310,255546
617,abaland,12,0.00470,77987,30.51779,255546
618,aeoluswing,12,0.00470,77999,30.52249,255546
619,aginpatrick,12,0.00470,78011,30.52718,255546
620,algs,12,0.00470,78023,30.53188,255546
621,AseiSugiyama,12,0.00470,78035,30.53658,255546
622,Aut0R3V,12,0.00470,78047,30.54127,255546
623,bdoohan-goog,12,0.00470,78059,30.54597,255546
624,bencwallace,12,0.00470,78071,30.55066,255546
625,BeneaAlinAndrei,12,0.00470,78083,30.55536,255546
626,bermudezmt,12,0.00470,78095,30.56006,255546
627,bwassie,12,0.00470,78107,30.56475,255546
628,davidyuyuan,12,0.00470,78119,30.56945,255546
629,dhanisahu,12,0.00470,78131,30.57414,255546
630,DontStopMeNow,12,0.00470,78143,30.57884,255546
631,dstnluong,12,0.00470,78155,30.58353,255546
632,enriquedacostacambio,12,0.00470,78167,30.58823,255546
633,gar1t,12,0.00470,78179,30.59293,255546
634,GerardoGR,12,0.00470,78191,30.59762,255546
635,guanhuichen,12,0.00470,78203,30.60232,255546
636,hefedev,12,0.00470,78215,30.60701,255546
637,hyeonsangjeon,12,0.00470,78227,30.61171,255546
638,Itega,12,0.00470,78239,30.61641,255546
639,izapolsk,12,0.00470,78251,30.62110,255546
640,javen218,12,0.00470,78263,30.62580,255546
641,jdumm,12,0.00470,78275,30.63049,255546
642,jidemoski,12,0.00470,78287,30.63519,255546
643,jmalobicky,12,0.00470,78299,30.63988,255546
644,jpatanooga,12,0.00470,78311,30.64458,255546
645,jq,12,0.00470,78323,30.64928,255546
646,kbthu,12,0.00470,78335,30.65397,255546
647,lauradang,12,0.00470,78347,30.65867,255546
648,Lejboelle,12,0.00470,78359,30.66336,255546
649,lomori,12,0.00470,78371,30.66806,255546
650,Lordfourteen,12,0.00470,78383,30.67276,255546
651,mai-nakagawa,12,0.00470,78395,30.67745,255546
652,meowcakes,12,0.00470,78407,30.68215,255546
653,m-mayran,12,0.00470,78419,30.68684,255546
654,Nagarajj,12,0.00470,78431,30.69154,255546
655,nihir27,12,0.00470,78443,30.69623,255546
656,nikhil-koul,12,0.00470,78455,30.70093,255546
657,nitesh31mishra,12,0.00470,78467,30.70563,255546
658,nongqiqin,12,0.00470,78479,30.71032,255546
659,owennewo,12,0.00470,78491,30.71502,255546
660,pshiko,12,0.00470,78503,30.71971,255546
661,RakeshRaj97,12,0.00470,78515,30.72441,255546
662,romeokienzler,12,0.00470,78527,30.72911,255546
663,shivaylamba,12,0.00470,78539,30.73380,255546
664,sid027,12,0.00470,78551,30.73850,255546
665,tkatila,12,0.00470,78563,30.74319,255546
666,TomomasaTakatori,12,0.00470,78575,30.74789,255546
667,virgoaugustine,12,0.00470,78587,30.75258,255546
668,vvnpan,12,0.00470,78599,30.75728,255546
669,wallacezzzzz007,12,0.00470,78611,30.76198,255546
670,WangAllen851018,12,0.00470,78623,30.76667,255546
671,WEICHINLIN,12,0.00470,78635,30.77137,255546
672,xiaowenxie5,12,0.00470,78647,30.77606,255546
673,yiyuanyu17,12,0.00470,78659,30.78076,255546
674,zidarko,12,0.00470,78671,30.78546,255546
675,zuston,12,0.00470,78683,30.79015,255546
676,aalugore-ai,11,0.00430,78694,30.79446,255546
677,ahsan-n,11,0.00430,78705,30.79876,255546
678,alexwennerberg,11,0.00430,78716,30.80306,255546
679,alforik,11,0.00430,78727,30.80737,255546
680,amybachir,11,0.00430,78738,30.81167,255546
681,andrewm4894,11,0.00430,78749,30.81598,255546
682,bbarnes52,11,0.00430,78760,30.82028,255546
683,berlinsaint,11,0.00430,78771,30.82459,255546
684,bsikander,11,0.00430,78782,30.82889,255546
685,cc-gb2,11,0.00430,78793,30.83320,255546
686,chaoleili,11,0.00430,78804,30.83750,255546
687,dkurt,11,0.00430,78815,30.84181,255546
688,dongdan39,11,0.00430,78826,30.84611,255546
689,durandom,11,0.00430,78837,30.85041,255546
690,gangliao,11,0.00430,78848,30.85472,255546
691,goldwinner,11,0.00430,78859,30.85902,255546
692,gosandhya,11,0.00430,78870,30.86333,255546
693,haudren,11,0.00430,78881,30.86763,255546
694,iankoulski,11,0.00430,78892,30.87194,255546
695,Intellicode,11,0.00430,78903,30.87624,255546
696,jagane-infinstor,11,0.00430,78914,30.88055,255546
697,JakeSummers,11,0.00430,78925,30.88485,255546
698,kamalmemon,11,0.00430,78936,30.88915,255546
699,kavemun,11,0.00430,78947,30.89346,255546
700,konsloiz,11,0.00430,78958,30.89776,255546
701,ksonbol,11,0.00430,78969,30.90207,255546
702,kuikuikuizzZ,11,0.00430,78980,30.90637,255546
703,LuChengTHU,11,0.00430,78991,30.91068,255546
704,luckyskg,11,0.00430,79002,30.91498,255546
705,lwj1980s,11,0.00430,79013,30.91929,255546
706,Mar-ai,11,0.00430,79024,30.92359,255546
707,marcjimz,11,0.00430,79035,30.92790,255546
708,MingfeiPan,11,0.00430,79046,30.93220,255546
709,mishraprafful,11,0.00430,79057,30.93650,255546
710,myonlyzzy,11,0.00430,79068,30.94081,255546
711,NeoKish,11,0.00430,79079,30.94511,255546
712,o0fatigue,11,0.00430,79090,30.94942,255546
713,omartin2010,11,0.00430,79101,30.95372,255546
714,Pallavi-28,11,0.00430,79112,30.95803,255546
715,ra312,11,0.00430,79123,30.96233,255546
716,raddaoui,11,0.00430,79134,30.96664,255546
717,rawkintrevo,11,0.00430,79145,30.97094,255546
718,reem,11,0.00430,79156,30.97525,255546
719,riklopfer,11,0.00430,79167,30.97955,255546
720,rionam,11,0.00430,79178,30.98385,255546
721,SatwikBhandiwad,11,0.00430,79189,30.98816,255546
722,soleares,11,0.00430,79200,30.99246,255546
723,songm28,11,0.00430,79211,30.99677,255546
724,soyuutaku,11,0.00430,79222,31.00107,255546
725,sshakeri,11,0.00430,79233,31.00538,255546
726,sunilfernandes,11,0.00430,79244,31.00968,255546
727,tarrade,11,0.00430,79255,31.01399,255546
728,thliang01,11,0.00430,79266,31.01829,255546
729,ThomaswellY,11,0.00430,79277,31.02259,255546
730,tinyma123,11,0.00430,79288,31.02690,255546
731,travishen,11,0.00430,79299,31.03120,255546
732,ultrons,11,0.00430,79310,31.03551,255546
733,vijay-nag,11,0.00430,79321,31.03981,255546
734,VoVAllen,11,0.00430,79332,31.04412,255546
735,whillas,11,0.00430,79343,31.04842,255546
736,ytsophie,11,0.00430,79354,31.05273,255546
737,zsaladin,11,0.00430,79365,31.05703,255546
738,41tair,10,0.00391,79375,31.06094,255546
739,achalshant,10,0.00391,79385,31.06486,255546
740,Aiden-Jeon,10,0.00391,79395,31.06877,255546
741,allenwux,10,0.00391,79405,31.07268,255546
742,andreafehrman,10,0.00391,79415,31.07660,255546
743,axeltidemann,10,0.00391,79425,31.08051,255546
744,bestowjay,10,0.00391,79435,31.08442,255546
745,blacksailer,10,0.00391,79445,31.08834,255546
746,clausagerskov,10,0.00391,79455,31.09225,255546
747,Crazybean-lwb,10,0.00391,79465,31.09616,255546
748,dynofu,10,0.00391,79475,31.10008,255546
749,eggiter,10,0.00391,79485,31.10399,255546
750,fahadh4ilyas,10,0.00391,79495,31.10790,255546
751,fakeburst,10,0.00391,79505,31.11182,255546
752,FaustineLi,10,0.00391,79515,31.11573,255546
753,haghabozorgi,10,0.00391,79525,31.11964,255546
754,iamshwin,10,0.00391,79535,31.12356,255546
755,insoo67park,10,0.00391,79545,31.12747,255546
756,JetMuffin,10,0.00391,79555,31.13138,255546
757,Jose-Matsuda,10,0.00391,79565,31.13529,255546
758,josiemundi,10,0.00391,79575,31.13921,255546
759,jszanto,10,0.00391,79585,31.14312,255546
760,krish0005,10,0.00391,79595,31.14703,255546
761,LinuxDevSecOps,10,0.00391,79605,31.15095,255546
762,LSC527,10,0.00391,79615,31.15486,255546
763,lvcaiping,10,0.00391,79625,31.15877,255546
764,martham93,10,0.00391,79635,31.16269,255546
765,marwanfahmi,10,0.00391,79645,31.16660,255546
766,MatthiasCarnein,10,0.00391,79655,31.17051,255546
767,mengdong,10,0.00391,79665,31.17443,255546
768,MeranaTona,10,0.00391,79675,31.17834,255546
769,metrofun,10,0.00391,79685,31.18225,255546
770,mmwebster,10,0.00391,79695,31.18617,255546
771,moey920,10,0.00391,79705,31.19008,255546
772,MohammadOmr,10,0.00391,79715,31.19399,255546
773,NicoG94,10,0.00391,79725,31.19791,255546
774,nihil0,10,0.00391,79735,31.20182,255546
775,ocherfas,10,0.00391,79745,31.20573,255546
776,omlomloml,10,0.00391,79755,31.20965,255546
777,pavanaiyar,10,0.00391,79765,31.21356,255546
778,pineking,10,0.00391,79775,31.21747,255546
779,pretidav,10,0.00391,79785,31.22138,255546
780,ReyRen,10,0.00391,79795,31.22530,255546
781,robertzsun-dev,10,0.00391,79805,31.22921,255546
782,RoyerRamirez,10,0.00391,79815,31.23312,255546
783,Rustastra,10,0.00391,79825,31.23704,255546
784,saumilsdk,10,0.00391,79835,31.24095,255546
785,sh0gg0th,10,0.00391,79845,31.24486,255546
786,Sharon-iguazio,10,0.00391,79855,31.24878,255546
787,shikajiro,10,0.00391,79865,31.25269,255546
788,SumLare,10,0.00391,79875,31.25660,255546
789,suned,10,0.00391,79885,31.26052,255546
790,sunnythepatel,10,0.00391,79895,31.26443,255546
791,sunzhaochang,10,0.00391,79905,31.26834,255546
792,tarjintor,10,0.00391,79915,31.27226,255546
793,thebinaryone1,10,0.00391,79925,31.27617,255546
794,tranlyvu,10,0.00391,79935,31.28008,255546
795,TranThanh96,10,0.00391,79945,31.28400,255546
796,tsuiot,10,0.00391,79955,31.28791,255546
797,typhoonzero,10,0.00391,79965,31.29182,255546
798,wangzewang,10,0.00391,79975,31.29574,255546
799,wilbry,10,0.00391,79985,31.29965,255546
800,wjhhuizi,10,0.00391,79995,31.30356,255546
801,xiaoxq,10,0.00391,80005,31.30747,255546
802,xybuty,10,0.00391,80015,31.31139,255546
803,yangyang919,10,0.00391,80025,31.31530,255546
804,yanp,10,0.00391,80035,31.31921,255546
805,zhangle-dev,10,0.00391,80045,31.32313,255546
806,3a78f807111,9,0.00352,80054,31.32665,255546
807,3dimaging,9,0.00352,80063,31.33017,255546
808,4everming,9,0.00352,80072,31.33369,255546
809,adepuravikrishna,9,0.00352,80081,31.33722,255546
810,akdigitalself,9,0.00352,80090,31.34074,255546
811,alexeygorobets,9,0.00352,80099,31.34426,255546
812,alicelee0606,9,0.00352,80108,31.34778,255546
813,allendred,9,0.00352,80117,31.35130,255546
814,alokumar1,9,0.00352,80126,31.35482,255546
815,AnberLu,9,0.00352,80135,31.35835,255546
816,andrewgdavis,9,0.00352,80144,31.36187,255546
817,arunnalpet,9,0.00352,80153,31.36539,255546
818,axelmagn,9,0.00352,80162,31.36891,255546
819,BenzhaminKim,9,0.00352,80171,31.37243,255546
820,bruce3557,9,0.00352,80180,31.37596,255546
821,cabjr,9,0.00352,80189,31.37948,255546
822,cah-parita-desai,9,0.00352,80198,31.38300,255546
823,ChaseLyall,9,0.00352,80207,31.38652,255546
824,crosvera,9,0.00352,80216,31.39004,255546
825,cwei44,9,0.00352,80225,31.39357,255546
826,D0m021ng,9,0.00352,80234,31.39709,255546
827,danieldn,9,0.00352,80243,31.40061,255546
828,deathemperor,9,0.00352,80252,31.40413,255546
829,dutingda,9,0.00352,80261,31.40765,255546
830,eavelardev,9,0.00352,80270,31.41117,255546
831,Eliacus,9,0.00352,80279,31.41470,255546
832,evonit,9,0.00352,80288,31.41822,255546
833,ezioliao,9,0.00352,80297,31.42174,255546
834,FrancisLfg,9,0.00352,80306,31.42526,255546
835,haomengchao,9,0.00352,80315,31.42878,255546
836,harshad16,9,0.00352,80324,31.43231,255546
837,ijackcy,9,0.00352,80333,31.43583,255546
838,IreneGi,9,0.00352,80342,31.43935,255546
839,IvyBazan,9,0.00352,80351,31.44287,255546
840,jalola,9,0.00352,80360,31.44639,255546
841,JessicaBarh,9,0.00352,80369,31.44992,255546
842,jinxingwang,9,0.00352,80378,31.45344,255546
843,joey100,9,0.00352,80387,31.45696,255546
844,johan-andersson01,9,0.00352,80396,31.46048,255546
845,jsnowacki,9,0.00352,80405,31.46400,255546
846,kevin85421,9,0.00352,80414,31.46752,255546
847,l1990790120,9,0.00352,80423,31.47105,255546
848,liuqi,9,0.00352,80432,31.47457,255546
849,lsuanet,9,0.00352,80441,31.47809,255546
850,martin-laurent,9,0.00352,80450,31.48161,255546
851,MenglingD,9,0.00352,80459,31.48513,255546
852,mhbuehler,9,0.00352,80468,31.48866,255546
853,migueltol22,9,0.00352,80477,31.49218,255546
854,mike0355,9,0.00352,80486,31.49570,255546
855,mikwieczorek,9,0.00352,80495,31.49922,255546
856,mojokb,9,0.00352,80504,31.50274,255546
857,molejnik-mergebit,9,0.00352,80513,31.50627,255546
858,monkey3199,9,0.00352,80522,31.50979,255546
859,motilalmeher,9,0.00352,80531,31.51331,255546
860,mukul-shaunik-nokia,9,0.00352,80540,31.51683,255546
861,padrian2s,9,0.00352,80549,31.52035,255546
862,PascalSchroederDE,9,0.00352,80558,31.52387,255546
863,person142,9,0.00352,80567,31.52740,255546
864,pjo256,9,0.00352,80576,31.53092,255546
865,prgawade,9,0.00352,80585,31.53444,255546
866,pvnguyen,9,0.00352,80594,31.53796,255546
867,romanzdk,9,0.00352,80603,31.54148,255546
868,SachinT95,9,0.00352,80612,31.54501,255546
869,sammy04,9,0.00352,80621,31.54853,255546
870,sarrourajerbi,9,0.00352,80630,31.55205,255546
871,sdf611097,9,0.00352,80639,31.55557,255546
872,shuaibiyy,9,0.00352,80648,31.55909,255546
873,speaknowpotato,9,0.00352,80657,31.56261,255546
874,statmike,9,0.00352,80666,31.56614,255546
875,tholop,9,0.00352,80675,31.56966,255546
876,tks-ai,9,0.00352,80684,31.57318,255546
877,twittidai,9,0.00352,80693,31.57670,255546
878,VaishnaviHire,9,0.00352,80702,31.58022,255546
879,vladislavkoz,9,0.00352,80711,31.58375,255546
880,wanglj-lanzer,9,0.00352,80720,31.58727,255546
881,wynn5a,9,0.00352,80729,31.59079,255546
882,zuowang,9,0.00352,80738,31.59431,255546
883,814HiManny,8,0.00313,80746,31.59744,255546
884,AahanSingh,8,0.00313,80754,31.60057,255546
885,abhiverma1924,8,0.00313,80762,31.60370,255546
886,Aditya-171,8,0.00313,80770,31.60683,255546
887,alan-krumholz,8,0.00313,80778,31.60996,255546
888,alishaIBM,8,0.00313,80786,31.61310,255546
889,andrewferlitsch,8,0.00313,80794,31.61623,255546
890,areshytko,8,0.00313,80802,31.61936,255546
891,arshyasharifian,8,0.00313,80810,31.62249,255546
892,aurorazl,8,0.00313,80818,31.62562,255546
893,austynherman,8,0.00313,80826,31.62875,255546
894,aychang95,8,0.00313,80834,31.63188,255546
895,AymenFJA,8,0.00313,80842,31.63501,255546
896,BioGeek,8,0.00313,80850,31.63814,255546
897,bmenn,8,0.00313,80858,31.64127,255546
898,brentchang,8,0.00313,80866,31.64440,255546
899,butzist,8,0.00313,80874,31.64753,255546
900,catalinad90,8,0.00313,80882,31.65066,255546
901,cbreuel,8,0.00313,80890,31.65379,255546
902,chenwenjun-github,8,0.00313,80898,31.65692,255546
903,Corea,8,0.00313,80906,31.66005,255546
904,crauterb,8,0.00313,80914,31.66318,255546
905,crbl1122,8,0.00313,80922,31.66631,255546
906,danijar,8,0.00313,80930,31.66945,255546
907,deepakm-ntnx,8,0.00313,80938,31.67258,255546
908,deepyaman,8,0.00313,80946,31.67571,255546
909,dpoulopoulos,8,0.00313,80954,31.67884,255546
910,EdwinZzy,8,0.00313,80962,31.68197,255546
911,eminemence,8,0.00313,80970,31.68510,255546
912,erolco,8,0.00313,80978,31.68823,255546
913,FFede0,8,0.00313,80986,31.69136,255546
914,Focke-Wulf,8,0.00313,80994,31.69449,255546
915,GigliOneiric,8,0.00313,81002,31.69762,255546
916,Hachimaki,8,0.00313,81010,31.70075,255546
917,ifuwang,8,0.00313,81018,31.70388,255546
918,irabanillo91,8,0.00313,81026,31.70701,255546
919,irhawks,8,0.00313,81034,31.71014,255546
920,ivanmkc,8,0.00313,81042,31.71327,255546
921,jazka,8,0.00313,81050,31.71640,255546
922,jhagege,8,0.00313,81058,31.71953,255546
923,jhua18,8,0.00313,81066,31.72266,255546
924,jimbudarz,8,0.00313,81074,31.72579,255546
925,JK-97,8,0.00313,81082,31.72893,255546
926,jl-massey,8,0.00313,81090,31.73206,255546
927,juliadeclared,8,0.00313,81098,31.73519,255546
928,k402xxxcenxxx,8,0.00313,81106,31.73832,255546
929,kandrio,8,0.00313,81114,31.74145,255546
930,kbc8894,8,0.00313,81122,31.74458,255546
931,KCFindstr,8,0.00313,81130,31.74771,255546
932,kdubovikov,8,0.00313,81138,31.75084,255546
933,khani92,8,0.00313,81146,31.75397,255546
934,Kulikovpavel,8,0.00313,81154,31.75710,255546
935,LuBingtan,8,0.00313,81162,31.76023,255546
936,lucasaytt,8,0.00313,81170,31.76336,255546
937,magick93,8,0.00313,81178,31.76649,255546
938,maorlipchuk,8,0.00313,81186,31.76962,255546
939,MattSich,8,0.00313,81194,31.77275,255546
940,MaxGrtz,8,0.00313,81202,31.77588,255546
941,mcantrell,8,0.00313,81210,31.77901,255546
942,mgyong,8,0.00313,81218,31.78214,255546
943,mikel-brostrom,8,0.00313,81226,31.78528,255546
944,missingcharacter,8,0.00313,81234,31.78841,255546
945,mjurkus,8,0.00313,81242,31.79154,255546
946,monoidus,8,0.00313,81250,31.79467,255546
947,myqq0000,8,0.00313,81258,31.79780,255546
948,nepalineupane,8,0.00313,81266,31.80093,255546
949,netankit,8,0.00313,81274,31.80406,255546
950,Neytoph,8,0.00313,81282,31.80719,255546
951,nico-kuzak,8,0.00313,81290,31.81032,255546
952,nkflash,8,0.00313,81298,31.81345,255546
953,oxxygenio,8,0.00313,81306,31.81658,255546
954,Padarn,8,0.00313,81314,31.81971,255546
955,pavanky,8,0.00313,81322,31.82284,255546
956,pconrad-fb,8,0.00313,81330,31.82597,255546
957,PingYufeng,8,0.00313,81338,31.82910,255546
958,psheorangithub,8,0.00313,81346,31.83223,255546
959,pwzhong,8,0.00313,81354,31.83536,255546
960,Rasen-wq,8,0.00313,81362,31.83849,255546
961,rbq,8,0.00313,81370,31.84163,255546
962,sam0996,8,0.00313,81378,31.84476,255546
963,sasvaritoni,8,0.00313,81386,31.84789,255546
964,shichengsg001,8,0.00313,81394,31.85102,255546
965,songkane,8,0.00313,81402,31.85415,255546
966,stsukrov,8,0.00313,81410,31.85728,255546
967,thomas-mueller,8,0.00313,81418,31.86041,255546
968,tinuxnet,8,0.00313,81426,31.86354,255546
969,uniuuu,8,0.00313,81434,31.86667,255546
970,velascoluis,8,0.00313,81442,31.86980,255546
971,wakanapo,8,0.00313,81450,31.87293,255546
972,whiletruelearn,8,0.00313,81458,31.87606,255546
973,x28646510,8,0.00313,81466,31.87919,255546
974,xiabo2011,8,0.00313,81474,31.88232,255546
975,xiaonancc77,8,0.00313,81482,31.88545,255546
976,xiaqunfeng,8,0.00313,81490,31.88858,255546
977,xqqcoder,8,0.00313,81498,31.89171,255546
978,xRagnorokx,8,0.00313,81506,31.89484,255546
979,yosit,8,0.00313,81514,31.89798,255546
980,zamonia500,8,0.00313,81522,31.90111,255546
981,15162162323,7,0.00274,81529,31.90385,255546
982,abin-thomas-by,7,0.00274,81536,31.90658,255546
983,adityaparamesh,7,0.00274,81543,31.90932,255546
984,andrea-cola,7,0.00274,81550,31.91206,255546
985,andreeamun,7,0.00274,81557,31.91480,255546
986,andresmascl,7,0.00274,81564,31.91754,255546
987,andyi2it,7,0.00274,81571,31.92028,255546
988,AnnieWei58,7,0.00274,81578,31.92302,255546
989,azarezade,7,0.00274,81585,31.92576,255546
990,BAlmeidaS,7,0.00274,81592,31.92850,255546
991,bebe424,7,0.00274,81599,31.93124,255546
992,bobmayuze,7,0.00274,81606,31.93398,255546
993,bryanpaget,7,0.00274,81613,31.93672,255546
994,Can-Sahin,7,0.00274,81620,31.93946,255546
995,cchanley2003,7,0.00274,81627,31.94219,255546
996,ccrrvvaa,7,0.00274,81634,31.94493,255546
997,celiawa,7,0.00274,81641,31.94767,255546
998,celinew1221,7,0.00274,81648,31.95041,255546
999,Crisescode,7,0.00274,81655,31.95315,255546
1000,CZYCW,7,0.00274,81662,31.95589,255546
1001,D4Lta,7,0.00274,81669,31.95863,255546
1002,dakoner,7,0.00274,81676,31.96137,255546
1003,dbg-raghulkrishna,7,0.00274,81683,31.96411,255546
1004,devashishshankar,7,0.00274,81690,31.96685,255546
1005,drozzy,7,0.00274,81697,31.96959,255546
1006,Edilmo,7,0.00274,81704,31.97233,255546
1007,edu-ap,7,0.00274,81711,31.97507,255546
1008,emenendez,7,0.00274,81718,31.97780,255546
1009,enricomarchesin,7,0.00274,81725,31.98054,255546
1010,ereil,7,0.00274,81732,31.98328,255546
1011,eshaingle,7,0.00274,81739,31.98602,255546
1012,galv,7,0.00274,81746,31.98876,255546
1013,GetOn4,7,0.00274,81753,31.99150,255546
1014,goodpp,7,0.00274,81760,31.99424,255546
1015,goyalankit,7,0.00274,81767,31.99698,255546
1016,gpotti,7,0.00274,81774,31.99972,255546
1017,GuoHaiqing,7,0.00274,81781,32.00246,255546
1018,harperjuanl,7,0.00274,81788,32.00520,255546
1019,hassanzadeh,7,0.00274,81795,32.00794,255546
1020,hmizuma,7,0.00274,81802,32.01068,255546
1021,HumairAK,7,0.00274,81809,32.01341,255546
1022,iantowey,7,0.00274,81816,32.01615,255546
1023,imicer,7,0.00274,81823,32.01889,255546
1024,Jason-CKY,7,0.00274,81830,32.02163,255546
1025,Jeet-14,7,0.00274,81837,32.02437,255546
1026,jimthompson5802,7,0.00274,81844,32.02711,255546
1027,jjf130,7,0.00274,81851,32.02985,255546
1028,joepeskett,7,0.00274,81858,32.03259,255546
1029,jotaylo,7,0.00274,81865,32.03533,255546
1030,jpe316,7,0.00274,81872,32.03807,255546
1031,kruthikakr,7,0.00274,81879,32.04081,255546
1032,kurianbenoy,7,0.00274,81886,32.04355,255546
1033,kvamshi,7,0.00274,81893,32.04629,255546
1034,lanya16,7,0.00274,81900,32.04902,255546
1035,laserK3000,7,0.00274,81907,32.05176,255546
1036,lresende,7,0.00274,81914,32.05450,255546
1037,LRSutton,7,0.00274,81921,32.05724,255546
1038,LukasBlank,7,0.00274,81928,32.05998,255546
1039,mageirakos,7,0.00274,81935,32.06272,255546
1040,maniappan,7,0.00274,81942,32.06546,255546
1041,markgeejw,7,0.00274,81949,32.06820,255546
1042,mattiasarro,7,0.00274,81956,32.07094,255546
1043,maxdebayser,7,0.00274,81963,32.07368,255546
1044,mChowdhury-91,7,0.00274,81970,32.07642,255546
1045,mertkavi,7,0.00274,81977,32.07916,255546
1046,milkybird98,7,0.00274,81984,32.08190,255546
1047,MISSEY,7,0.00274,81991,32.08463,255546
1048,montenegrodr,7,0.00274,81998,32.08737,255546
1049,mousam-singh,7,0.00274,82005,32.09011,255546
1050,mvwestendorp,7,0.00274,82012,32.09285,255546
1051,NettrixTobin,7,0.00274,82019,32.09559,255546
1052,NicholaiStaalung,7,0.00274,82026,32.09833,255546
1053,nielsmeima,7,0.00274,82033,32.10107,255546
1054,Niuxiaotong,7,0.00274,82040,32.10381,255546
1055,nkosteski,7,0.00274,82047,32.10655,255546
1056,oemergenc,7,0.00274,82054,32.10929,255546
1057,OpenZSD,7,0.00274,82061,32.11203,255546
1058,razumv,7,0.00274,82068,32.11477,255546
1059,rhc54,7,0.00274,82075,32.11751,255546
1060,rickysage,7,0.00274,82082,32.12024,255546
1061,rodrigocaus,7,0.00274,82089,32.12298,255546
1062,rrrkharse,7,0.00274,82096,32.12572,255546
1063,rylynchen,7,0.00274,82103,32.12846,255546
1064,ryo-matsuzaka,7,0.00274,82110,32.13120,255546
1065,sfujiwara,7,0.00274,82117,32.13394,255546
1066,shalankig,7,0.00274,82124,32.13668,255546
1067,shibuiwilliam,7,0.00274,82131,32.13942,255546
1068,shotarohorai,7,0.00274,82138,32.14216,255546
1069,Sim4n6,7,0.00274,82145,32.14490,255546
1070,skgreenstar,7,0.00274,82152,32.14764,255546
1071,sneelz,7,0.00274,82159,32.15038,255546
1072,snowlover173,7,0.00274,82166,32.15312,255546
1073,sshuair,7,0.00274,82173,32.15585,255546
1074,stephenhenderson,7,0.00274,82180,32.15859,255546
1075,stevebanik,7,0.00274,82187,32.16133,255546
1076,subhabratabanerjee,7,0.00274,82194,32.16407,255546
1077,sunilvb,7,0.00274,82201,32.16681,255546
1078,Suozz,7,0.00274,82208,32.16955,255546
1079,tech348712013870132,7,0.00274,82215,32.17229,255546
1080,theophilee,7,0.00274,82222,32.17503,255546
1081,thetko85,7,0.00274,82229,32.17777,255546
1082,titansmc,7,0.00274,82236,32.18051,255546
1083,Toeplitz,7,0.00274,82243,32.18325,255546
1084,tripti-singhal,7,0.00274,82250,32.18599,255546
1085,ultraji,7,0.00274,82257,32.18873,255546
1086,veliborfrobas,7,0.00274,82264,32.19146,255546
1087,WalterSmuts,7,0.00274,82271,32.19420,255546
1088,WillianFuks,7,0.00274,82278,32.19694,255546
1089,wodecki,7,0.00274,82285,32.19968,255546
1090,xiaoyili,7,0.00274,82292,32.20242,255546
1091,XinchenWan,7,0.00274,82299,32.20516,255546
1092,yongwen,7,0.00274,82306,32.20790,255546
1093,yptheangel,7,0.00274,82313,32.21064,255546
1094,zengqingfu1442,7,0.00274,82320,32.21338,255546
1095,zmdelima,7,0.00274,82327,32.21612,255546
1096,zygm0nt,7,0.00274,82334,32.21886,255546
1097,13567436138,6,0.00235,82340,32.22120,255546
1098,aaltay,6,0.00235,82346,32.22355,255546
1099,AbelThorne,6,0.00235,82352,32.22590,255546
1100,achandras,6,0.00235,82358,32.22825,255546
1101,adriangay,6,0.00235,82364,32.23060,255546
1102,aflc,6,0.00235,82370,32.23294,255546
1103,akiyamasho,6,0.00235,82376,32.23529,255546
1104,aktivalux,6,0.00235,82382,32.23764,255546
1105,alanhdu,6,0.00235,82388,32.23999,255546
1106,alefesta,6,0.00235,82394,32.24234,255546
1107,amalendur,6,0.00235,82400,32.24468,255546
1108,AndrewMcFarren,6,0.00235,82406,32.24703,255546
1109,anishasthana,6,0.00235,82412,32.24938,255546
1110,ardeshir,6,0.00235,82418,32.25173,255546
1111,asahnovskiy-deloitte,6,0.00235,82424,32.25408,255546
1112,beatgeek,6,0.00235,82430,32.25642,255546
1113,benash,6,0.00235,82436,32.25877,255546
1114,biaochen,6,0.00235,82442,32.26112,255546
1115,boniek83,6,0.00235,82448,32.26347,255546
1116,brettkoonce,6,0.00235,82454,32.26582,255546
1117,busunkim96,6,0.00235,82460,32.26816,255546
1118,calvinleungyk,6,0.00235,82466,32.27051,255546
1119,capkurmagati,6,0.00235,82472,32.27286,255546
1120,chaitanyak52,6,0.00235,82478,32.27521,255546
1121,CharlesxrWu,6,0.00235,82484,32.27755,255546
1122,chenwenjun1995,6,0.00235,82490,32.27990,255546
1123,chiefkarlin,6,0.00235,82496,32.28225,255546
1124,CosyOranges,6,0.00235,82502,32.28460,255546
1125,d123456temp,6,0.00235,82508,32.28695,255546
1126,d34th4ck3r,6,0.00235,82514,32.28929,255546
1127,dakl,6,0.00235,82520,32.29164,255546
1128,dale88,6,0.00235,82526,32.29399,255546
1129,defoishugo,6,0.00235,82532,32.29634,255546
1130,denis-angilella,6,0.00235,82538,32.29869,255546
1131,DennisVis,6,0.00235,82544,32.30103,255546
1132,disktnk,6,0.00235,82550,32.30338,255546
1133,divinerapier,6,0.00235,82556,32.30573,255546
1134,DurivetMatthias,6,0.00235,82562,32.30808,255546
1135,eastlunar,6,0.00235,82568,32.31043,255546
1136,EClaydon,6,0.00235,82574,32.31277,255546
1137,EdwardZhang88,6,0.00235,82580,32.31512,255546
1138,ericandrewmeadows,6,0.00235,82586,32.31747,255546
1139,ErikEngerd,6,0.00235,82592,32.31982,255546
1140,etsyamitra,6,0.00235,82598,32.32217,255546
1141,fabianvdW,6,0.00235,82604,32.32451,255546
1142,fedeesku1,6,0.00235,82610,32.32686,255546
1143,ferrgo,6,0.00235,82616,32.32921,255546
1144,FrancisLennon17,6,0.00235,82622,32.33156,255546
1145,fstetic,6,0.00235,82628,32.33390,255546
1146,gachiemchiep,6,0.00235,82634,32.33625,255546
1147,gbin10533,6,0.00235,82640,32.33860,255546
1148,GdMacmillan,6,0.00235,82646,32.34095,255546
1149,ggodreau,6,0.00235,82652,32.34330,255546
1150,gidutz,6,0.00235,82658,32.34564,255546
1151,gitpushdashf,6,0.00235,82664,32.34799,255546
1152,goodoid,6,0.00235,82670,32.35034,255546
1153,gsunner,6,0.00235,82676,32.35269,255546
1154,halftan,6,0.00235,82682,32.35504,255546
1155,hanpeiyu94,6,0.00235,82688,32.35738,255546
1156,hansaimlim,6,0.00235,82694,32.35973,255546
1157,HelmiGH,6,0.00235,82700,32.36208,255546
1158,hjkkhj123,6,0.00235,82706,32.36443,255546
1159,iavinas,6,0.00235,82712,32.36678,255546
1160,ID56,6,0.00235,82718,32.36912,255546
1161,iyera,6,0.00235,82724,32.37147,255546
1162,jaffe-fly,6,0.00235,82730,32.37382,255546
1163,jaiganeshp,6,0.00235,82736,32.37617,255546
1164,jdoliner,6,0.00235,82742,32.37852,255546
1165,jerrylam,6,0.00235,82748,32.38086,255546
1166,jielou,6,0.00235,82754,32.38321,255546
1167,jmdinis,6,0.00235,82760,32.38556,255546
1168,JoeyZwicker,6,0.00235,82766,32.38791,255546
1169,johnhoman,6,0.00235,82772,32.39025,255546
1170,jorwalk,6,0.00235,82778,32.39260,255546
1171,JoshZastrow,6,0.00235,82784,32.39495,255546
1172,juanvasquezreyes,6,0.00235,82790,32.39730,255546
1173,julioyildo,6,0.00235,82796,32.39965,255546
1174,junhuihuang,6,0.00235,82802,32.40199,255546
1175,jw-websensa,6,0.00235,82808,32.40434,255546
1176,jzfb2,6,0.00235,82814,32.40669,255546
1177,kaka11chen,6,0.00235,82820,32.40904,255546
1178,kalyc,6,0.00235,82826,32.41139,255546
1179,KausthubK,6,0.00235,82832,32.41373,255546
1180,keeplearnin,6,0.00235,82838,32.41608,255546
1181,kidddddddddddddddddddddd,6,0.00235,82844,32.41843,255546
1182,kinglion811,6,0.00235,82850,32.42078,255546
1183,kotalakshman,6,0.00235,82856,32.42313,255546
1184,kunallimaye,6,0.00235,82862,32.42547,255546
1185,lakshmanok,6,0.00235,82868,32.42782,255546
1186,LifeArchitect,6,0.00235,82874,32.43017,255546
1187,linpingta,6,0.00235,82880,32.43252,255546
1188,liorshk,6,0.00235,82886,32.43486,255546
1189,lovishch20,6,0.00235,82892,32.43721,255546
1190,lxl910915,6,0.00235,82898,32.43956,255546
1191,madhukarkm,6,0.00235,82904,32.44191,255546
1192,MainRo,6,0.00235,82910,32.44426,255546
1193,matkosoric,6,0.00235,82916,32.44660,255546
1194,mcminis1,6,0.00235,82922,32.44895,255546
1195,meandmymind,6,0.00235,82928,32.45130,255546
1196,MengYuanTsai,6,0.00235,82934,32.45365,255546
1197,micmarty-deepsense,6,0.00235,82940,32.45600,255546
1198,Mithil467,6,0.00235,82946,32.45834,255546
1199,MLHafizur,6,0.00235,82952,32.46069,255546
1200,mmuppidi,6,0.00235,82958,32.46304,255546
1201,mshaikh786,6,0.00235,82964,32.46539,255546
1202,mtszkw,6,0.00235,82970,32.46774,255546
1203,mumarniaz,6,0.00235,82976,32.47008,255546
1204,namlh16,6,0.00235,82982,32.47243,255546
1205,nanduri1998,6,0.00235,82988,32.47478,255546
1206,nicokuzak,6,0.00235,82994,32.47713,255546
1207,NightLightTw,6,0.00235,83000,32.47948,255546
1208,nikhilsharma93,6,0.00235,83006,32.48182,255546
1209,nkrish1983,6,0.00235,83012,32.48417,255546
1210,nosmatch,6,0.00235,83018,32.48652,255546
1211,oncekey,6,0.00235,83024,32.48887,255546
1212,oonisim,6,0.00235,83030,32.49121,255546
1213,patrickpoirson,6,0.00235,83036,32.49356,255546
1214,peemblis,6,0.00235,83042,32.49591,255546
1215,PercyLau,6,0.00235,83048,32.49826,255546
1216,phoenixwu0229,6,0.00235,83054,32.50061,255546
1217,prashanthb-ai,6,0.00235,83060,32.50295,255546
1218,Princy-Malhotra,6,0.00235,83066,32.50530,255546
1219,priya170807,6,0.00235,83072,32.50765,255546
1220,pyang-aurora,6,0.00235,83078,32.51000,255546
1221,qifengz,6,0.00235,83084,32.51235,255546
1222,quanguachong,6,0.00235,83090,32.51469,255546
1223,rado-parrak,6,0.00235,83096,32.51704,255546
1224,rajesh-chawla,6,0.00235,83102,32.51939,255546
1225,randombishop,6,0.00235,83108,32.52174,255546
1226,raven-jia,6,0.00235,83114,32.52409,255546
1227,RDarrylR,6,0.00235,83120,32.52643,255546
1228,rileygreen-ncs,6,0.00235,83126,32.52878,255546
1229,Roma110,6,0.00235,83132,32.53113,255546
1230,saksham93,6,0.00235,83138,32.53348,255546
1231,saurabh24292,6,0.00235,83144,32.53583,255546
1232,sbakiu,6,0.00235,83150,32.53817,255546
1233,seoha-kim,6,0.00235,83156,32.54052,255546
1234,sharmahemlata,6,0.00235,83162,32.54287,255546
1235,shouryaotta,6,0.00235,83168,32.54522,255546
1236,siddharthjain1611,6,0.00235,83174,32.54756,255546
1237,simon-mo,6,0.00235,83180,32.54991,255546
1238,Soot3,6,0.00235,83186,32.55226,255546
1239,spots107,6,0.00235,83192,32.55461,255546
1240,srinjay-paul,6,0.00235,83198,32.55696,255546
1241,stomplee,6,0.00235,83204,32.55930,255546
1242,tClelford,6,0.00235,83210,32.56165,255546
1243,tidylobster,6,0.00235,83216,32.56400,255546
1244,tiliter-algorithms,6,0.00235,83222,32.56635,255546
1245,tongtaott,6,0.00235,83228,32.56870,255546
1246,Ventals,6,0.00235,83234,32.57104,255546
1247,vincentarthur,6,0.00235,83240,32.57339,255546
1248,vinnysenthil,6,0.00235,83246,32.57574,255546
1249,vkoppisetti-verisk,6,0.00235,83252,32.57809,255546
1250,vlagache,6,0.00235,83258,32.58044,255546
1251,vswami78,6,0.00235,83264,32.58278,255546
1252,wave112,6,0.00235,83270,32.58513,255546
1253,wcass77,6,0.00235,83276,32.58748,255546
1254,WestonLu,6,0.00235,83282,32.58983,255546
1255,xaoo,6,0.00235,83288,32.59218,255546
1256,yanqiangmiffy,6,0.00235,83294,32.59452,255546
1257,yarnabrina,6,0.00235,83300,32.59687,255546
1258,yetone,6,0.00235,83306,32.59922,255546
1259,yuanbw,6,0.00235,83312,32.60157,255546
1260,zeusro,6,0.00235,83318,32.60391,255546
1261,14sudharsan,5,0.00196,83323,32.60587,255546
1262,482170765,5,0.00196,83328,32.60783,255546
1263,Abhi3linku,5,0.00196,83333,32.60978,255546
1264,agemocui,5,0.00196,83338,32.61174,255546
1265,agnz,5,0.00196,83343,32.61370,255546
1266,aichiludan,5,0.00196,83348,32.61565,255546
1267,aisensiy,5,0.00196,83353,32.61761,255546
1268,AkashDharani,5,0.00196,83358,32.61957,255546
1269,akfmdl,5,0.00196,83363,32.62152,255546
1270,akshaydtada,5,0.00196,83368,32.62348,255546
1271,AlecZebrick,5,0.00196,83373,32.62544,255546
1272,AlexanderEkdahl,5,0.00196,83378,32.62739,255546
1273,alimhanif,5,0.00196,83383,32.62935,255546
1274,ali-raza-tariq,5,0.00196,83388,32.63131,255546
1275,Amitg1,5,0.00196,83393,32.63326,255546
1276,amolsr,5,0.00196,83398,32.63522,255546
1277,and-1,5,0.00196,83403,32.63718,255546
1278,Anderssorby,5,0.00196,83408,32.63913,255546
1279,anilreddyv,5,0.00196,83413,32.64109,255546
1280,anineharto,5,0.00196,83418,32.64305,255546
1281,anishjain18,5,0.00196,83423,32.64500,255546
1282,antigenius0910,5,0.00196,83428,32.64696,255546
1283,AntPeixe,5,0.00196,83433,32.64892,255546
1284,Anushka30,5,0.00196,83438,32.65087,255546
1285,asahnovskiy,5,0.00196,83443,32.65283,255546
1286,ayush-1506,5,0.00196,83448,32.65479,255546
1287,backnotprop,5,0.00196,83453,32.65674,255546
1288,bankbiz,5,0.00196,83458,32.65870,255546
1289,BarleyXu,5,0.00196,83463,32.66066,255546
1290,baskaranz,5,0.00196,83468,32.66261,255546
1291,benjaminwinokur,5,0.00196,83473,32.66457,255546
1292,bnsblue,5,0.00196,83478,32.66653,255546
1293,BobLiu20,5,0.00196,83483,32.66848,255546
1294,BoecquaertJonas,5,0.00196,83488,32.67044,255546
1295,Boes-man,5,0.00196,83493,32.67240,255546
1296,bomerzz,5,0.00196,83498,32.67435,255546
1297,brtasavpatel,5,0.00196,83503,32.67631,255546
1298,bsraya,5,0.00196,83508,32.67827,255546
1299,btphan95,5,0.00196,83513,32.68022,255546
1300,cakeislife100,5,0.00196,83518,32.68218,255546
1301,ChenhanXmu,5,0.00196,83523,32.68414,255546
1302,chie8842,5,0.00196,83528,32.68609,255546
1303,chinmaychandak,5,0.00196,83533,32.68805,255546
1304,chirag0002,5,0.00196,83538,32.69000,255546
1305,ChiragGorsia05,5,0.00196,83543,32.69196,255546
1306,condaatje,5,0.00196,83548,32.69392,255546
1307,crispto,5,0.00196,83553,32.69587,255546
1308,csteegz,5,0.00196,83558,32.69783,255546
1309,damitkwr,5,0.00196,83563,32.69979,255546
1310,danielricks,5,0.00196,83568,32.70174,255546
1311,daniel-sanche,5,0.00196,83573,32.70370,255546
1312,danielsiwiec,5,0.00196,83578,32.70566,255546
1313,danizavtz,5,0.00196,83583,32.70761,255546
1314,darthsuogles,5,0.00196,83588,32.70957,255546
1315,david-thrower,5,0.00196,83593,32.71153,255546
1316,deafdave,5,0.00196,83598,32.71348,255546
1317,deepak2431,5,0.00196,83603,32.71544,255546
1318,deepaknadig,5,0.00196,83608,32.71740,255546
1319,dejangolubovic,5,0.00196,83613,32.71935,255546
1320,dilip640,5,0.00196,83618,32.72131,255546
1321,divyadilip91,5,0.00196,83623,32.72327,255546
1322,drPytho,5,0.00196,83628,32.72522,255546
1323,drubinstein,5,0.00196,83633,32.72718,255546
1324,dsiegel,5,0.00196,83638,32.72914,255546
1325,dwatrous,5,0.00196,83643,32.73109,255546
1326,ElizabethSvit,5,0.00196,83648,32.73305,255546
1327,EsaFazal72,5,0.00196,83653,32.73501,255546
1328,evanseabrook,5,0.00196,83658,32.73696,255546
1329,fatimaafridi,5,0.00196,83663,32.73892,255546
1330,femtonelson,5,0.00196,83668,32.74088,255546
1331,fighterhit,5,0.00196,83673,32.74283,255546
1332,fisache,5,0.00196,83678,32.74479,255546
1333,frederick0329,5,0.00196,83683,32.74675,255546
1334,frsann,5,0.00196,83688,32.74870,255546
1335,fsaina,5,0.00196,83693,32.75066,255546
1336,gaborvecsei,5,0.00196,83698,32.75262,255546
1337,gabrielecastellano,5,0.00196,83703,32.75457,255546
1338,gcheron,5,0.00196,83708,32.75653,255546
1339,geewynn,5,0.00196,83713,32.75849,255546
1340,gfursin,5,0.00196,83718,32.76044,255546
1341,g-karthik,5,0.00196,83723,32.76240,255546
1342,gmfrasca,5,0.00196,83728,32.76436,255546
1343,GraphtyLove,5,0.00196,83733,32.76631,255546
1344,gxfun,5,0.00196,83738,32.76827,255546
1345,harshit-deepsource,5,0.00196,83743,32.77023,255546
1346,hbrylkowski,5,0.00196,83748,32.77218,255546
1347,heyfey,5,0.00196,83753,32.77414,255546
1348,hholst80,5,0.00196,83758,32.77610,255546
1349,hieuhc,5,0.00196,83763,32.77805,255546
1350,hirokinko,5,0.00196,83768,32.78001,255546
1351,hopper-signifyd,5,0.00196,83773,32.78196,255546
1352,HWiese1980,5,0.00196,83778,32.78392,255546
1353,ianonavy,5,0.00196,83783,32.78588,255546
1354,ice1x,5,0.00196,83788,32.78783,255546
1355,indraforyou,5,0.00196,83793,32.78979,255546
1356,itayvallach,5,0.00196,83798,32.79175,255546
1357,jadechip,5,0.00196,83803,32.79370,255546
1358,JaimeHolland,5,0.00196,83808,32.79566,255546
1359,james426759,5,0.00196,83813,32.79762,255546
1360,jameswnl,5,0.00196,83818,32.79957,255546
1361,janousy,5,0.00196,83823,32.80153,255546
1362,javierdlrm,5,0.00196,83828,32.80349,255546
1363,jax79sg,5,0.00196,83833,32.80544,255546
1364,jayaswalayush,5,0.00196,83838,32.80740,255546
1365,Jaydeemourg,5,0.00196,83843,32.80936,255546
1366,jcastagneri,5,0.00196,83848,32.81131,255546
1367,jcatana,5,0.00196,83853,32.81327,255546
1368,jdonnelly-apixio,5,0.00196,83858,32.81523,255546
1369,jfigura,5,0.00196,83863,32.81718,255546
1370,jinze,5,0.00196,83868,32.81914,255546
1371,jnavarro86,5,0.00196,83873,32.82110,255546
1372,JODIN1727,5,0.00196,83878,32.82305,255546
1373,joeswashington,5,0.00196,83883,32.82501,255546
1374,jonin,5,0.00196,83888,32.82697,255546
1375,jshelman,5,0.00196,83893,32.82892,255546
1376,Jude188,5,0.00196,83898,32.83088,255546
1377,jvendegna,5,0.00196,83903,32.83284,255546
1378,katiesandford,5,0.00196,83908,32.83479,255546
1379,k-gupta,5,0.00196,83913,32.83675,255546
1380,KikiCS,5,0.00196,83918,32.83871,255546
1381,krazyhaas,5,0.00196,83923,32.84066,255546
1382,Kriyszig,5,0.00196,83928,32.84262,255546
1383,kunpengprod,5,0.00196,83933,32.84458,255546
1384,kwonmha,5,0.00196,83938,32.84653,255546
1385,lechwolowski,5,0.00196,83943,32.84849,255546
1386,leetdavid,5,0.00196,83948,32.85045,255546
1387,liudonggang,5,0.00196,83953,32.85240,255546
1388,lokesh-sreedhara,5,0.00196,83958,32.85436,255546
1389,lppier,5,0.00196,83963,32.85632,255546
1390,lp-pl,5,0.00196,83968,32.85827,255546
1391,lqdev,5,0.00196,83973,32.86023,255546
1392,Luci1306,5,0.00196,83978,32.86219,255546
1393,Madaditya,5,0.00196,83983,32.86414,255546
1394,marcoleewow,5,0.00196,83988,32.86610,255546
1395,markmirch,5,0.00196,83993,32.86806,255546
1396,MatthiasVDDooren,5,0.00196,83998,32.87001,255546
1397,mauermbq,5,0.00196,84003,32.87197,255546
1398,mengkai94,5,0.00196,84008,32.87392,255546
1399,miguelangel,5,0.00196,84013,32.87588,255546
1400,minhwan-rocks,5,0.00196,84018,32.87784,255546
1401,MLXQ,5,0.00196,84023,32.87979,255546
1402,mnmainguy,5,0.00196,84028,32.88175,255546
1403,moorthy156,5,0.00196,84033,32.88371,255546
1404,muik,5,0.00196,84038,32.88566,255546
1405,munendrasn,5,0.00196,84043,32.88762,255546
1406,MustafaHar,5,0.00196,84048,32.88958,255546
1407,nallagangus,5,0.00196,84053,32.89153,255546
1408,nellaivijay,5,0.00196,84058,32.89349,255546
1409,nithin8702,5,0.00196,84063,32.89545,255546
1410,NSLog0,5,0.00196,84068,32.89740,255546
1411,odellus,5,0.00196,84073,32.89936,255546
1412,ohtaro,5,0.00196,84078,32.90132,255546
1413,orezahc,5,0.00196,84083,32.90327,255546
1414,orugantichetan,5,0.00196,84088,32.90523,255546
1415,patzhang,5,0.00196,84093,32.90719,255546
1416,pbalm,5,0.00196,84098,32.90914,255546
1417,pengyuan,5,0.00196,84103,32.91110,255546
1418,peterhaddad3121,5,0.00196,84108,32.91306,255546
1419,phansoks,5,0.00196,84113,32.91501,255546
1420,pinkavaj,5,0.00196,84118,32.91697,255546
1421,pod3275,5,0.00196,84123,32.91893,255546
1422,PoornimaDevii,5,0.00196,84128,32.92088,255546
1423,pshah16,5,0.00196,84133,32.92284,255546
1424,ptrckbnck,5,0.00196,84138,32.92480,255546
1425,pvellanki,5,0.00196,84143,32.92675,255546
1426,Rabelaiss,5,0.00196,84148,32.92871,255546
1427,radhakrishnang,5,0.00196,84153,32.93067,255546
1428,rajan123456,5,0.00196,84158,32.93262,255546
1429,RansSelected,5,0.00196,84163,32.93458,255546
1430,rcrowe-google,5,0.00196,84168,32.93654,255546
1431,regorsmitz,5,0.00196,84173,32.93849,255546
1432,rllin,5,0.00196,84178,32.94045,255546
1433,rmporsch,5,0.00196,84183,32.94241,255546
1434,robin2008,5,0.00196,84188,32.94436,255546
1435,santiagoolivar2017,5,0.00196,84193,32.94632,255546
1436,scottcantreid,5,0.00196,84198,32.94828,255546
1437,seanswyi,5,0.00196,84203,32.95023,255546
1438,sergeykuprikov,5,0.00196,84208,32.95219,255546
1439,Sergiodiaz53,5,0.00196,84213,32.95415,255546
1440,serhio7,5,0.00196,84218,32.95610,255546
1441,shkr,5,0.00196,84223,32.95806,255546
1442,siganakis,5,0.00196,84228,32.96002,255546
1443,silverlining21,5,0.00196,84233,32.96197,255546
1444,sngahane,5,0.00196,84238,32.96393,255546
1445,snps-jinto,5,0.00196,84243,32.96588,255546
1446,soffieprincess06,5,0.00196,84248,32.96784,255546
1447,Souheil-Yazji,5,0.00196,84253,32.96980,255546
1448,souvik-deepsource,5,0.00196,84258,32.97175,255546
1449,Subhraj07,5,0.00196,84263,32.97371,255546
1450,subramaniankarthik,5,0.00196,84268,32.97567,255546
1451,suensummit,5,0.00196,84273,32.97762,255546
1452,suibinz,5,0.00196,84278,32.97958,255546
1453,sukumargaonkar,5,0.00196,84283,32.98154,255546
1454,superkjp,5,0.00196,84288,32.98349,255546
1455,tall-josh,5,0.00196,84293,32.98545,255546
1456,tdhite,5,0.00196,84298,32.98741,255546
1457,tgaddair,5,0.00196,84303,32.98936,255546
1458,TheFreaky,5,0.00196,84308,32.99132,255546
1459,theone4ever,5,0.00196,84313,32.99328,255546
1460,toniz,5,0.00196,84318,32.99523,255546
1461,TravRan,5,0.00196,84323,32.99719,255546
1462,tremblerz,5,0.00196,84328,32.99915,255546
1463,TristansCloud,5,0.00196,84333,33.00110,255546
1464,tristan-vt,5,0.00196,84338,33.00306,255546
1465,VasiliShi,5,0.00196,84343,33.00502,255546
1466,vinaynair,5,0.00196,84348,33.00697,255546
1467,VishDev12,5,0.00196,84353,33.00893,255546
1468,vkaushik189,5,0.00196,84358,33.01089,255546
1469,v-raja,5,0.00196,84363,33.01284,255546
1470,wangzheyuan,5,0.00196,84368,33.01480,255546
1471,wilkensoncode,5,0.00196,84373,33.01676,255546
1472,Windrill,5,0.00196,84378,33.01871,255546
1473,Winowang,5,0.00196,84383,33.02067,255546
1474,wooleybugger,5,0.00196,84388,33.02263,255546
1475,yaliqin,5,0.00196,84393,33.02458,255546
1476,zpcalan,5,0.00196,84398,33.02654,255546
1477,zyxue,5,0.00196,84403,33.02850,255546
1478,zzunny97,5,0.00196,84408,33.03045,255546
1479,0as1s,4,0.00157,84412,33.03202,255546
1480,251744647,4,0.00157,84416,33.03358,255546
1481,abe-hpe,4,0.00157,84420,33.03515,255546
1482,abhishektiwari,4,0.00157,84424,33.03671,255546
1483,adipola,4,0.00157,84428,33.03828,255546
1484,ai4life,4,0.00157,84432,33.03984,255546
1485,aikidave,4,0.00157,84436,33.04141,255546
1486,ajaypbrt,4,0.00157,84440,33.04297,255546
1487,akrava,4,0.00157,84444,33.04454,255546
1488,aldazero,4,0.00157,84448,33.04611,255546
1489,alienxt,4,0.00157,84452,33.04767,255546
1490,alinakuz,4,0.00157,84456,33.04924,255546
1491,AlirezaSadeghi,4,0.00157,84460,33.05080,255546
1492,alison-lim,4,0.00157,84464,33.05237,255546
1493,alvercau,4,0.00157,84468,33.05393,255546
1494,andaag,4,0.00157,84472,33.05550,255546
1495,andrewlarimer,4,0.00157,84476,33.05706,255546
1496,anisnasir,4,0.00157,84480,33.05863,255546
1497,anjaliagarwal8,4,0.00157,84484,33.06019,255546
1498,apatil4,4,0.00157,84488,33.06176,255546
1499,apatsekin,4,0.00157,84492,33.06332,255546
1500,arjunm183,4,0.00157,84496,33.06489,255546
1501,armandmcqueen,4,0.00157,84500,33.06645,255546
1502,arun-vc,4,0.00157,84504,33.06802,255546
1503,ashujain2,4,0.00157,84508,33.06958,255546
1504,asongent,4,0.00157,84512,33.07115,255546
1505,astirya,4,0.00157,84516,33.07271,255546
1506,AtrisMio,4,0.00157,84520,33.07428,255546
1507,ayush7007,4,0.00157,84524,33.07585,255546
1508,bakhtiary,4,0.00157,84528,33.07741,255546
1509,bartlomiej-malecki,4,0.00157,84532,33.07898,255546
1510,batawfic,4,0.00157,84536,33.08054,255546
1511,bbrewington,4,0.00157,84540,33.08211,255546
1512,bhkamath,4,0.00157,84544,33.08367,255546
1513,biggedi,4,0.00157,84548,33.08524,255546
1514,binblee,4,0.00157,84552,33.08680,255546
1515,bleachzk,4,0.00157,84556,33.08837,255546
1516,blsaws,4,0.00157,84560,33.08993,255546
1517,bnussbau,4,0.00157,84564,33.09150,255546
1518,Bowen0729,4,0.00157,84568,33.09306,255546
1519,cai-harry,4,0.00157,84572,33.09463,255546
1520,caleb-artifact,4,0.00157,84576,33.09619,255546
1521,CameliaBenLaamari,4,0.00157,84580,33.09776,255546
1522,canshiwei,4,0.00157,84584,33.09932,255546
1523,carre140,4,0.00157,84588,33.10089,255546
1524,cgebbe,4,0.00157,84592,33.10246,255546
1525,chansonzhang,4,0.00157,84596,33.10402,255546
1526,chantikummari,4,0.00157,84600,33.10559,255546
1527,charlesparasa,4,0.00157,84604,33.10715,255546
1528,CheaterAdams,4,0.00157,84608,33.10872,255546
1529,chenbodeng719,4,0.00157,84612,33.11028,255546
1530,chessahoekstra,4,0.00157,84616,33.11185,255546
1531,Chris-Paul-Li,4,0.00157,84620,33.11341,255546
1532,chromatices,4,0.00157,84624,33.11498,255546
1533,clj2567,4,0.00157,84628,33.11654,255546
1534,crispindev,4,0.00157,84632,33.11811,255546
1535,damejovanoski,4,0.00157,84636,33.11967,255546
1536,davidleejy,4,0.00157,84640,33.12124,255546
1537,dblate,4,0.00157,84644,33.12280,255546
1538,dchickabasapa,4,0.00157,84648,33.12437,255546
1539,denisl78,4,0.00157,84652,33.12593,255546
1540,devonkinghorn,4,0.00157,84656,33.12750,255546
1541,dfm871002,4,0.00157,84660,33.12906,255546
1542,dformoso,4,0.00157,84664,33.13063,255546
1543,DharmitD,4,0.00157,84668,33.13220,255546
1544,DianaDai,4,0.00157,84672,33.13376,255546
1545,dlahlou,4,0.00157,84676,33.13533,255546
1546,DmitriGekhtman,4,0.00157,84680,33.13689,255546
1547,dmsuehir,4,0.00157,84684,33.13846,255546
1548,dnavale,4,0.00157,84688,33.14002,255546
1549,doctapp,4,0.00157,84692,33.14159,255546
1550,dogopupper,4,0.00157,84696,33.14315,255546
1551,DQinYuan,4,0.00157,84700,33.14472,255546
1552,DreamerCather,4,0.00157,84704,33.14628,255546
1553,drewbo,4,0.00157,84708,33.14785,255546
1554,drewylui,4,0.00157,84712,33.14941,255546
1555,DvirDukhan,4,0.00157,84716,33.15098,255546
1556,dwang55,4,0.00157,84720,33.15254,255546
1557,dyoung23,4,0.00157,84724,33.15411,255546
1558,eero-t,4,0.00157,84728,33.15567,255546
1559,elim19,4,0.00157,84732,33.15724,255546
1560,elrussord1,4,0.00157,84736,33.15881,255546
1561,elyase,4,0.00157,84740,33.16037,255546
1562,eternity1984,4,0.00157,84744,33.16194,255546
1563,eundonglee,4,0.00157,84748,33.16350,255546
1564,fabboe,4,0.00157,84752,33.16507,255546
1565,FANG-MING,4,0.00157,84756,33.16663,255546
1566,fhingerl,4,0.00157,84760,33.16820,255546
1567,fondlykip,4,0.00157,84764,33.16976,255546
1568,fulei-9,4,0.00157,84768,33.17133,255546
1569,f-wole,4,0.00157,84772,33.17289,255546
1570,g-angstrom,4,0.00157,84776,33.17446,255546
1571,garlic5566,4,0.00157,84780,33.17602,255546
1572,Gaurang10,4,0.00157,84784,33.17759,255546
1573,gayathry2612,4,0.00157,84788,33.17915,255546
1574,gcampax,4,0.00157,84792,33.18072,255546
1575,George0112,4,0.00157,84796,33.18228,255546
1576,gethinzhang,4,0.00157,84800,33.18385,255546
1577,ggeorgakoudis,4,0.00157,84804,33.18541,255546
1578,gindeleo,4,0.00157,84808,33.18698,255546
1579,gongcan1219,4,0.00157,84812,33.18855,255546
1580,gundeti,4,0.00157,84816,33.19011,255546
1581,Guo-Yunzhe,4,0.00157,84820,33.19168,255546
1582,guoziyi-study,4,0.00157,84824,33.19324,255546
1583,haksunLee,4,0.00157,84828,33.19481,255546
1584,hanneshapke,4,0.00157,84832,33.19637,255546
1585,haydnkeung,4,0.00157,84836,33.19794,255546
1586,hebo-yang,4,0.00157,84840,33.19950,255546
1587,hellodk,4,0.00157,84844,33.20107,255546
1588,helloericsf,4,0.00157,84848,33.20263,255546
1589,HP-Nunes,4,0.00157,84852,33.20420,255546
1590,hrsma2i,4,0.00157,84856,33.20576,255546
1591,huanghy95,4,0.00157,84860,33.20733,255546
1592,husamaf,4,0.00157,84864,33.20889,255546
1593,ibrahimhaddad,4,0.00157,84868,33.21046,255546
1594,ionicsolutions,4,0.00157,84872,33.21202,255546
1595,iptizer,4,0.00157,84876,33.21359,255546
1596,ispmarin,4,0.00157,84880,33.21516,255546
1597,ja06200,4,0.00157,84884,33.21672,255546
1598,jageshmaharjan,4,0.00157,84888,33.21829,255546
1599,japan4415,4,0.00157,84892,33.21985,255546
1600,Jboulery,4,0.00157,84896,33.22142,255546
1601,jceb,4,0.00157,84900,33.22298,255546
1602,jdalbosc-cisco,4,0.00157,84904,33.22455,255546
1603,jdelfino,4,0.00157,84908,33.22611,255546
1604,jer0nim0,4,0.00157,84912,33.22768,255546
1605,jerryjin2018,4,0.00157,84916,33.22924,255546
1606,jiaozhentian,4,0.00157,84920,33.23081,255546
1607,jiasenwu,4,0.00157,84924,33.23237,255546
1608,JishinJames,4,0.00157,84928,33.23394,255546
1609,jkim711,4,0.00157,84932,33.23550,255546
1610,jnatale11,4,0.00157,84936,33.23707,255546
1611,johnmacnamararseg,4,0.00157,84940,33.23863,255546
1612,JohnRobinv,4,0.00157,84944,33.24020,255546
1613,jonasboecquaert,4,0.00157,84948,33.24176,255546
1614,josefkorbel,4,0.00157,84952,33.24333,255546
1615,JuanmaBM,4,0.00157,84956,33.24490,255546
1616,juansebashr,4,0.00157,84960,33.24646,255546
1617,justrohan,4,0.00157,84964,33.24803,255546
1618,kalakandi,4,0.00157,84968,33.24959,255546
1619,KamalAman,4,0.00157,84972,33.25116,255546
1620,karanveersingh5623,4,0.00157,84976,33.25272,255546
1621,kevinbazira,4,0.00157,84980,33.25429,255546
1622,kimuson,4,0.00157,84984,33.25585,255546
1623,KineticCookie,4,0.00157,84988,33.25742,255546
1624,kmrshntr,4,0.00157,84992,33.25898,255546
1625,Kokkini,4,0.00157,84996,33.26055,255546
1626,kolasanichaitanya,4,0.00157,85000,33.26211,255546
1627,komalkotha,4,0.00157,85004,33.26368,255546
1628,konradmalik,4,0.00157,85008,33.26524,255546
1629,kpulipati,4,0.00157,85012,33.26681,255546
1630,kschroed,4,0.00157,85016,33.26837,255546
1631,kumare3,4,0.00157,85020,33.26994,255546
1632,kxiao-fn,4,0.00157,85024,33.27150,255546
1633,langhuansanren,4,0.00157,85028,33.27307,255546
1634,learning-automation,4,0.00157,85032,33.27464,255546
1635,leeadh,4,0.00157,85036,33.27620,255546
1636,lightning-like,4,0.00157,85040,33.27777,255546
1637,longpi1,4,0.00157,85044,33.27933,255546
1638,luisquintanilla,4,0.00157,85048,33.28090,255546
1639,lzuwei,4,0.00157,85052,33.28246,255546
1640,ma2331550908,4,0.00157,85056,33.28403,255546
1641,mahsanaru,4,0.00157,85060,33.28559,255546
1642,malawskim,4,0.00157,85064,33.28716,255546
1643,manasjain0699,4,0.00157,85068,33.28872,255546
1644,marcelorum,4,0.00157,85072,33.29029,255546
1645,MarcinHawryluk,4,0.00157,85076,33.29185,255546
1646,marcinkosztolowicz,4,0.00157,85080,33.29342,255546
1647,MarcSkovMadsen,4,0.00157,85084,33.29498,255546
1648,mathematiguy,4,0.00157,85088,33.29655,255546
1649,mavencode01,4,0.00157,85092,33.29811,255546
1650,Mayank12022,4,0.00157,85096,33.29968,255546
1651,mbelton37,4,0.00157,85100,33.30125,255546
1652,Mddct,4,0.00157,85104,33.30281,255546
1653,md-shabbir,4,0.00157,85108,33.30438,255546
1654,mereldawu,4,0.00157,85112,33.30594,255546
1655,metaphor,4,0.00157,85116,33.30751,255546
1656,mf-giwoong-lee,4,0.00157,85120,33.30907,255546
1657,michaelwsherman,4,0.00157,85124,33.31064,255546
1658,michalbrys,4,0.00157,85128,33.31220,255546
1659,millerhooks,4,0.00157,85132,33.31377,255546
1660,mkbahk,4,0.00157,85136,33.31533,255546
1661,MLnick,4,0.00157,85140,33.31690,255546
1662,MostafaGazar,4,0.00157,85144,33.31846,255546
1663,mosyang,4,0.00157,85148,33.32003,255546
1664,Mrreboot7,4,0.00157,85152,33.32159,255546
1665,mstopa,4,0.00157,85156,33.32316,255546
1666,msvensson222,4,0.00157,85160,33.32472,255546
1667,mukulp,4,0.00157,85164,33.32629,255546
1668,mustafaghaliUnity,4,0.00157,85168,33.32785,255546
1669,naveen24691,4,0.00157,85172,33.32942,255546
1670,nicksettje,4,0.00157,85176,33.33099,255546
1671,nidhidamodaran,4,0.00157,85180,33.33255,255546
1672,nirsagi,4,0.00157,85184,33.33412,255546
1673,N-Kingsley,4,0.00157,85188,33.33568,255546
1674,nkpng2k,4,0.00157,85192,33.33725,255546
1675,nksma,4,0.00157,85196,33.33881,255546
1676,nkumar15,4,0.00157,85200,33.34038,255546
1677,NourhanKhaled,4,0.00157,85204,33.34194,255546
1678,nsriram13,4,0.00157,85208,33.34351,255546
1679,olegchorny,4,0.00157,85212,33.34507,255546
1680,onurgu,4,0.00157,85216,33.34664,255546
1681,oshev,4,0.00157,85220,33.34820,255546
1682,paipaoso,4,0.00157,85224,33.34977,255546
1683,pashtet04,4,0.00157,85228,33.35133,255546
1684,patricia92fa,4,0.00157,85232,33.35290,255546
1685,PatrickKhouryGhosn,4,0.00157,85236,33.35446,255546
1686,pdcoded,4,0.00157,85240,33.35603,255546
1687,pedrovgp,4,0.00157,85244,33.35760,255546
1688,perlinger,4,0.00157,85248,33.35916,255546
1689,persistman,4,0.00157,85252,33.36073,255546
1690,pffijt,4,0.00157,85256,33.36229,255546
1691,pigbrain,4,0.00157,85260,33.36386,255546
1692,pkasson,4,0.00157,85264,33.36542,255546
1693,pretendhigh,4,0.00157,85268,33.36699,255546
1694,pxu20,4,0.00157,85272,33.36855,255546
1695,PyoJunCode,4,0.00157,85276,33.37012,255546
1696,pythagoras1357,4,0.00157,85280,33.37168,255546
1697,rachitchauhan43,4,0.00157,85284,33.37325,255546
1698,Rajneesh-Tiwari,4,0.00157,85288,33.37481,255546
1699,randmind,4,0.00157,85292,33.37638,255546
1700,raphaelauv,4,0.00157,85296,33.37794,255546
1701,rc-zhang,4,0.00157,85300,33.37951,255546
1702,rganeshsharma,4,0.00157,85304,33.38107,255546
1703,rohithreddy,4,0.00157,85308,33.38264,255546
1704,Roman-Ka,4,0.00157,85312,33.38420,255546
1705,rtroutinz,4,0.00157,85316,33.38577,255546
1706,RustamGimadiev,4,0.00157,85320,33.38734,255546
1707,ryangrahamnc,4,0.00157,85324,33.38890,255546
1708,sahilkhanna129,4,0.00157,85328,33.39047,255546
1709,SaintBacchus,4,0.00157,85332,33.39203,255546
1710,saintnoah,4,0.00157,85336,33.39360,255546
1711,sandeep-krishnamurthy,4,0.00157,85340,33.39516,255546
1712,Saul-R,4,0.00157,85344,33.39673,255546
1713,saurovn,4,0.00157,85348,33.39829,255546
1714,sebastianohl,4,0.00157,85352,33.39986,255546
1715,SebastianScherer88,4,0.00157,85356,33.40142,255546
1716,sebnyberg,4,0.00157,85360,33.40299,255546
1717,seger48,4,0.00157,85364,33.40455,255546
1718,senthilsivanath,4,0.00157,85368,33.40612,255546
1719,sevensees,4,0.00157,85372,33.40768,255546
1720,shantanuVerma7,4,0.00157,85376,33.40925,255546
1721,sheep94lion,4,0.00157,85380,33.41081,255546
1722,shimdude,4,0.00157,85384,33.41238,255546
1723,shintaro-uchiyama,4,0.00157,85388,33.41395,255546
1724,shuaiyy,4,0.00157,85392,33.41551,255546
1725,ShyamSubramanian,4,0.00157,85396,33.41708,255546
1726,sidray7965,4,0.00157,85400,33.41864,255546
1727,simanadler,4,0.00157,85404,33.42021,255546
1728,sk1395,4,0.00157,85408,33.42177,255546
1729,skrawn,4,0.00157,85412,33.42334,255546
1730,slitery1234,4,0.00157,85416,33.42490,255546
1731,sradc,4,0.00157,85420,33.42647,255546
1732,srujanattunuri,4,0.00157,85424,33.42803,255546
1733,ssdst,4,0.00157,85428,33.42960,255546
1734,Sterls,4,0.00157,85432,33.43116,255546
1735,sublimotion,4,0.00157,85436,33.43273,255546
1736,suryaavala,4,0.00157,85440,33.43429,255546
1737,swapnilogale,4,0.00157,85444,33.43586,255546
1738,taivokasper,4,0.00157,85448,33.43742,255546
1739,Tauranis,4,0.00157,85452,33.43899,255546
1740,temporafugiunt,4,0.00157,85456,33.44055,255546
1741,texdade,4,0.00157,85460,33.44212,255546
1742,thavlik,4,0.00157,85464,33.44369,255546
1743,themowski,4,0.00157,85468,33.44525,255546
1744,thlevy,4,0.00157,85472,33.44682,255546
1745,tianhaoz95,4,0.00157,85476,33.44838,255546
1746,timbuktuu,4,0.00157,85480,33.44995,255546
1747,tkislan,4,0.00157,85484,33.45151,255546
1748,ToddMorrill,4,0.00157,85488,33.45308,255546
1749,TomasPihrt,4,0.00157,85492,33.45464,255546
1750,tonanhngo,4,0.00157,85496,33.45621,255546
1751,trog-levrai,4,0.00157,85500,33.45777,255546
1752,tszumowski,4,0.00157,85504,33.45934,255546
1753,tyrsius,4,0.00157,85508,33.46090,255546
1754,uhhc,4,0.00157,85512,33.46247,255546
1755,unclerayray,4,0.00157,85516,33.46403,255546
1756,unexpectedpanda,4,0.00157,85520,33.46560,255546
1757,ustcyue,4,0.00157,85524,33.46716,255546
1758,vamshi-rvk,4,0.00157,85528,33.46873,255546
1759,vandanavk,4,0.00157,85532,33.47029,255546
1760,vanillakola,4,0.00157,85536,33.47186,255546
1761,venkateshreddy1388,4,0.00157,85540,33.47343,255546
1762,vgarba2,4,0.00157,85544,33.47499,255546
1763,VibratingPig,4,0.00157,85548,33.47656,255546
1764,vicmeng,4,0.00157,85552,33.47812,255546
1765,victpf,4,0.00157,85556,33.47969,255546
1766,vigosser,4,0.00157,85560,33.48125,255546
1767,vinayjain15,4,0.00157,85564,33.48282,255546
1768,VincentDu2021,4,0.00157,85568,33.48438,255546
1769,vineetbadola,4,0.00157,85572,33.48595,255546
1770,vishal-kr-yadav,4,0.00157,85576,33.48751,255546
1771,vmallya-123,4,0.00157,85580,33.48908,255546
1772,wang-mask,4,0.00157,85584,33.49064,255546
1773,wywywy01,4,0.00157,85588,33.49221,255546
1774,xieqihui,4,0.00157,85592,33.49377,255546
1775,xin-hao-awx,4,0.00157,85596,33.49534,255546
1776,yajunwong,4,0.00157,85600,33.49690,255546
1777,Yaoda77,4,0.00157,85604,33.49847,255546
1778,yarcyarc,4,0.00157,85608,33.50004,255546
1779,yarongol,4,0.00157,85612,33.50160,255546
1780,ycfnana,4,0.00157,85616,33.50317,255546
1781,yeahydq,4,0.00157,85620,33.50473,255546
1782,ypitrey,4,0.00157,85624,33.50630,255546
1783,zheddie,4,0.00157,85628,33.50786,255546
1784,zulissi,4,0.00157,85632,33.50943,255546
1785,zwqjoy,4,0.00157,85636,33.51099,255546
1786,11fenil11,3,0.00117,85639,33.51217,255546
1787,64J0,3,0.00117,85642,33.51334,255546
1788,abbyearnin,3,0.00117,85645,33.51451,255546
1789,aborilov,3,0.00117,85648,33.51569,255546
1790,aburns7,3,0.00117,85651,33.51686,255546
1791,adamjablonowski,3,0.00117,85654,33.51804,255546
1792,Adithimurthi,3,0.00117,85657,33.51921,255546
1793,adrian-plutoflume,3,0.00117,85660,33.52038,255546
1794,ahmet-uyar,3,0.00117,85663,33.52156,255546
1795,ahousley,3,0.00117,85666,33.52273,255546
1796,AigizK,3,0.00117,85669,33.52391,255546
1797,ajayakumar-jayaraj,3,0.00117,85672,33.52508,255546
1798,AjayZinngg,3,0.00117,85675,33.52625,255546
1799,ajithkumar6,3,0.00117,85678,33.52743,255546
1800,ak-tanak,3,0.00117,85681,33.52860,255546
1801,AlbertCintas,3,0.00117,85684,33.52978,255546
1802,aleksandra-sp,3,0.00117,85687,33.53095,255546
1803,alessandroferrari,3,0.00117,85690,33.53212,255546
1804,alexbarta,3,0.00117,85693,33.53330,255546
1805,ali8zake,3,0.00117,85696,33.53447,255546
1806,alzindiq,3,0.00117,85699,33.53565,255546
1807,AmberCheng,3,0.00117,85702,33.53682,255546
1808,amirhessam88,3,0.00117,85705,33.53799,255546
1809,amitbhadra,3,0.00117,85708,33.53917,255546
1810,amitchatbd,3,0.00117,85711,33.54034,255546
1811,amq,3,0.00117,85714,33.54152,255546
1812,Amrit-Mann,3,0.00117,85717,33.54269,255546
1813,amyxst,3,0.00117,85720,33.54386,255546
1814,Anamika28,3,0.00117,85723,33.54504,255546
1815,AndrewLeach,3,0.00117,85726,33.54621,255546
1816,andrewspiers,3,0.00117,85729,33.54738,255546
1817,AndreyRomanchev,3,0.00117,85732,33.54856,255546
1818,anj-s,3,0.00117,85735,33.54973,255546
1819,ankur47,3,0.00117,85738,33.55091,255546
1820,antshuwen,3,0.00117,85741,33.55208,255546
1821,apulache,3,0.00117,85744,33.55325,255546
1822,argunasekhar,3,0.00117,85747,33.55443,255546
1823,arianyambao,3,0.00117,85750,33.55560,255546
1824,aritar,3,0.00117,85753,33.55678,255546
1825,aronla,3,0.00117,85756,33.55795,255546
1826,ArVar,3,0.00117,85759,33.55912,255546
1827,asavpatel92,3,0.00117,85762,33.56030,255546
1828,AshokKuramdasu,3,0.00117,85765,33.56147,255546
1829,aslisabanci,3,0.00117,85768,33.56265,255546
1830,asojoabiola,3,0.00117,85771,33.56382,255546
1831,asok-mirror,3,0.00117,85774,33.56499,255546
1832,augustovictor,3,0.00117,85777,33.56617,255546
1833,avarf,3,0.00117,85780,33.56734,255546
1834,aVideogamer,3,0.00117,85783,33.56852,255546
1835,avolution,3,0.00117,85786,33.56969,255546
1836,awittzb,3,0.00117,85789,33.57086,255546
1837,ayman107,3,0.00117,85792,33.57204,255546
1838,azadehatfxtl,3,0.00117,85795,33.57321,255546
1839,banbanandroid,3,0.00117,85798,33.57439,255546
1840,Bartket,3,0.00117,85801,33.57556,255546
1841,bbarn3y,3,0.00117,85804,33.57673,255546
1842,beliaev-maksim,3,0.00117,85807,33.57791,255546
1843,benbrandt,3,0.00117,85810,33.57908,255546
1844,BenoitLeguay,3,0.00117,85813,33.58026,255546
1845,ben-omji,3,0.00117,85816,33.58143,255546
1846,benswinney,3,0.00117,85819,33.58260,255546
1847,bharath0208,3,0.00117,85822,33.58378,255546
1848,bobuel,3,0.00117,85825,33.58495,255546
1849,bodak,3,0.00117,85828,33.58613,255546
1850,bonacciog,3,0.00117,85831,33.58730,255546
1851,BorFour,3,0.00117,85834,33.58847,255546
1852,BrainLogic,3,0.00117,85837,33.58965,255546
1853,Brajen259,3,0.00117,85840,33.59082,255546
1854,bravo325806,3,0.00117,85843,33.59200,255546
1855,bretttully,3,0.00117,85846,33.59317,255546
1856,brucechin,3,0.00117,85849,33.59434,255546
1857,brychcy,3,0.00117,85852,33.59552,255546
1858,bsamadi,3,0.00117,85855,33.59669,255546
1859,busycalibrating,3,0.00117,85858,33.59786,255546
1860,cah4444,3,0.00117,85861,33.59904,255546
1861,capoolebugchat,3,0.00117,85864,33.60021,255546
1862,caren-guo,3,0.00117,85867,33.60139,255546
1863,carlthome,3,0.00117,85870,33.60256,255546
1864,cblackd7r,3,0.00117,85873,33.60373,255546
1865,CBrucePerkins,3,0.00117,85876,33.60491,255546
1866,cbscientist,3,0.00117,85879,33.60608,255546
1867,ccll,3,0.00117,85882,33.60726,255546
1868,ccurro,3,0.00117,85885,33.60843,255546
1869,cejj,3,0.00117,85888,33.60960,255546
1870,cesargomez,3,0.00117,85891,33.61078,255546
1871,chaosxeras,3,0.00117,85894,33.61195,255546
1872,chaowangnk1,3,0.00117,85897,33.61313,255546
1873,chelarua,3,0.00117,85900,33.61430,255546
1874,chengmengli06,3,0.00117,85903,33.61547,255546
1875,chintha-v,3,0.00117,85906,33.61665,255546
1876,chiragjn,3,0.00117,85909,33.61782,255546
1877,chxk,3,0.00117,85912,33.61900,255546
1878,CJZheng91,3,0.00117,85915,33.62017,255546
1879,ClaudioDavi,3,0.00117,85918,33.62134,255546
1880,claytonlemons,3,0.00117,85921,33.62252,255546
1881,cloudw,3,0.00117,85924,33.62369,255546
1882,cmhokej,3,0.00117,85927,33.62487,255546
1883,CoderHam,3,0.00117,85930,33.62604,255546
1884,cody-yancey,3,0.00117,85933,33.62721,255546
1885,ColinCampbell-GBI,3,0.00117,85936,33.62839,255546
1886,ConnorBarnhill,3,0.00117,85939,33.62956,255546
1887,cp2587,3,0.00117,85942,33.63074,255546
1888,cpedrinaci,3,0.00117,85945,33.63191,255546
1889,croesuslab,3,0.00117,85948,33.63308,255546
1890,csachs,3,0.00117,85951,33.63426,255546
1891,daniel-beyond,3,0.00117,85954,33.63543,255546
1892,DanieleBaranzini,3,0.00117,85957,33.63661,255546
1893,DanielLund,3,0.00117,85960,33.63778,255546
1894,danielschulz,3,0.00117,85963,33.63895,255546
1895,dannydk6,3,0.00117,85966,33.64013,255546
1896,dari-o,3,0.00117,85969,33.64130,255546
1897,davidLif,3,0.00117,85972,33.64248,255546
1898,dboc,3,0.00117,85975,33.64365,255546
1899,dctelus,3,0.00117,85978,33.64482,255546
1900,dcyoung,3,0.00117,85981,33.64600,255546
1901,deepanker13,3,0.00117,85984,33.64717,255546
1902,deeptikorwar,3,0.00117,85987,33.64835,255546
1903,dennis1du,3,0.00117,85990,33.64952,255546
1904,destornillador,3,0.00117,85993,33.65069,255546
1905,diegodgs,3,0.00117,85996,33.65187,255546
1906,diegok-unity,3,0.00117,85999,33.65304,255546
1907,dizcology,3,0.00117,86002,33.65421,255546
1908,Don12138,3,0.00117,86005,33.65539,255546
1909,DonggeunYu,3,0.00117,86008,33.65656,255546
1910,doodlesbykumbi,3,0.00117,86011,33.65774,255546
1911,Dottorepoloni,3,0.00117,86014,33.65891,255546
1912,Dravigon,3,0.00117,86017,33.66008,255546
1913,drawesomenic,3,0.00117,86020,33.66126,255546
1914,duchy,3,0.00117,86023,33.66243,255546
1915,duongnt,3,0.00117,86026,33.66361,255546
1916,dynamicwebpaige,3,0.00117,86029,33.66478,255546
1917,eCeleritas,3,0.00117,86032,33.66595,255546
1918,edgar971,3,0.00117,86035,33.66713,255546
1919,Edward-liang,3,0.00117,86038,33.66830,255546
1920,Edwardsleo,3,0.00117,86041,33.66948,255546
1921,elcombato,3,0.00117,86044,33.67065,255546
1922,elenimou,3,0.00117,86047,33.67182,255546
1923,eliastsironis,3,0.00117,86050,33.67300,255546
1924,ElnazBigdeli,3,0.00117,86053,33.67417,255546
1925,Enzo90910,3,0.00117,86056,33.67535,255546
1926,eqqe,3,0.00117,86059,33.67652,255546
1927,eran-nussbaum,3,0.00117,86062,33.67769,255546
1928,erhwenkuo,3,0.00117,86065,33.67887,255546
1929,Eros11on,3,0.00117,86068,33.68004,255546
1930,ErraticO,3,0.00117,86071,33.68122,255546
1931,esha-ingle-mpf,3,0.00117,86074,33.68239,255546
1932,ettiee,3,0.00117,86077,33.68356,255546
1933,EUCHI1996,3,0.00117,86080,33.68474,255546
1934,EvanFabry,3,0.00117,86083,33.68591,255546
1935,eyalcha,3,0.00117,86086,33.68709,255546
1936,fakeskimo,3,0.00117,86089,33.68826,255546
1937,feizerl,3,0.00117,86092,33.68943,255546
1938,Fkawala,3,0.00117,86095,33.69061,255546
1939,florian-koenig,3,0.00117,86098,33.69178,255546
1940,frankmanbb,3,0.00117,86101,33.69296,255546
1941,frankzhao,3,0.00117,86104,33.69413,255546
1942,fuhuifang,3,0.00117,86107,33.69530,255546
1943,gehring,3,0.00117,86110,33.69648,255546
1944,georgetree,3,0.00117,86113,33.69765,255546
1945,gettheguru,3,0.00117,86116,33.69883,255546
1946,gigi-at-zymergen,3,0.00117,86119,33.70000,255546
1947,gnovack,3,0.00117,86122,33.70117,255546
1948,goat023,3,0.00117,86125,33.70235,255546
1949,gogeof,3,0.00117,86128,33.70352,255546
1950,gokuatkai,3,0.00117,86131,33.70470,255546
1951,gomrinal,3,0.00117,86134,33.70587,255546
1952,GoodJoey,3,0.00117,86137,33.70704,255546
1953,goodluckbot,3,0.00117,86140,33.70822,255546
1954,gopitk,3,0.00117,86143,33.70939,255546
1955,gordonsilvera,3,0.00117,86146,33.71056,255546
1956,Gorosia,3,0.00117,86149,33.71174,255546
1957,govindsinghnegi,3,0.00117,86152,33.71291,255546
1958,gprashanthkumar,3,0.00117,86155,33.71409,255546
1959,grehce,3,0.00117,86158,33.71526,255546
1960,grischa,3,0.00117,86161,33.71643,255546
1961,gtoonstra,3,0.00117,86164,33.71761,255546
1962,GT-ZhangAcer,3,0.00117,86167,33.71878,255546
1963,gudipudipradeep,3,0.00117,86170,33.71996,255546
1964,gugumituo,3,0.00117,86173,33.72113,255546
1965,gxin0426,3,0.00117,86176,33.72230,255546
1966,hainp,3,0.00117,86179,33.72348,255546
1967,halayudha,3,0.00117,86182,33.72465,255546
1968,haoxinst,3,0.00117,86185,33.72583,255546
1969,HaozhengAN,3,0.00117,86188,33.72700,255546
1970,harshsaini,3,0.00117,86191,33.72817,255546
1971,harshvladha,3,0.00117,86194,33.72935,255546
1972,harupy,3,0.00117,86197,33.73052,255546
1973,hecheng64,3,0.00117,86200,33.73170,255546
1974,Heena-PyCloud,3,0.00117,86203,33.73287,255546
1975,Helvind,3,0.00117,86206,33.73404,255546
1976,HenrryVargas,3,0.00117,86209,33.73522,255546
1977,Henry-Kim-Youngwoo,3,0.00117,86212,33.73639,255546
1978,hepwori,3,0.00117,86215,33.73757,255546
1979,hgrsd,3,0.00117,86218,33.73874,255546
1980,hmc-cs-mdrissi,3,0.00117,86221,33.73991,255546
1981,hongjunGu2019,3,0.00117,86224,33.74109,255546
1982,huan11,3,0.00117,86227,33.74226,255546
1983,hunhoon21,3,0.00117,86230,33.74344,255546
1984,hykych,3,0.00117,86233,33.74461,255546
1985,hyzhak,3,0.00117,86236,33.74578,255546
1986,hzliangbin,3,0.00117,86239,33.74696,255546
1987,iamvarol,3,0.00117,86242,33.74813,255546
1988,ifs-pauljegouic,3,0.00117,86245,33.74931,255546
1989,ijaouani,3,0.00117,86248,33.75048,255546
1990,InCogNiTo124,3,0.00117,86251,33.75165,255546
1991,isaacyuenhk01,3,0.00117,86254,33.75283,255546
1992,ishanmadan1996,3,0.00117,86257,33.75400,255546
1993,ivanbrave,3,0.00117,86260,33.75518,255546
1994,jainprachi2506,3,0.00117,86263,33.75635,255546
1995,jaminsore,3,0.00117,86266,33.75752,255546
1996,janbe-ts,3,0.00117,86269,33.75870,255546
1997,jardon,3,0.00117,86272,33.75987,255546
1998,jasonbrancazio,3,0.00117,86275,33.76104,255546
1999,jayanthp-intellect,3,0.00117,86278,33.76222,255546
2000,JBosom,3,0.00117,86281,33.76339,255546
2001,jeanbaptiste-brasselet,3,0.00117,86284,33.76457,255546
2002,jednymslowem,3,0.00117,86287,33.76574,255546
2003,jernster,3,0.00117,86290,33.76691,255546
2004,jerry40214,3,0.00117,86293,33.76809,255546
2005,jetbasrawi,3,0.00117,86296,33.76926,255546
2006,jhasm,3,0.00117,86299,33.77044,255546
2007,jhattingh,3,0.00117,86302,33.77161,255546
2008,jianhuashao,3,0.00117,86305,33.77278,255546
2009,jimmy-hawkfish,3,0.00117,86308,33.77396,255546
2010,jingli0118,3,0.00117,86311,33.77513,255546
2011,jinnovation,3,0.00117,86314,33.77631,255546
2012,JishnuM,3,0.00117,86317,33.77748,255546
2013,jjayadeep06,3,0.00117,86320,33.77865,255546
2014,jklaise,3,0.00117,86323,33.77983,255546
2015,jlouea,3,0.00117,86326,33.78100,255546
2016,joaquingarciaatos,3,0.00117,86329,33.78218,255546
2017,JohannesTK,3,0.00117,86332,33.78335,255546
2018,johnbuluba,3,0.00117,86335,33.78452,255546
2019,john-cr,3,0.00117,86338,33.78570,255546
2020,JohnWick-888,3,0.00117,86341,33.78687,255546
2021,JoinHands,3,0.00117,86344,33.78805,255546
2022,Jonuknownothingsnow,3,0.00117,86347,33.78922,255546
2023,jovan-absci,3,0.00117,86350,33.79039,255546
2024,jphines,3,0.00117,86353,33.79157,255546
2025,JuanValencia,3,0.00117,86356,33.79274,255546
2026,Juggernaut1997,3,0.00117,86359,33.79392,255546
2027,JunPyoL22,3,0.00117,86362,33.79509,255546
2028,justin0322,3,0.00117,86365,33.79626,255546
2029,JV-DHL,3,0.00117,86368,33.79744,255546
2030,k4rth33k,3,0.00117,86371,33.79861,255546
2031,kabilan6,3,0.00117,86374,33.79979,255546
2032,kaishah,3,0.00117,86377,33.80096,255546
2033,kakaxilyp,3,0.00117,86380,33.80213,255546
2034,katieole,3,0.00117,86383,33.80331,255546
2035,kaybon,3,0.00117,86386,33.80448,255546
2036,kbmanseau,3,0.00117,86389,33.80566,255546
2037,kemp2001,3,0.00117,86392,33.80683,255546
2038,kenly-ldk,3,0.00117,86395,33.80800,255546
2039,keshavpeswani,3,0.00117,86398,33.80918,255546
2040,kevinstumpf,3,0.00117,86401,33.81035,255546
2041,khersey,3,0.00117,86404,33.81153,255546
2042,kilicbaran,3,0.00117,86407,33.81270,255546
2043,kim-seoha,3,0.00117,86410,33.81387,255546
2044,kishoreallwynraj,3,0.00117,86413,33.81505,255546
2045,kkolli,3,0.00117,86416,33.81622,255546
2046,Kloempi,3,0.00117,86419,33.81739,255546
2047,kmr0877,3,0.00117,86422,33.81857,255546
2048,konnase,3,0.00117,86425,33.81974,255546
2049,Kribylet,3,0.00117,86428,33.82092,255546
2050,KunWuLuan,3,0.00117,86431,33.82209,255546
2051,kwokon0ng,3,0.00117,86434,33.82326,255546
2052,kzhai,3,0.00117,86437,33.82444,255546
2053,LeeJian,3,0.00117,86440,33.82561,255546
2054,Lee-Yeongjae,3,0.00117,86443,33.82679,255546
2055,leopd,3,0.00117,86446,33.82796,255546
2056,linuraj,3,0.00117,86449,33.82913,255546
2057,liuweibin6566396837,3,0.00117,86452,33.83031,255546
2058,livneros,3,0.00117,86455,33.83148,255546
2059,liyinhgqw,3,0.00117,86458,33.83266,255546
2060,llimboy,3,0.00117,86461,33.83383,255546
2061,lnmohankumar,3,0.00117,86464,33.83500,255546
2062,LucidNeko,3,0.00117,86467,33.83618,255546
2063,LuigiCerone,3,0.00117,86470,33.83735,255546
2064,ma08,3,0.00117,86473,33.83853,255546
2065,mabi08,3,0.00117,86476,33.83970,255546
2066,Madhav111,3,0.00117,86479,33.84087,255546
2067,magreenberg1,3,0.00117,86482,33.84205,255546
2068,majidhali,3,0.00117,86485,33.84322,255546
2069,mak-454,3,0.00117,86488,33.84440,255546
2070,makeitai,3,0.00117,86491,33.84557,255546
2071,manojlds,3,0.00117,86494,33.84674,255546
2072,manuelsh,3,0.00117,86497,33.84792,255546
2073,mappedinn,3,0.00117,86500,33.84909,255546
2074,marcmillien,3,0.00117,86503,33.85027,255546
2075,markqiu,3,0.00117,86506,33.85144,255546
2076,MartinRogmann,3,0.00117,86509,33.85261,255546
2077,masoudjalayer90,3,0.00117,86512,33.85379,255546
2078,matejaputic,3,0.00117,86515,33.85496,255546
2079,mathieulallier807,3,0.00117,86518,33.85614,255546
2080,mattshma,3,0.00117,86521,33.85731,255546
2081,maxisacoder,3,0.00117,86524,33.85848,255546
2082,mayakacz,3,0.00117,86527,33.85966,255546
2083,mdew192837,3,0.00117,86530,33.86083,255546
2084,Meadosc,3,0.00117,86533,33.86201,255546
2085,meiblorn,3,0.00117,86536,33.86318,255546
2086,mesaverde0207,3,0.00117,86539,33.86435,255546
2087,Mesilenceki,3,0.00117,86542,33.86553,255546
2088,MessKon,3,0.00117,86545,33.86670,255546
2089,mgwismer,3,0.00117,86548,33.86788,255546
2090,mhamdan91,3,0.00117,86551,33.86905,255546
2091,MichaelJiangPlus,3,0.00117,86554,33.87022,255546
2092,mickeyh,3,0.00117,86557,33.87140,255546
2093,mikejmills,3,0.00117,86560,33.87257,255546
2094,mikereeves,3,0.00117,86563,33.87374,255546
2095,mikevoets,3,0.00117,86566,33.87492,255546
2096,mindthevirt,3,0.00117,86569,33.87609,255546
2097,Mithul,3,0.00117,86572,33.87727,255546
2098,MKRNaqeebi,3,0.00117,86575,33.87844,255546
2099,mlegore,3,0.00117,86578,33.87961,255546
2100,mnoble-vody,3,0.00117,86581,33.88079,255546
2101,MohammedRashad,3,0.00117,86584,33.88196,255546
2102,mohite-abhi,3,0.00117,86587,33.88314,255546
2103,mohittalele,3,0.00117,86590,33.88431,255546
2104,moonyoung430,3,0.00117,86593,33.88548,255546
2105,Morride,3,0.00117,86596,33.88666,255546
2106,mosabami,3,0.00117,86599,33.88783,255546
2107,mradha-beat,3,0.00117,86602,33.88901,255546
2108,mroy31,3,0.00117,86605,33.89018,255546
2109,MrPhilosopher,3,0.00117,86608,33.89135,255546
2110,mschuwalow,3,0.00117,86611,33.89253,255546
2111,muhammadtehseenSystemsltd,3,0.00117,86614,33.89370,255546
2112,mwoodbri,3,0.00117,86617,33.89488,255546
2113,n3o-Bhushan,3,0.00117,86620,33.89605,255546
2114,narner90,3,0.00117,86623,33.89722,255546
2115,nashra2637,3,0.00117,86626,33.89840,255546
2116,NathanHowell,3,0.00117,86629,33.89957,255546
2117,navo1194,3,0.00117,86632,33.90075,255546
2118,neonihil,3,0.00117,86635,33.90192,255546
2119,neupaneaj,3,0.00117,86638,33.90309,255546
2120,nicholas-abad,3,0.00117,86641,33.90427,255546
2121,nickozilla,3,0.00117,86644,33.90544,255546
2122,NiveditaViswanathNVIDIA,3,0.00117,86647,33.90662,255546
2123,NoahRoseLedesma,3,0.00117,86650,33.90779,255546
2124,NohaIhab,3,0.00117,86653,33.90896,255546
2125,noushi,3,0.00117,86656,33.91014,255546
2126,nroberts1,3,0.00117,86659,33.91131,255546
2127,nsteblay,3,0.00117,86662,33.91249,255546
2128,ntl-ibm,3,0.00117,86665,33.91366,255546
2129,nuel-d1,3,0.00117,86668,33.91483,255546
2130,nurcandurak,3,0.00117,86671,33.91601,255546
2131,nutmilk10,3,0.00117,86674,33.91718,255546
2132,oadams,3,0.00117,86677,33.91836,255546
2133,ofir-bt,3,0.00117,86680,33.91953,255546
2134,Omoong,3,0.00117,86683,33.92070,255546
2135,onetonfoot,3,0.00117,86686,33.92188,255546
2136,onur-sam-gtn-ai,3,0.00117,86689,33.92305,255546
2137,opalelement,3,0.00117,86692,33.92422,255546
2138,oshep,3,0.00117,86695,33.92540,255546
2139,panbalag,3,0.00117,86698,33.92657,255546
2140,parano,3,0.00117,86701,33.92775,255546
2141,patcombe,3,0.00117,86704,33.92892,255546
2142,paulbaumgart,3,0.00117,86707,33.93009,255546
2143,pavan-infiswift,3,0.00117,86710,33.93127,255546
2144,pavankumarboinapalli,3,0.00117,86713,33.93244,255546
2145,pbrzostowski,3,0.00117,86716,33.93362,255546
2146,Pedrohgv,3,0.00117,86719,33.93479,255546
2147,pheianox,3,0.00117,86722,33.93596,255546
2148,pinglin,3,0.00117,86725,33.93714,255546
2149,pkourouklidis,3,0.00117,86728,33.93831,255546
2150,plainenough,3,0.00117,86731,33.93949,255546
2151,pmcvay,3,0.00117,86734,33.94066,255546
2152,pmuilu,3,0.00117,86737,33.94183,255546
2153,pogacsa,3,0.00117,86740,33.94301,255546
2154,potix2,3,0.00117,86743,33.94418,255546
2155,prashanthharshangi,3,0.00117,86746,33.94536,255546
2156,pratibhadeepti,3,0.00117,86749,33.94653,255546
2157,PrimeF,3,0.00117,86752,33.94770,255546
2158,probirsil,3,0.00117,86755,33.94888,255546
2159,prograhamer,3,0.00117,86758,33.95005,255546
2160,prsrepo,3,0.00117,86761,33.95123,255546
2161,punkerpunker,3,0.00117,86764,33.95240,255546
2162,qinjie545,3,0.00117,86767,33.95357,255546
2163,quaterneon,3,0.00117,86770,33.95475,255546
2164,rabierp,3,0.00117,86773,33.95592,255546
2165,rahuja23,3,0.00117,86776,33.95710,255546
2166,rahulsmehta,3,0.00117,86779,33.95827,255546
2167,rajatonit,3,0.00117,86782,33.95944,255546
2168,rajendra-tamboli,3,0.00117,86785,33.96062,255546
2169,ramakrishnamamidi,3,0.00117,86788,33.96179,255546
2170,rameshkemp,3,0.00117,86791,33.96297,255546
2171,rastislavs,3,0.00117,86794,33.96414,255546
2172,rclough,3,0.00117,86797,33.96531,255546
2173,rduan,3,0.00117,86800,33.96649,255546
2174,rebsp,3,0.00117,86803,33.96766,255546
2175,Reldan,3,0.00117,86806,33.96884,255546
2176,revathijay,3,0.00117,86809,33.97001,255546
2177,revolutionisme,3,0.00117,86812,33.97118,255546
2178,rexad,3,0.00117,86815,33.97236,255546
2179,richardagalvez,3,0.00117,86818,33.97353,255546
2180,riosv,3,0.00117,86821,33.97471,255546
2181,ritaarex,3,0.00117,86824,33.97588,255546
2182,riyaj8888,3,0.00117,86827,33.97705,255546
2183,rjtshrm,3,0.00117,86830,33.97823,255546
2184,rmard90,3,0.00117,86833,33.97940,255546
2185,RobinKa,3,0.00117,86836,33.98057,255546
2186,romankazinnik,3,0.00117,86839,33.98175,255546
2187,RosaCandela,3,0.00117,86842,33.98292,255546
2188,rosgluk,3,0.00117,86845,33.98410,255546
2189,rubenaranamorera,3,0.00117,86848,33.98527,255546
2190,rushins,3,0.00117,86851,33.98644,255546
2191,rvesse,3,0.00117,86854,33.98762,255546
2192,sagravat,3,0.00117,86857,33.98879,255546
2193,salilmishra23,3,0.00117,86860,33.98997,255546
2194,SamChb72,3,0.00117,86863,33.99114,255546
2195,samuelmi2,3,0.00117,86866,33.99231,255546
2196,sathiez,3,0.00117,86869,33.99349,255546
2197,SatyaNarayan1,3,0.00117,86872,33.99466,255546
2198,scott0000,3,0.00117,86875,33.99584,255546
2199,SeanNaren,3,0.00117,86878,33.99701,255546
2200,seansxl,3,0.00117,86881,33.99818,255546
2201,senarvi,3,0.00117,86884,33.99936,255546
2202,shan100github,3,0.00117,86887,34.00053,255546
2203,shashank3959,3,0.00117,86890,34.00171,255546
2204,shashikant-ghangare,3,0.00117,86893,34.00288,255546
2205,shashisingh,3,0.00117,86896,34.00405,255546
2206,shbijlan,3,0.00117,86899,34.00523,255546
2207,shimpel,3,0.00117,86902,34.00640,255546
2208,shivaga9esh,3,0.00117,86905,34.00758,255546
2209,shivam-rai,3,0.00117,86908,34.00875,255546
2210,shruthingcp,3,0.00117,86911,34.00992,255546
2211,ShuhanYan,3,0.00117,86914,34.01110,255546
2212,shuhaohe,3,0.00117,86917,34.01227,255546
2213,siddharthchaurasia-tudip,3,0.00117,86920,34.01345,255546
2214,Sifat1998,3,0.00117,86923,34.01462,255546
2215,sijieamoy,3,0.00117,86926,34.01579,255546
2216,Silentphantom62,3,0.00117,86929,34.01697,255546
2217,siriusa51,3,0.00117,86932,34.01814,255546
2218,skothawa-tibco,3,0.00117,86935,34.01932,255546
2219,skuchipu,3,0.00117,86938,34.02049,255546
2220,smurli,3,0.00117,86941,34.02166,255546
2221,soochem,3,0.00117,86944,34.02284,255546
2222,SpecialAll,3,0.00117,86947,34.02401,255546
2223,sriharan16,3,0.00117,86950,34.02519,255546
2224,stampcrab,3,0.00117,86953,34.02636,255546
2225,steveplazafb,3,0.00117,86956,34.02753,255546
2226,subramp,3,0.00117,86959,34.02871,255546
2227,SunilManika,3,0.00117,86962,34.02988,255546
2228,suryabdev,3,0.00117,86965,34.03106,255546
2229,sushkov-r,3,0.00117,86968,34.03223,255546
2230,sxmon,3,0.00117,86971,34.03340,255546
2231,szymonbcoding,3,0.00117,86974,34.03458,255546
2232,TaChao,3,0.00117,86977,34.03575,255546
2233,talcoh2x,3,0.00117,86980,34.03692,255546
2234,TalhaNaeem101,3,0.00117,86983,34.03810,255546
2235,tamera-lanham,3,0.00117,86986,34.03927,255546
2236,tbaggu,3,0.00117,86989,34.04045,255546
2237,tech509201941,3,0.00117,86992,34.04162,255546
2238,techwolf139,3,0.00117,86995,34.04279,255546
2239,tejaschumbalkar,3,0.00117,86998,34.04397,255546
2240,tekumara,3,0.00117,87001,34.04514,255546
2241,TheTravellingSalesman,3,0.00117,87004,34.04632,255546
2242,tiansiyuan,3,0.00117,87007,34.04749,255546
2243,Tilyp,3,0.00117,87010,34.04866,255546
2244,timothysu,3,0.00117,87013,34.04984,255546
2245,tktest1234,3,0.00117,87016,34.05101,255546
2246,Tlaloc-Es,3,0.00117,87019,34.05219,255546
2247,tleewongjaro-agoda,3,0.00117,87022,34.05336,255546
2248,tmielika,3,0.00117,87025,34.05453,255546
2249,Tomer23,3,0.00117,87028,34.05571,255546
2250,torbre16,3,0.00117,87031,34.05688,255546
2251,TosinAina,3,0.00117,87034,34.05806,255546
2252,true-source,3,0.00117,87037,34.05923,255546
2253,tteltrab,3,0.00117,87040,34.06040,255546
2254,twitchax,3,0.00117,87043,34.06158,255546
2255,twolffpiggott,3,0.00117,87046,34.06275,255546
2256,vabshere,3,0.00117,87049,34.06393,255546
2257,varinic,3,0.00117,87052,34.06510,255546
2258,Vasuji,3,0.00117,87055,34.06627,255546
2259,vcarnogu,3,0.00117,87058,34.06745,255546
2260,vditya,3,0.00117,87061,34.06862,255546
2261,vegoutha,3,0.00117,87064,34.06980,255546
2262,vemqar,3,0.00117,87067,34.07097,255546
2263,venci6,3,0.00117,87070,34.07214,255546
2264,verhoek,3,0.00117,87073,34.07332,255546
2265,vgmartinez,3,0.00117,87076,34.07449,255546
2266,VilmaZubak,3,0.00117,87079,34.07567,255546
2267,vinhngx,3,0.00117,87082,34.07684,255546
2268,vipul-sharma20,3,0.00117,87085,34.07801,255546
2269,vladhc,3,0.00117,87088,34.07919,255546
2270,vmolina,3,0.00117,87091,34.08036,255546
2271,wallarug,3,0.00117,87094,34.08154,255546
2272,wallies,3,0.00117,87097,34.08271,255546
2273,WangAooa,3,0.00117,87100,34.08388,255546
2274,wangdian,3,0.00117,87103,34.08506,255546
2275,wangpf09,3,0.00117,87106,34.08623,255546
2276,wanvincent,3,0.00117,87109,34.08741,255546
2277,wenboown,3,0.00117,87112,34.08858,255546
2278,Wenshiqi222,3,0.00117,87115,34.08975,255546
2279,wfg314,3,0.00117,87118,34.09093,255546
2280,wjentner,3,0.00117,87121,34.09210,255546
2281,wkeifenheim,3,0.00117,87124,34.09327,255546
2282,Writtic,3,0.00117,87127,34.09445,255546
2283,wydwww,3,0.00117,87130,34.09562,255546
2284,wzxJayce,3,0.00117,87133,34.09680,255546
2285,Xiaoaier-Z-L,3,0.00117,87136,34.09797,255546
2286,xiaowei-zillow,3,0.00117,87139,34.09914,255546
2287,yangwenhuan,3,0.00117,87142,34.10032,255546
2288,ycheng,3,0.00117,87145,34.10149,255546
2289,yehiyam,3,0.00117,87148,34.10267,255546
2290,YinguangZhao,3,0.00117,87151,34.10384,255546
2291,ykevinc,3,0.00117,87154,34.10501,255546
2292,YogeshSomawar,3,0.00117,87157,34.10619,255546
2293,younkun,3,0.00117,87160,34.10736,255546
2294,yribeiro,3,0.00117,87163,34.10854,255546
2295,yuefengz,3,0.00117,87166,34.10971,255546
2296,yuval-yaari,3,0.00117,87169,34.11088,255546
2297,yuzhaojing,3,0.00117,87172,34.11206,255546
2298,zanelliriccardo,3,0.00117,87175,34.11323,255546
2299,ZA-NVG,3,0.00117,87178,34.11441,255546
2300,Zashino,3,0.00117,87181,34.11558,255546
2301,zeb-stephen-downs,3,0.00117,87184,34.11675,255546
2302,zhang87492,3,0.00117,87187,34.11793,255546
2303,zhangle-java,3,0.00117,87190,34.11910,255546
2304,zhangzewen,3,0.00117,87193,34.12028,255546
2305,zhcf,3,0.00117,87196,34.12145,255546
2306,ZhengJuCn,3,0.00117,87199,34.12262,255546
2307,zhiyxu,3,0.00117,87202,34.12380,255546
2308,zhyon404,3,0.00117,87205,34.12497,255546
2309,zhzhang,3,0.00117,87208,34.12615,255546
2310,zm274310577,3,0.00117,87211,34.12732,255546
2311,zqz-net,3,0.00117,87214,34.12849,255546
2312,ZxMYS,3,0.00117,87217,34.12967,255546
2313,zzha2941,3,0.00117,87220,34.13084,255546
2314,11mhg,2,0.00078,87222,34.13162,255546
2315,Aakash1822,2,0.00078,87224,34.13241,255546
2316,aaronsssya,2,0.00078,87226,34.13319,255546
2317,aashish-sheshadri,2,0.00078,87228,34.13397,255546
2318,aba-ca-xi,2,0.00078,87230,34.13475,255546
2319,abdullin,2,0.00078,87232,34.13554,255546
2320,abimur-123,2,0.00078,87234,34.13632,255546
2321,abishek-murali,2,0.00078,87236,34.13710,255546
2322,abramovi,2,0.00078,87238,34.13789,255546
2323,abrarmajeedi,2,0.00078,87240,34.13867,255546
2324,abreu4,2,0.00078,87242,34.13945,255546
2325,ace-gabriel,2,0.00078,87244,34.14023,255546
2326,achal-wwt,2,0.00078,87246,34.14102,255546
2327,adhaene-noimos,2,0.00078,87248,34.14180,255546
2328,AdityaSoni19031997,2,0.00078,87250,34.14258,255546
2329,adiwijaya,2,0.00078,87252,34.14336,255546
2330,adrshm91,2,0.00078,87254,34.14415,255546
2331,adux6991,2,0.00078,87256,34.14493,255546
2332,adyachok,2,0.00078,87258,34.14571,255546
2333,afilcheff,2,0.00078,87260,34.14649,255546
2334,agnim25,2,0.00078,87262,34.14728,255546
2335,agoblet,2,0.00078,87264,34.14806,255546
2336,ahmed1alqulayti,2,0.00078,87266,34.14884,255546
2337,aicdp1010,2,0.00078,87268,34.14962,255546
2338,AiDataSciencer,2,0.00078,87270,34.15041,255546
2339,aka-toxa,2,0.00078,87272,34.15119,255546
2340,akhimji,2,0.00078,87274,34.15197,255546
2341,akravacyber,2,0.00078,87276,34.15276,255546
2342,akshatgit,2,0.00078,87278,34.15354,255546
2343,aku134,2,0.00078,87280,34.15432,255546
2344,Al4DIN,2,0.00078,87282,34.15510,255546
2345,alanhughes,2,0.00078,87284,34.15589,255546
2346,AldusLorde,2,0.00078,87286,34.15667,255546
2347,alekseyolg,2,0.00078,87288,34.15745,255546
2348,AlexanderCHarrington,2,0.00078,87290,34.15823,255546
2349,AlexChenSkyBlue,2,0.00078,87292,34.15902,255546
2350,alexcoca,2,0.00078,87294,34.15980,255546
2351,alexmirrington,2,0.00078,87296,34.16058,255546
2352,alexw994,2,0.00078,87298,34.16136,255546
2353,Alienfeel,2,0.00078,87300,34.16215,255546
2354,alok-raj,2,0.00078,87302,34.16293,255546
2355,amalow,2,0.00078,87304,34.16371,255546
2356,ameya-parab,2,0.00078,87306,34.16449,255546
2357,Amishakumari544,2,0.00078,87308,34.16528,255546
2358,amitchnick,2,0.00078,87310,34.16606,255546
2359,ammubharatram,2,0.00078,87312,34.16684,255546
2360,amosaini,2,0.00078,87314,34.16763,255546
2361,amostech,2,0.00078,87316,34.16841,255546
2362,andersonvc,2,0.00078,87318,34.16919,255546
2363,andong0323,2,0.00078,87320,34.16997,255546
2364,andradron,2,0.00078,87322,34.17076,255546
2365,andreas-schliebitz,2,0.00078,87324,34.17154,255546
2366,andrebriggs,2,0.00078,87326,34.17232,255546
2367,andrewcantos,2,0.00078,87328,34.17310,255546
2368,andyk,2,0.00078,87330,34.17389,255546
2369,andyswift,2,0.00078,87332,34.17467,255546
2370,andyzheung,2,0.00078,87334,34.17545,255546
2371,anhuaxiang,2,0.00078,87336,34.17623,255546
2372,animesh-agarwal,2,0.00078,87338,34.17702,255546
2373,AnkitRai-22,2,0.00078,87340,34.17780,255546
2374,AnnaYue,2,0.00078,87342,34.17858,255546
2375,anshuman-cg,2,0.00078,87344,34.17936,255546
2376,anyingl,2,0.00078,87346,34.18015,255546
2377,aoighost,2,0.00078,87348,34.18093,255546
2378,apshoemaker,2,0.00078,87350,34.18171,255546
2379,apurva3000,2,0.00078,87352,34.18250,255546
2380,arashd,2,0.00078,87354,34.18328,255546
2381,Archa91,2,0.00078,87356,34.18406,255546
2382,aresa7796,2,0.00078,87358,34.18484,255546
2383,arianpasquali,2,0.00078,87360,34.18563,255546
2384,arinto,2,0.00078,87362,34.18641,255546
2385,arjun921,2,0.00078,87364,34.18719,255546
2386,arlofaria,2,0.00078,87366,34.18797,255546
2387,asaydin,2,0.00078,87368,34.18876,255546
2388,Aschwinvo,2,0.00078,87370,34.18954,255546
2389,Ashish-Bhau,2,0.00078,87372,34.19032,255546
2390,ashokbalaraman,2,0.00078,87374,34.19110,255546
2391,ashokramadass,2,0.00078,87376,34.19189,255546
2392,asif001,2,0.00078,87378,34.19267,255546
2393,asmod3us,2,0.00078,87380,34.19345,255546
2394,atamahjoubfar,2,0.00078,87382,34.19424,255546
2395,atbraoy,2,0.00078,87384,34.19502,255546
2396,athensofamerica,2,0.00078,87386,34.19580,255546
2397,at-machine-user,2,0.00078,87388,34.19658,255546
2398,Attila111111,2,0.00078,87390,34.19737,255546
2399,avik-taranis,2,0.00078,87392,34.19815,255546
2400,avintonOfficial,2,0.00078,87394,34.19893,255546
2401,awl-ext-hoangtml,2,0.00078,87396,34.19971,255546
2402,AxdorphCoder,2,0.00078,87398,34.20050,255546
2403,ayushpandeyemotionrx,2,0.00078,87400,34.20128,255546
2404,banderlog,2,0.00078,87402,34.20206,255546
2405,bankentan,2,0.00078,87404,34.20284,255546
2406,Barteus,2,0.00078,87406,34.20363,255546
2407,bcebere,2,0.00078,87408,34.20441,255546
2408,bdlb77,2,0.00078,87410,34.20519,255546
2409,bearrito,2,0.00078,87412,34.20597,255546
2410,Benjamin-Etheredge,2,0.00078,87414,34.20676,255546
2411,bertinma,2,0.00078,87416,34.20754,255546
2412,beyersito,2,0.00078,87418,34.20832,255546
2413,bgpatel,2,0.00078,87420,34.20911,255546
2414,bhupc,2,0.00078,87422,34.20989,255546
2415,bigflood,2,0.00078,87424,34.21067,255546
2416,bioshazard,2,0.00078,87426,34.21145,255546
2417,bjmrevilla,2,0.00078,87428,34.21224,255546
2418,bkhuong,2,0.00078,87430,34.21302,255546
2419,blacky-i,2,0.00078,87432,34.21380,255546
2420,BlodwenZ,2,0.00078,87434,34.21458,255546
2421,bmopuri,2,0.00078,87436,34.21537,255546
2422,bobmerevel,2,0.00078,87438,34.21615,255546
2423,BOBO-ZzB,2,0.00078,87440,34.21693,255546
2424,Bonbonbg,2,0.00078,87442,34.21771,255546
2425,bonclay,2,0.00078,87444,34.21850,255546
2426,borremosch,2,0.00078,87446,34.21928,255546
2427,bradleykcardwell,2,0.00078,87448,34.22006,255546
2428,brendanobra,2,0.00078,87450,34.22084,255546
2429,brianmartin,2,0.00078,87452,34.22163,255546
2430,brness,2,0.00078,87454,34.22241,255546
2431,BroderPeters,2,0.00078,87456,34.22319,255546
2432,brucearctor,2,0.00078,87458,34.22398,255546
2433,brussell757,2,0.00078,87460,34.22476,255546
2434,bryanye97,2,0.00078,87462,34.22554,255546
2435,bug-developer021,2,0.00078,87464,34.22632,255546
2436,buluba89,2,0.00078,87466,34.22711,255546
2437,ByronHsu,2,0.00078,87468,34.22789,255546
2438,byronyi,2,0.00078,87470,34.22867,255546
2439,caiyuanji,2,0.00078,87472,34.22945,255546
2440,calebmoss,2,0.00078,87474,34.23024,255546
2441,CaNignEX,2,0.00078,87476,34.23102,255546
2442,carmat88,2,0.00078,87478,34.23180,255546
2443,Cas-pian,2,0.00078,87480,34.23258,255546
2444,cavepopo,2,0.00078,87482,34.23337,255546
2445,cchung100m,2,0.00078,87484,34.23415,255546
2446,cdraper-CS,2,0.00078,87486,34.23493,255546
2447,cdyangzhenyu,2,0.00078,87488,34.23571,255546
2448,cells2numbers,2,0.00078,87490,34.23650,255546
2449,cgparkinson,2,0.00078,87492,34.23728,255546
2450,chanansh,2,0.00078,87494,34.23806,255546
2451,charlesmelby,2,0.00078,87496,34.23885,255546
2452,Charlie-L-K,2,0.00078,87498,34.23963,255546
2453,chen98,2,0.00078,87500,34.24041,255546
2454,chenglinzhang,2,0.00078,87502,34.24119,255546
2455,chenhan1218,2,0.00078,87504,34.24198,255546
2456,chenmay0921,2,0.00078,87506,34.24276,255546
2457,chennupushkar,2,0.00078,87508,34.24354,255546
2458,Chenxs1122,2,0.00078,87510,34.24432,255546
2459,chienfuchen32,2,0.00078,87512,34.24511,255546
2460,chlun1,2,0.00078,87514,34.24589,255546
2461,choismn00,2,0.00078,87516,34.24667,255546
2462,chpmoreno,2,0.00078,87518,34.24745,255546
2463,chris-andrasick,2,0.00078,87520,34.24824,255546
2464,ChrisMagnuson,2,0.00078,87522,34.24902,255546
2465,chrisstockton,2,0.00078,87524,34.24980,255546
2466,chriswu99aaa,2,0.00078,87526,34.25059,255546
2467,chunyang-wen,2,0.00078,87528,34.25137,255546
2468,ChusMoyano,2,0.00078,87530,34.25215,255546
2469,chwonghk01,2,0.00078,87532,34.25293,255546
2470,cjidboon94,2,0.00078,87534,34.25372,255546
2471,clarizzafern,2,0.00078,87536,34.25450,255546
2472,cm185255,2,0.00078,87538,34.25528,255546
2473,C-nit,2,0.00078,87540,34.25606,255546
2474,constanton,2,0.00078,87542,34.25685,255546
2475,Corezcy,2,0.00078,87544,34.25763,255546
2476,cornleaf,2,0.00078,87546,34.25841,255546
2477,corvin-quodai,2,0.00078,87548,34.25919,255546
2478,CreatorSky,2,0.00078,87550,34.25998,255546
2479,crogers923,2,0.00078,87552,34.26076,255546
2480,CRSilkworth,2,0.00078,87554,34.26154,255546
2481,cruxyoung,2,0.00078,87556,34.26232,255546
2482,cupdike,2,0.00078,87558,34.26311,255546
2483,custom8,2,0.00078,87560,34.26389,255546
2484,cyfdecyf,2,0.00078,87562,34.26467,255546
2485,D1o0g9s,2,0.00078,87564,34.26546,255546
2486,daisuke834,2,0.00078,87566,34.26624,255546
2487,dalxds,2,0.00078,87568,34.26702,255546
2488,danielrs,2,0.00078,87570,34.26780,255546
2489,daniel-woolworths,2,0.00078,87572,34.26859,255546
2490,DanMcInerney,2,0.00078,87574,34.26937,255546
2491,dardanbekteshi,2,0.00078,87576,34.27015,255546
2492,DarioBernardo,2,0.00078,87578,34.27093,255546
2493,darkopevec,2,0.00078,87580,34.27172,255546
2494,darthveda-ai,2,0.00078,87582,34.27250,255546
2495,davemaung,2,0.00078,87584,34.27328,255546
2496,davidgao7,2,0.00078,87586,34.27406,255546
2497,DavidGeW,2,0.00078,87588,34.27485,255546
2498,davidggz,2,0.00078,87590,34.27563,255546
2499,davidtwomey,2,0.00078,87592,34.27641,255546
2500,dawu76,2,0.00078,87594,34.27719,255546
2501,DDDDDDDDDDDDLANG,2,0.00078,87596,34.27798,255546
2502,DDFaller,2,0.00078,87598,34.27876,255546
2503,Deancup,2,0.00078,87600,34.27954,255546
2504,derekwyatt,2,0.00078,87602,34.28033,255546
2505,DeshuaiWang,2,0.00078,87604,34.28111,255546
2506,DesmondH0,2,0.00078,87606,34.28189,255546
2507,devenjarvis,2,0.00078,87608,34.28267,255546
2508,devil-cyber,2,0.00078,87610,34.28346,255546
2509,devoftheweb,2,0.00078,87612,34.28424,255546
2510,dewnull,2,0.00078,87614,34.28502,255546
2511,dgess,2,0.00078,87616,34.28580,255546
2512,DHolmanCoding,2,0.00078,87618,34.28659,255546
2513,diazidabagus,2,0.00078,87620,34.28737,255546
2514,DimaKav,2,0.00078,87622,34.28815,255546
2515,d-kavaliou,2,0.00078,87624,34.28893,255546
2516,dmrub,2,0.00078,87626,34.28972,255546
2517,doctorai-in,2,0.00078,87628,34.29050,255546
2518,doepking,2,0.00078,87630,34.29128,255546
2519,dogukanutuna,2,0.00078,87632,34.29206,255546
2520,DorotheaKal,2,0.00078,87634,34.29285,255546
2521,dragonwarp,2,0.00078,87636,34.29363,255546
2522,dredwilliams,2,0.00078,87638,34.29441,255546
2523,drobison-deloitte,2,0.00078,87640,34.29520,255546
2524,dsblank,2,0.00078,87642,34.29598,255546
2525,dshen51,2,0.00078,87644,34.29676,255546
2526,duoduo-ai,2,0.00078,87646,34.29754,255546
2527,durch,2,0.00078,87648,34.29833,255546
2528,duttab49,2,0.00078,87650,34.29911,255546
2529,dvdbisong,2,0.00078,87652,34.29989,255546
2530,Dylan-Rich,2,0.00078,87654,34.30067,255546
2531,e-compagno,2,0.00078,87656,34.30146,255546
2532,ediphy-azorab,2,0.00078,87658,34.30224,255546
2533,EdMorrell,2,0.00078,87660,34.30302,255546
2534,edowson,2,0.00078,87662,34.30380,255546
2535,Efthymios-Stathakis,2,0.00078,87664,34.30459,255546
2536,Eliasecchi,2,0.00078,87666,34.30537,255546
2537,EricBentoML,2,0.00078,87668,34.30615,255546
2538,Eshan-Agarwal,2,0.00078,87670,34.30693,255546
2539,eshiroma,2,0.00078,87672,34.30772,255546
2540,espears1,2,0.00078,87674,34.30850,255546
2541,etracer65,2,0.00078,87676,34.30928,255546
2542,eugenesiow,2,0.00078,87678,34.31007,255546
2543,ev4isthos,2,0.00078,87680,34.31085,255546
2544,Evanto,2,0.00078,87682,34.31163,255546
2545,ever-cheng,2,0.00078,87684,34.31241,255546
2546,ey00,2,0.00078,87686,34.31320,255546
2547,eykanal,2,0.00078,87688,34.31398,255546
2548,ezeeyahoo,2,0.00078,87690,34.31476,255546
2549,f6wbl6,2,0.00078,87692,34.31554,255546
2550,falcocoris,2,0.00078,87694,34.31633,255546
2551,Faraz743,2,0.00078,87696,34.31711,255546
2552,farazmujtaba,2,0.00078,87698,34.31789,255546
2553,farshadsm,2,0.00078,87700,34.31867,255546
2554,fberanizo,2,0.00078,87702,34.31946,255546
2555,felixhuangau,2,0.00078,87704,34.32024,255546
2556,ferpitol,2,0.00078,87706,34.32102,255546
2557,FGXZ2JO,2,0.00078,87708,34.32181,255546
2558,Findlazyfriend,2,0.00078,87710,34.32259,255546
2559,Fizmath,2,0.00078,87712,34.32337,255546
2560,FKSI,2,0.00078,87714,34.32415,255546
2561,floleuerer,2,0.00078,87716,34.32494,255546
2562,Franco8888,2,0.00078,87718,34.32572,255546
2563,gajanankulkarni-18,2,0.00078,87720,34.32650,255546
2564,GarrettMooney,2,0.00078,87722,34.32728,255546
2565,garrettwong,2,0.00078,87724,34.32807,255546
2566,geoantony9,2,0.00078,87726,34.32885,255546
2567,GeorgeLeePatterson,2,0.00078,87728,34.32963,255546
2568,Geoyi,2,0.00078,87730,34.33041,255546
2569,gerrith3,2,0.00078,87732,34.33120,255546
2570,Gevorg-Minasyan,2,0.00078,87734,34.33198,255546
2571,gfyulx,2,0.00078,87736,34.33276,255546
2572,giogit,2,0.00078,87738,34.33354,255546
2573,GitHub007Dra,2,0.00078,87740,34.33433,255546
2574,glong1997,2,0.00078,87742,34.33511,255546
2575,goofy-z,2,0.00078,87744,34.33589,255546
2576,graykode,2,0.00078,87746,34.33668,255546
2577,greggdonovan,2,0.00078,87748,34.33746,255546
2578,guykhazma,2,0.00078,87750,34.33824,255546
2579,GytisBraz,2,0.00078,87752,34.33902,255546
2580,hahamark1,2,0.00078,87754,34.33981,255546
2581,hahns0lo,2,0.00078,87756,34.34059,255546
2582,hanan9m,2,0.00078,87758,34.34137,255546
2583,harish422,2,0.00078,87760,34.34215,255546
2584,Harishkrishna17,2,0.00078,87762,34.34294,255546
2585,harmeet-singh-discovery,2,0.00078,87764,34.34372,255546
2586,hasansalimkanmaz,2,0.00078,87766,34.34450,255546
2587,hchiuzhuo,2,0.00078,87768,34.34528,255546
2588,hegand,2,0.00078,87770,34.34607,255546
2589,heilerich,2,0.00078,87772,34.34685,255546
2590,hemangjoshi37a,2,0.00078,87774,34.34763,255546
2591,HenryW95,2,0.00078,87776,34.34841,255546
2592,hexiaoliangRick,2,0.00078,87778,34.34920,255546
2593,hfarooqui,2,0.00078,87780,34.34998,255546
2594,hfwen0502,2,0.00078,87782,34.35076,255546
2595,hhji,2,0.00078,87784,34.35155,255546
2596,hideto0710,2,0.00078,87786,34.35233,255546
2597,hikoz,2,0.00078,87788,34.35311,255546
2598,himkt,2,0.00078,87790,34.35389,255546
2599,hkair,2,0.00078,87792,34.35468,255546
2600,hlngaiSam,2,0.00078,87794,34.35546,255546
2601,hmchen-github,2,0.00078,87796,34.35624,255546
2602,hoangtnm,2,0.00078,87798,34.35702,255546
2603,holadepo,2,0.00078,87800,34.35781,255546
2604,hongyonggan,2,0.00078,87802,34.35859,255546
2605,hossein-rasi,2,0.00078,87804,34.35937,255546
2606,hsteude,2,0.00078,87806,34.36015,255546
2607,huang06,2,0.00078,87808,34.36094,255546
2608,huboqiang,2,0.00078,87810,34.36172,255546
2609,Huy199,2,0.00078,87812,34.36250,255546
2610,HVKHCM,2,0.00078,87814,34.36328,255546
2611,hwang9u,2,0.00078,87816,34.36407,255546
2612,hwHans,2,0.00078,87818,34.36485,255546
2613,hyperparameters,2,0.00078,87820,34.36563,255546
2614,iBluemind,2,0.00078,87822,34.36642,255546
2615,i-chvets,2,0.00078,87824,34.36720,255546
2616,idahoakl,2,0.00078,87826,34.36798,255546
2617,idibidiart,2,0.00078,87828,34.36876,255546
2618,iedmrc,2,0.00078,87830,34.36955,255546
2619,ihorby,2,0.00078,87832,34.37033,255546
2620,II-VSB-II,2,0.00078,87834,34.37111,255546
2621,ilchemla,2,0.00078,87836,34.37189,255546
2622,ilovecomet,2,0.00078,87838,34.37268,255546
2623,ImadEddineBek,2,0.00078,87840,34.37346,255546
2624,imagr-pat,2,0.00078,87842,34.37424,255546
2625,indranilr,2,0.00078,87844,34.37502,255546
2626,isaacmg,2,0.00078,87846,34.37581,255546
2627,isaranto,2,0.00078,87848,34.37659,255546
2628,IsraelAbebe,2,0.00078,87850,34.37737,255546
2629,isuyyy,2,0.00078,87852,34.37816,255546
2630,Itfly,2,0.00078,87854,34.37894,255546
2631,IvanAlejandro888,2,0.00078,87856,34.37972,255546
2632,ivanjacobsec,2,0.00078,87858,34.38050,255546
2633,ivryan,2,0.00078,87860,34.38129,255546
2634,Jabbo16,2,0.00078,87862,34.38207,255546
2635,JackDallas,2,0.00078,87864,34.38285,255546
2636,jackhuang007,2,0.00078,87866,34.38363,255546
2637,jacklu2016,2,0.00078,87868,34.38442,255546
2638,jaggaer-mtrninic,2,0.00078,87870,34.38520,255546
2639,Jalmeida1994,2,0.00078,87872,34.38598,255546
2640,jamesandres,2,0.00078,87874,34.38676,255546
2641,jamessandy,2,0.00078,87876,34.38755,255546
2642,jammingyu9,2,0.00078,87878,34.38833,255546
2643,JasonPad19,2,0.00078,87880,34.38911,255546
2644,javiroman,2,0.00078,87882,34.38989,255546
2645,jayaprasadt,2,0.00078,87884,34.39068,255546
2646,jaystary,2,0.00078,87886,34.39146,255546
2647,jcRisch,2,0.00078,87888,34.39224,255546
2648,JCzz,2,0.00078,87890,34.39303,255546
2649,jdavis34265,2,0.00078,87892,34.39381,255546
2650,jdurago,2,0.00078,87894,34.39459,255546
2651,JebasinghLuccas,2,0.00078,87896,34.39537,255546
2652,JeffersonH44,2,0.00078,87898,34.39616,255546
2653,jentrialgo,2,0.00078,87900,34.39694,255546
2654,Jetafull,2,0.00078,87902,34.39772,255546
2655,jhamet93,2,0.00078,87904,34.39850,255546
2656,jhebelerDS,2,0.00078,87906,34.39929,255546
2657,jhs0318,2,0.00078,87908,34.40007,255546
2658,jimenan-iguazio,2,0.00078,87910,34.40085,255546
2659,jimspohrer,2,0.00078,87912,34.40163,255546
2660,jinseonlee1215,2,0.00078,87914,34.40242,255546
2661,jithinvalsalan,2,0.00078,87916,34.40320,255546
2662,jiujiang,2,0.00078,87918,34.40398,255546
2663,jkchang,2,0.00078,87920,34.40476,255546
2664,jnmaomao,2,0.00078,87922,34.40555,255546
2665,joal-zb,2,0.00078,87924,34.40633,255546
2666,joesan,2,0.00078,87926,34.40711,255546
2667,johnchenghk01,2,0.00078,87928,34.40790,255546
2668,joinal-ahmed,2,0.00078,87930,34.40868,255546
2669,jonathanglima,2,0.00078,87932,34.40946,255546
2670,jonathangold,2,0.00078,87934,34.41024,255546
2671,JonChanGit,2,0.00078,87936,34.41103,255546
2672,jonghyunho,2,0.00078,87938,34.41181,255546
2673,Jooho,2,0.00078,87940,34.41259,255546
2674,josete89,2,0.00078,87942,34.41337,255546
2675,jpic,2,0.00078,87944,34.41416,255546
2676,JP-MRPhys,2,0.00078,87946,34.41494,255546
2677,jpvandervelden,2,0.00078,87948,34.41572,255546
2678,jrabary,2,0.00078,87950,34.41650,255546
2679,jrabiah,2,0.00078,87952,34.41729,255546
2680,jszendre,2,0.00078,87954,34.41807,255546
2681,JuanPabloSebey,2,0.00078,87956,34.41885,255546
2682,juan-sv,2,0.00078,87958,34.41963,255546
2683,juhyeon-cha,2,0.00078,87960,34.42042,255546
2684,junggeh,2,0.00078,87962,34.42120,255546
2685,junyazhang,2,0.00078,87964,34.42198,255546
2686,jusingh,2,0.00078,87966,34.42277,255546
2687,JustinReboullot,2,0.00078,87968,34.42355,255546
2688,j-wezel,2,0.00078,87970,34.42433,255546
2689,JyothsnaPendyala,2,0.00078,87972,34.42511,255546
2690,jzonthemtn,2,0.00078,87974,34.42590,255546
2691,kaikun213,2,0.00078,87976,34.42668,255546
2692,kamal24111991,2,0.00078,87978,34.42746,255546
2693,kanwaljitkhurmi,2,0.00078,87980,34.42824,255546
2694,karkumar,2,0.00078,87982,34.42903,255546
2695,karmicdude,2,0.00078,87984,34.42981,255546
2696,KatyaRuth,2,0.00078,87986,34.43059,255546
2697,kcturner123,2,0.00078,87988,34.43137,255546
2698,kenhktsui,2,0.00078,87990,34.43216,255546
2699,kenugraha,2,0.00078,87992,34.43294,255546
2700,kenwoodjw,2,0.00078,87994,34.43372,255546
2701,kevincasadodsc,2,0.00078,87996,34.43450,255546
2702,khangtrantri,2,0.00078,87998,34.43529,255546
2703,khsibr,2,0.00078,88000,34.43607,255546
2704,ki-arie,2,0.00078,88002,34.43685,255546
2705,kikko,2,0.00078,88004,34.43764,255546
2706,Kiza,2,0.00078,88006,34.43842,255546
2707,k-jeon,2,0.00078,88008,34.43920,255546
2708,klaus82,2,0.00078,88010,34.43998,255546
2709,Klein-Hu,2,0.00078,88012,34.44077,255546
2710,kmathiou,2,0.00078,88014,34.44155,255546
2711,KMFidom,2,0.00078,88016,34.44233,255546
2712,koenmtb1,2,0.00078,88018,34.44311,255546
2713,kolakows,2,0.00078,88020,34.44390,255546
2714,KonstantinosAnd,2,0.00078,88022,34.44468,255546
2715,koseoyoung,2,0.00078,88024,34.44546,255546
2716,kpeters,2,0.00078,88026,34.44624,255546
2717,kslin,2,0.00078,88028,34.44703,255546
2718,kstory8,2,0.00078,88030,34.44781,255546
2719,kubeflow-examples,2,0.00078,88032,34.44859,255546
2720,kuldeepjain,2,0.00078,88034,34.44938,255546
2721,kunalpatel1793,2,0.00078,88036,34.45016,255546
2722,kylegc,2,0.00078,88038,34.45094,255546
2723,kzh,2,0.00078,88040,34.45172,255546
2724,lambertsbennett,2,0.00078,88042,34.45251,255546
2725,Lance410247,2,0.00078,88044,34.45329,255546
2726,larry-lu-lu,2,0.00078,88046,34.45407,255546
2727,larsderidder,2,0.00078,88048,34.45485,255546
2728,LasalJayawardena,2,0.00078,88050,34.45564,255546
2729,laurentbastien,2,0.00078,88052,34.45642,255546
2730,lawdpls,2,0.00078,88054,34.45720,255546
2731,lbatteau,2,0.00078,88056,34.45798,255546
2732,lc-billyfung,2,0.00078,88058,34.45877,255546
2733,LeBoyOrion,2,0.00078,88060,34.45955,255546
2734,leeqleeqleeq,2,0.00078,88062,34.46033,255546
2735,leorleor,2,0.00078,88064,34.46111,255546
2736,lfloeer,2,0.00078,88066,34.46190,255546
2737,lightingghost,2,0.00078,88068,34.46268,255546
2738,limotkl,2,0.00078,88070,34.46346,255546
2739,liu431,2,0.00078,88072,34.46425,255546
2740,liuchintao,2,0.00078,88074,34.46503,255546
2741,liujun121533,2,0.00078,88076,34.46581,255546
2742,liusy182,2,0.00078,88078,34.46659,255546
2743,LiuZhiYuan123456,2,0.00078,88080,34.46738,255546
2744,lixianfa,2,0.00078,88082,34.46816,255546
2745,lizzy220,2,0.00078,88084,34.46894,255546
2746,llKetanll,2,0.00078,88086,34.46972,255546
2747,Longwelwind,2,0.00078,88088,34.47051,255546
2748,Lord-V15,2,0.00078,88090,34.47129,255546
2749,Louanes1,2,0.00078,88092,34.47207,255546
2750,LouNauSRC,2,0.00078,88094,34.47285,255546
2751,lppsuixn,2,0.00078,88096,34.47364,255546
2752,lucaseo90,2,0.00078,88098,34.47442,255546
2753,lucien-kejl,2,0.00078,88100,34.47520,255546
2754,ludans,2,0.00078,88102,34.47598,255546
2755,luigicr1965,2,0.00078,88104,34.47677,255546
2756,lukeogg,2,0.00078,88106,34.47755,255546
2757,lukkiddd,2,0.00078,88108,34.47833,255546
2758,LutzWeischerFujitsu,2,0.00078,88110,34.47912,255546
2759,lvbaouu,2,0.00078,88112,34.47990,255546
2760,Lyken17,2,0.00078,88114,34.48068,255546
2761,lynochka,2,0.00078,88116,34.48146,255546
2762,m10913044,2,0.00078,88118,34.48225,255546
2763,m1ghtym0,2,0.00078,88120,34.48303,255546
2764,magdalenakuhn,2,0.00078,88122,34.48381,255546
2765,mannuscript,2,0.00078,88124,34.48459,255546
2766,manolis-andr,2,0.00078,88126,34.48538,255546
2767,maorzalt,2,0.00078,88128,34.48616,255546
2768,mapdegree,2,0.00078,88130,34.48694,255546
2769,mareksuscak,2,0.00078,88132,34.48772,255546
2770,markbeierl,2,0.00078,88134,34.48851,255546
2771,marlow-h,2,0.00078,88136,34.48929,255546
2772,marsupialtail,2,0.00078,88138,34.49007,255546
2773,martinbomio,2,0.00078,88140,34.49085,255546
2774,martin-gorner,2,0.00078,88142,34.49164,255546
2775,martin-liu,2,0.00078,88144,34.49242,255546
2776,mat0pad,2,0.00078,88146,34.49320,255546
2777,math-sasso,2,0.00078,88148,34.49399,255546
2778,mattcallanan,2,0.00078,88150,34.49477,255546
2779,mattdornfeld,2,0.00078,88152,34.49555,255546
2780,MatteoFelici,2,0.00078,88154,34.49633,255546
2781,matthiasfalk,2,0.00078,88156,34.49712,255546
2782,mattiasliljenzin,2,0.00078,88158,34.49790,255546
2783,mattmcclean,2,0.00078,88160,34.49868,255546
2784,maurizio-vitale,2,0.00078,88162,34.49946,255546
2785,mdruby,2,0.00078,88164,34.50025,255546
2786,mehrdadnd,2,0.00078,88166,34.50103,255546
2787,meneal,2,0.00078,88168,34.50181,255546
2788,mengxi-ascent,2,0.00078,88170,34.50259,255546
2789,merryzhou,2,0.00078,88172,34.50338,255546
2790,mfabdrabou,2,0.00078,88174,34.50416,255546
2791,mfruhner,2,0.00078,88176,34.50494,255546
2792,mgr2178,2,0.00078,88178,34.50572,255546
2793,micahjsmith,2,0.00078,88180,34.50651,255546
2794,michael-balint,2,0.00078,88182,34.50729,255546
2795,MiHess,2,0.00078,88184,34.50807,255546
2796,Minyus,2,0.00078,88186,34.50886,255546
2797,misohu,2,0.00078,88188,34.50964,255546
2798,misteliy,2,0.00078,88190,34.51042,255546
2799,MJ-Amway,2,0.00078,88192,34.51120,255546
2800,mjgrav2001,2,0.00078,88194,34.51199,255546
2801,ml6-liam,2,0.00078,88196,34.51277,255546
2802,Mlawrence95,2,0.00078,88198,34.51355,255546
2803,mmalviya,2,0.00078,88200,34.51433,255546
2804,mohamadmansourX,2,0.00078,88202,34.51512,255546
2805,mohamedFaris47,2,0.00078,88204,34.51590,255546
2806,monil536,2,0.00078,88206,34.51668,255546
2807,montanier,2,0.00078,88208,34.51746,255546
2808,mouradmourafiq,2,0.00078,88210,34.51825,255546
2809,mparkhe,2,0.00078,88212,34.51903,255546
2810,mrjgamble,2,0.00078,88214,34.51981,255546
2811,mrudulan,2,0.00078,88216,34.52060,255546
2812,mshyeon,2,0.00078,88218,34.52138,255546
2813,msteiner-google,2,0.00078,88220,34.52216,255546
2814,mukul-mehta,2,0.00078,88222,34.52294,255546
2815,Mullefa,2,0.00078,88224,34.52373,255546
2816,muscovitebob,2,0.00078,88226,34.52451,255546
2817,Muzry,2,0.00078,88228,34.52529,255546
2818,mwarzynski,2,0.00078,88230,34.52607,255546
2819,Mykolaichenko,2,0.00078,88232,34.52686,255546
2820,n3011,2,0.00078,88234,34.52764,255546
2821,nabsabraham,2,0.00078,88236,34.52842,255546
2822,Naegionn,2,0.00078,88238,34.52920,255546
2823,namespace-io,2,0.00078,88240,34.52999,255546
2824,Nancy-Badran,2,0.00078,88242,34.53077,255546
2825,Nancylsell,2,0.00078,88244,34.53155,255546
2826,natalytvinova,2,0.00078,88246,34.53233,255546
2827,NateRoiger,2,0.00078,88248,34.53312,255546
2828,nathanwong91,2,0.00078,88250,34.53390,255546
2829,NeerajGulia,2,0.00078,88252,34.53468,255546
2830,neofarm473,2,0.00078,88254,34.53547,255546
2831,nephenthe,2,0.00078,88256,34.53625,255546
2832,nexemjail,2,0.00078,88258,34.53703,255546
2833,nicexxact,2,0.00078,88260,34.53781,255546
2834,nicholas-fwang,2,0.00078,88262,34.53860,255546
2835,nickiegk,2,0.00078,88264,34.53938,255546
2836,NickJasonLv,2,0.00078,88266,34.54016,255546
2837,nicosac97,2,0.00078,88268,34.54094,255546
2838,Nidhidamodaran,2,0.00078,88270,34.54173,255546
2839,nikan1996,2,0.00078,88272,34.54251,255546
2840,nikhil-dce,2,0.00078,88274,34.54329,255546
2841,Niko32,2,0.00078,88276,34.54407,255546
2842,nirmalsinghania2008,2,0.00078,88278,34.54486,255546
2843,niteshldd,2,0.00078,88280,34.54564,255546
2844,Nivedita-V,2,0.00078,88282,34.54642,255546
2845,nlaanait,2,0.00078,88284,34.54720,255546
2846,nowenL,2,0.00078,88286,34.54799,255546
2847,nphilou,2,0.00078,88288,34.54877,255546
2848,nschenone,2,0.00078,88290,34.54955,255546
2849,ns-jman,2,0.00078,88292,34.55034,255546
2850,oakkas,2,0.00078,88294,34.55112,255546
2851,ocdkube,2,0.00078,88296,34.55190,255546
2852,OfTheThorn,2,0.00078,88298,34.55268,255546
2853,oguzhanoyan,2,0.00078,88300,34.55347,255546
2854,omerfsen-gsnd,2,0.00078,88302,34.55425,255546
2855,onelittlenightmusic,2,0.00078,88304,34.55503,255546
2856,OnionSmile,2,0.00078,88306,34.55581,255546
2857,ooverandout,2,0.00078,88308,34.55660,255546
2858,OrenLeung,2,0.00078,88310,34.55738,255546
2859,osabobo,2,0.00078,88312,34.55816,255546
2860,owmasch,2,0.00078,88314,34.55894,255546
2861,ozora-ogino,2,0.00078,88316,34.55973,255546
2862,pablogsal,2,0.00078,88318,34.56051,255546
2863,pankajxyz,2,0.00078,88320,34.56129,255546
2864,parthasarathi-pm,2,0.00078,88322,34.56207,255546
2865,patelmm79,2,0.00078,88324,34.56286,255546
2866,patrickmead,2,0.00078,88326,34.56364,255546
2867,paxinos,2,0.00078,88328,34.56442,255546
2868,pedrocwb,2,0.00078,88330,34.56521,255546
2869,peteboothroyd,2,0.00078,88332,34.56599,255546
2870,phejimlin,2,0.00078,88334,34.56677,255546
2871,philipebuka,2,0.00078,88336,34.56755,255546
2872,PhilippeBarb,2,0.00078,88338,34.56834,255546
2873,philmln,2,0.00078,88340,34.56912,255546
2874,phonaylin,2,0.00078,88342,34.56990,255546
2875,piernikR,2,0.00078,88344,34.57068,255546
2876,PierrickPochelu,2,0.00078,88346,34.57147,255546
2877,piyushcse29,2,0.00078,88348,34.57225,255546
2878,pjsudharshan,2,0.00078,88350,34.57303,255546
2879,pkamath,2,0.00078,88352,34.57381,255546
2880,pkasson-ascena,2,0.00078,88354,34.57460,255546
2881,pmangg,2,0.00078,88356,34.57538,255546
2882,polsm91,2,0.00078,88358,34.57616,255546
2883,porterdarby,2,0.00078,88360,34.57695,255546
2884,pragadeeshraju,2,0.00078,88362,34.57773,255546
2885,pranasblk,2,0.00078,88364,34.57851,255546
2886,prateek1192,2,0.00078,88366,34.57929,255546
2887,psc-dlt,2,0.00078,88368,34.58008,255546
2888,pshegde,2,0.00078,88370,34.58086,255546
2889,psisoft,2,0.00078,88372,34.58164,255546
2890,pupilye,2,0.00078,88374,34.58242,255546
2891,pymia,2,0.00078,88376,34.58321,255546
2892,qinshuaihua,2,0.00078,88378,34.58399,255546
2893,radics93,2,0.00078,88380,34.58477,255546
2894,rafaascensao,2,0.00078,88382,34.58555,255546
2895,rafaelnovello,2,0.00078,88384,34.58634,255546
2896,rafalk0,2,0.00078,88386,34.58712,255546
2897,rairithesh123,2,0.00078,88388,34.58790,255546
2898,rajib76,2,0.00078,88390,34.58868,255546
2899,rami3e,2,0.00078,88392,34.58947,255546
2900,raphaelTrench,2,0.00078,88394,34.59025,255546
2901,Ravenp87,2,0.00078,88396,34.59103,255546
2902,rayan-roy,2,0.00078,88398,34.59182,255546
2903,rayymlai,2,0.00078,88400,34.59260,255546
2904,rcillavicomtech,2,0.00078,88402,34.59338,255546
2905,rebeccamcfadden,2,0.00078,88404,34.59416,255546
2906,reed9999,2,0.00078,88406,34.59495,255546
2907,remyLarroye,2,0.00078,88408,34.59573,255546
2908,rexshang,2,0.00078,88410,34.59651,255546
2909,richardliaw,2,0.00078,88412,34.59729,255546
2910,ricpet,2,0.00078,88414,34.59808,255546
2911,ritabanchowdhury319,2,0.00078,88416,34.59886,255546
2912,robin5540,2,0.00078,88418,34.59964,255546
2913,robscc,2,0.00078,88420,34.60042,255546
2914,rochageorge,2,0.00078,88422,34.60121,255546
2915,RochanMehrotra,2,0.00078,88424,34.60199,255546
2916,rohitsroch,2,0.00078,88426,34.60277,255546
2917,RonsenbergVI,2,0.00078,88428,34.60355,255546
2918,RoterDL,2,0.00078,88430,34.60434,255546
2919,rs9899,2,0.00078,88432,34.60512,255546
2920,rtkshahwar,2,0.00078,88434,34.60590,255546
2921,Rubiel1,2,0.00078,88436,34.60669,255546
2922,rujual,2,0.00078,88438,34.60747,255546
2923,ruoyu90,2,0.00078,88440,34.60825,255546
2924,ryan-ally,2,0.00078,88442,34.60903,255546
2925,sachdevayash1910,2,0.00078,88444,34.60982,255546
2926,saemaromoon,2,0.00078,88446,34.61060,255546
2927,sagarshrestha24,2,0.00078,88448,34.61138,255546
2928,sahilprasad,2,0.00078,88450,34.61216,255546
2929,saintyun,2,0.00078,88452,34.61295,255546
2930,saisona,2,0.00078,88454,34.61373,255546
2931,sajid-moinuddin,2,0.00078,88456,34.61451,255546
2932,samuda2019,2,0.00078,88458,34.61529,255546
2933,sasi-patha,2,0.00078,88460,34.61608,255546
2934,sathishvj,2,0.00078,88462,34.61686,255546
2935,satish-dops94,2,0.00078,88464,34.61764,255546
2936,sav116,2,0.00078,88466,34.61842,255546
2937,sciai-ai,2,0.00078,88468,34.61921,255546
2938,sculd,2,0.00078,88470,34.61999,255546
2939,seekyiyi,2,0.00078,88472,34.62077,255546
2940,Sergiodiaz53-Dedalus,2,0.00078,88474,34.62156,255546
2941,sethjones,2,0.00078,88476,34.62234,255546
2942,sethjuarez,2,0.00078,88478,34.62312,255546
2943,sfc-gh-adlee,2,0.00078,88480,34.62390,255546
2944,ShahNewazKhan,2,0.00078,88482,34.62469,255546
2945,shankyz,2,0.00078,88484,34.62547,255546
2946,shayancanonical,2,0.00078,88486,34.62625,255546
2947,shivakumargowda12,2,0.00078,88488,34.62703,255546
2948,shreya-verma19,2,0.00078,88490,34.62782,255546
2949,shubamsharma,2,0.00078,88492,34.62860,255546
2950,shuiqiangchen,2,0.00078,88494,34.62938,255546
2951,shunkakinoki,2,0.00078,88496,34.63016,255546
2952,Sillians,2,0.00078,88498,34.63095,255546
2953,simdynamic,2,0.00078,88500,34.63173,255546
2954,sinban04,2,0.00078,88502,34.63251,255546
2955,sindhudeloitte,2,0.00078,88504,34.63329,255546
2956,SirBubbls,2,0.00078,88506,34.63408,255546
2957,sirkkalap,2,0.00078,88508,34.63486,255546
2958,siva2k16,2,0.00078,88510,34.63564,255546
2959,skliarpawlo,2,0.00078,88512,34.63643,255546
2960,Sliceco,2,0.00078,88514,34.63721,255546
2961,smalhot9464,2,0.00078,88516,34.63799,255546
2962,smandrell-ec,2,0.00078,88518,34.63877,255546
2963,smathalikunnel,2,0.00078,88520,34.63956,255546
2964,Smlight,2,0.00078,88522,34.64034,255546
2965,snekkalapudi,2,0.00078,88524,34.64112,255546
2966,Sobolvitya,2,0.00078,88526,34.64190,255546
2967,soogui,2,0.00078,88528,34.64269,255546
2968,sravi999,2,0.00078,88530,34.64347,255546
2969,SrinivasGuntupalli,2,0.00078,88532,34.64425,255546
2970,srmeier,2,0.00078,88534,34.64503,255546
2971,ssbagalkar,2,0.00078,88536,34.64582,255546
2972,sssyyw,2,0.00078,88538,34.64660,255546
2973,stalamoni,2,0.00078,88540,34.64738,255546
2974,stevemanavalan,2,0.00078,88542,34.64817,255546
2975,stevencasey,2,0.00078,88544,34.64895,255546
2976,stewartadam,2,0.00078,88546,34.64973,255546
2977,strump,2,0.00078,88548,34.65051,255546
2978,subrnath,2,0.00078,88550,34.65130,255546
2979,subsid,2,0.00078,88552,34.65208,255546
2980,suluner,2,0.00078,88554,34.65286,255546
2981,sumanassarmathg,2,0.00078,88556,34.65364,255546
2982,suminb,2,0.00078,88558,34.65443,255546
2983,Sundragon1993,2,0.00078,88560,34.65521,255546
2984,supernan1994,2,0.00078,88562,34.65599,255546
2985,surajphulara,2,0.00078,88564,34.65677,255546
2986,svnoesis,2,0.00078,88566,34.65756,255546
2987,svz77,2,0.00078,88568,34.65834,255546
2988,swarajoturkar,2,0.00078,88570,34.65912,255546
2989,swartz-k,2,0.00078,88572,34.65990,255546
2990,swikar1,2,0.00078,88574,34.66069,255546
2991,sxbfundi,2,0.00078,88576,34.66147,255546
2992,syd-quant,2,0.00078,88578,34.66225,255546
2993,taffarel-gaivota,2,0.00078,88580,34.66304,255546
2994,tahesse,2,0.00078,88582,34.66382,255546
2995,TahirHayat,2,0.00078,88584,34.66460,255546
2996,talk2jaydip,2,0.00078,88586,34.66538,255546
2997,TanjaDuPlessis,2,0.00078,88588,34.66617,255546
2998,tanken,2,0.00078,88590,34.66695,255546
2999,TarunJana,2,0.00078,88592,34.66773,255546
3000,tautrimas,2,0.00078,88594,34.66851,255546
3001,taylanates24,2,0.00078,88596,34.66930,255546
3002,tchaton,2,0.00078,88598,34.67008,255546
3003,TDehaene,2,0.00078,88600,34.67086,255546
3004,techjacker,2,0.00078,88602,34.67164,255546
3005,telpirion,2,0.00078,88604,34.67243,255546
3006,tereketeketitaka,2,0.00078,88606,34.67321,255546
3007,thameemk612,2,0.00078,88608,34.67399,255546
3008,thanhpt55,2,0.00078,88610,34.67477,255546
3009,theathibm,2,0.00078,88612,34.67556,255546
3010,TheDutchDevil,2,0.00078,88614,34.67634,255546
3011,themummy,2,0.00078,88616,34.67712,255546
3012,Tieriko,2,0.00078,88618,34.67791,255546
3013,tim5chneider,2,0.00078,88620,34.67869,255546
3014,timofal,2,0.00078,88622,34.67947,255546
3015,tingzhang-ming,2,0.00078,88624,34.68025,255546
3016,tinkerer,2,0.00078,88626,34.68104,255546
3017,tirkarthi,2,0.00078,88628,34.68182,255546
3018,tjmonsi,2,0.00078,88630,34.68260,255546
3019,TKorr,2,0.00078,88632,34.68338,255546
3020,tmerrittsmith,2,0.00078,88634,34.68417,255546
3021,tomaszstachera,2,0.00078,88636,34.68495,255546
3022,tom-dd,2,0.00078,88638,34.68573,255546
3023,TomVanWemmel,2,0.00078,88640,34.68651,255546
3024,tonykim-moloco,2,0.00078,88642,34.68730,255546
3025,tonywang-sh,2,0.00078,88644,34.68808,255546
3026,TonyZZhang,2,0.00078,88646,34.68886,255546
3027,trieuat,2,0.00078,88648,34.68964,255546
3028,TRINHHOANGANH,2,0.00078,88650,34.69043,255546
3029,trmbdevops,2,0.00078,88652,34.69121,255546
3030,tulsi0523,2,0.00078,88654,34.69199,255546
3031,Tutj,2,0.00078,88656,34.69278,255546
3032,tvkpz,2,0.00078,88658,34.69356,255546
3033,tvtv511,2,0.00078,88660,34.69434,255546
3034,UllasShanthakumar,2,0.00078,88662,34.69512,255546
3035,unagaraju88,2,0.00078,88664,34.69591,255546
3036,unix-way,2,0.00078,88666,34.69669,255546
3037,unnown,2,0.00078,88668,34.69747,255546
3038,urekalion,2,0.00078,88670,34.69825,255546
3039,vahidtz,2,0.00078,88672,34.69904,255546
3040,ValentinVerkhohliad,2,0.00078,88674,34.69982,255546
3041,vamshikrishna9505,2,0.00078,88676,34.70060,255546
3042,Vaskozl,2,0.00078,88678,34.70138,255546
3043,veiii,2,0.00078,88680,34.70217,255546
3044,victoriavilasb,2,0.00078,88682,34.70295,255546
3045,vietanhdev,2,0.00078,88684,34.70373,255546
3046,vigneshsolution,2,0.00078,88686,34.70452,255546
3047,vijayreddybo,2,0.00078,88688,34.70530,255546
3048,vikashg,2,0.00078,88690,34.70608,255546
3049,viktoriaas,2,0.00078,88692,34.70686,255546
3050,vimalkansal,2,0.00078,88694,34.70765,255546
3051,vishalsantv,2,0.00078,88696,34.70843,255546
3052,vitaly-om,2,0.00078,88698,34.70921,255546
3053,vivekjainmaiet,2,0.00078,88700,34.70999,255546
3054,vivekpd15,2,0.00078,88702,34.71078,255546
3055,vlordier,2,0.00078,88704,34.71156,255546
3056,v-loves-avocados,2,0.00078,88706,34.71234,255546
3057,vmarkovtsev,2,0.00078,88708,34.71312,255546
3058,vovawed,2,0.00078,88710,34.71391,255546
3059,vr140,2,0.00078,88712,34.71469,255546
3060,vulong3896,2,0.00078,88714,34.71547,255546
3061,waelCh,2,0.00078,88716,34.71625,255546
3062,WalidMustapha,2,0.00078,88718,34.71704,255546
3063,walkerjian,2,0.00078,88720,34.71782,255546
3064,wallwind,2,0.00078,88722,34.71860,255546
3065,walterhuangio,2,0.00078,88724,34.71939,255546
3066,wangjun1974,2,0.00078,88726,34.72017,255546
3067,wangli1426,2,0.00078,88728,34.72095,255546
3068,wangpengfei984597422,2,0.00078,88730,34.72173,255546
3069,wangzy0327,2,0.00078,88732,34.72252,255546
3070,Wesley-Miller,2,0.00078,88734,34.72330,255546
3071,wfangchi,2,0.00078,88736,34.72408,255546
3072,whigy,2,0.00078,88738,34.72486,255546
3073,whycircle,2,0.00078,88740,34.72565,255546
3074,wiktorof,2,0.00078,88742,34.72643,255546
3075,wildermuthn,2,0.00078,88744,34.72721,255546
3076,will-gerard,2,0.00078,88746,34.72799,255546
3077,williamyeh,2,0.00078,88748,34.72878,255546
3078,windkit,2,0.00078,88750,34.72956,255546
3079,wlongxiang,2,0.00078,88752,34.73034,255546
3080,wuchen03,2,0.00078,88754,34.73112,255546
3081,wujie1993,2,0.00078,88756,34.73191,255546
3082,wuyinzhenjun,2,0.00078,88758,34.73269,255546
3083,wxyzyu,2,0.00078,88760,34.73347,255546
3084,WyattGorman,2,0.00078,88762,34.73426,255546
3085,wybaron,2,0.00078,88764,34.73504,255546
3086,wzamazon,2,0.00078,88766,34.73582,255546
3087,wzhou18,2,0.00078,88768,34.73660,255546
3088,xiaopang1001,2,0.00078,88770,34.73739,255546
3089,xujingyissa,2,0.00078,88772,34.73817,255546
3090,yaboo-oyabu,2,0.00078,88774,34.73895,255546
3091,yadavvij,2,0.00078,88776,34.73973,255546
3092,yannhowe,2,0.00078,88778,34.74052,255546
3093,yanspirit,2,0.00078,88780,34.74130,255546
3094,yanwu2014,2,0.00078,88782,34.74208,255546
3095,yaobaiwei,2,0.00078,88784,34.74286,255546
3096,yaser-hameed,2,0.00078,88786,34.74365,255546
3097,yasersakkaf,2,0.00078,88788,34.74443,255546
3098,yingfeng,2,0.00078,88790,34.74521,255546
3099,yinghsienwu,2,0.00078,88792,34.74599,255546
3100,youngMan4,2,0.00078,88794,34.74678,255546
3101,yousefis,2,0.00078,88796,34.74756,255546
3102,YousefRabi,2,0.00078,88798,34.74834,255546
3103,youxingtian,2,0.00078,88800,34.74913,255546
3104,yshalabi,2,0.00078,88802,34.74991,255546
3105,yuezhilanyi,2,0.00078,88804,34.75069,255546
3106,Yu-Wang-Datatonic,2,0.00078,88806,34.75147,255546
3107,yuyue9284,2,0.00078,88808,34.75226,255546
3108,yves-altaml,2,0.00078,88810,34.75304,255546
3109,YY007H,2,0.00078,88812,34.75382,255546
3110,YYStreet,2,0.00078,88814,34.75460,255546
3111,yzhangswingman,2,0.00078,88816,34.75539,255546
3112,zclyne,2,0.00078,88818,34.75617,255546
3113,zeeros,2,0.00078,88820,34.75695,255546
3114,zehni,2,0.00078,88822,34.75773,255546
3115,zeldebro,2,0.00078,88824,34.75852,255546
3116,zemarx,2,0.00078,88826,34.75930,255546
3117,ZhangYuguo,2,0.00078,88828,34.76008,255546
3118,Zhiyuancheng,2,0.00078,88830,34.76086,255546
3119,zrlaida,2,0.00078,88832,34.76165,255546
3120,zyxcambridge,2,0.00078,88834,34.76243,255546
3121,zzvara,2,0.00078,88836,34.76321,255546
3122,1202zhyl,1,0.00039,88837,34.76360,255546
3123,12DReflections,1,0.00039,88838,34.76400,255546
3124,15379180,1,0.00039,88839,34.76439,255546
3125,1920853199,1,0.00039,88840,34.76478,255546
3126,360DigiTMG-Training,1,0.00039,88841,34.76517,255546
3127,3Xpl0it3r,1,0.00039,88842,34.76556,255546
3128,4j4y,1,0.00039,88843,34.76595,255546
3129,4vik,1,0.00039,88844,34.76634,255546
3130,535727234,1,0.00039,88845,34.76673,255546
3131,5HAD0W-P1R4T3,1,0.00039,88846,34.76713,255546
3132,626626cdllp,1,0.00039,88847,34.76752,255546
3133,636,1,0.00039,88848,34.76791,255546
3134,912988434,1,0.00039,88849,34.76830,255546
3135,916264367,1,0.00039,88850,34.76869,255546
3136,980956031,1,0.00039,88851,34.76908,255546
3137,a097253,1,0.00039,88852,34.76947,255546
3138,Aachunella,1,0.00039,88853,34.76987,255546
3139,aadityak33,1,0.00039,88854,34.77026,255546
3140,aaron-nall,1,0.00039,88855,34.77065,255546
3141,AaronUST,1,0.00039,88856,34.77104,255546
3142,aarthipa,1,0.00039,88857,34.77143,255546
3143,AbdallahAboelela,1,0.00039,88858,34.77182,255546
3144,abdulari,1,0.00039,88859,34.77221,255546
3145,abdullah-saal,1,0.00039,88860,34.77260,255546
3146,abhijeetchauhan,1,0.00039,88861,34.77300,255546
3147,abhijitk123,1,0.00039,88862,34.77339,255546
3148,abhishekchakladar-tc,1,0.00039,88863,34.77378,255546
3149,abhishek-tyagi87,1,0.00039,88864,34.77417,255546
3150,abhishekvermasg,1,0.00039,88865,34.77456,255546
3151,abieler,1,0.00039,88866,34.77495,255546
3152,abinthomasonline,1,0.00039,88867,34.77534,255546
3153,AboorvaDevarajan,1,0.00039,88868,34.77574,255546
3154,ACAVJW4H,1,0.00039,88869,34.77613,255546
3155,accraze,1,0.00039,88870,34.77652,255546
3156,achikars,1,0.00039,88871,34.77691,255546
3157,achoreim,1,0.00039,88872,34.77730,255546
3158,ACodingfreak,1,0.00039,88873,34.77769,255546
3159,adampilz,1,0.00039,88874,34.77808,255546
3160,adam-wasserman,1,0.00039,88875,34.77847,255546
3161,Adedolapo-Akin,1,0.00039,88876,34.77887,255546
3162,AdeshKhandait,1,0.00039,88877,34.77926,255546
3163,aditipatil0711,1,0.00039,88878,34.77965,255546
3164,adobemomo,1,0.00039,88879,34.78004,255546
3165,adollar,1,0.00039,88880,34.78043,255546
3166,adrianchia,1,0.00039,88881,34.78082,255546
3167,afk42,1,0.00039,88882,34.78121,255546
3168,ag2-debug,1,0.00039,88883,34.78160,255546
3169,aganesan94,1,0.00039,88884,34.78200,255546
3170,AGrzes,1,0.00039,88885,34.78239,255546
3171,ahmedelmahy,1,0.00039,88886,34.78278,255546
3172,Ahsansyed713,1,0.00039,88887,34.78317,255546
3173,aidangomez,1,0.00039,88888,34.78356,255546
3174,aii-shanker-jj,1,0.00039,88889,34.78395,255546
3175,aikow,1,0.00039,88890,34.78434,255546
3176,aimldl,1,0.00039,88891,34.78474,255546
3177,aishwary09,1,0.00039,88892,34.78513,255546
3178,aivanou,1,0.00039,88893,34.78552,255546
3179,ajaykamal3,1,0.00039,88894,34.78591,255546
3180,ajpotts,1,0.00039,88895,34.78630,255546
3181,akangst,1,0.00039,88896,34.78669,255546
3182,akbari-ali,1,0.00039,88897,34.78708,255546
3183,akhilvinvent,1,0.00039,88898,34.78747,255546
3184,akilman,1,0.00039,88899,34.78787,255546
3185,akkolwalkar,1,0.00039,88900,34.78826,255546
3186,Akmazad,1,0.00039,88901,34.78865,255546
3187,akonneker,1,0.00039,88902,34.78904,255546
3188,akramIOT,1,0.00039,88903,34.78943,255546
3189,Aksh97,1,0.00039,88904,34.78982,255546
3190,akshayc11,1,0.00039,88905,34.79021,255546
3191,akulkailwoo,1,0.00039,88906,34.79061,255546
3192,alangordon258,1,0.00039,88907,34.79100,255546
3193,AlanHau,1,0.00039,88908,34.79139,255546
3194,alasdairtran,1,0.00039,88909,34.79178,255546
3195,albertshx,1,0.00039,88910,34.79217,255546
3196,Alec-Zebrick,1,0.00039,88911,34.79256,255546
3197,AlendeGeraldo,1,0.00039,88912,34.79295,255546
3198,Alessthana,1,0.00039,88913,34.79334,255546
3199,alexanderDoria,1,0.00039,88914,34.79374,255546
3200,Alexander-Rogin,1,0.00039,88915,34.79413,255546
3201,AlexBulankou,1,0.00039,88916,34.79452,255546
3202,alexchenfeng,1,0.00039,88917,34.79491,255546
3203,alexchrisramos,1,0.00039,88918,34.79530,255546
3204,AlexLuya,1,0.00039,88919,34.79569,255546
3205,AlexZhangHF,1,0.00039,88920,34.79608,255546
3206,alexZsss,1,0.00039,88921,34.79647,255546
3207,alf-icc,1,0.00039,88922,34.79687,255546
3208,algermissen,1,0.00039,88923,34.79726,255546
3209,Ali771025,1,0.00039,88924,34.79765,255546
3210,aliasmee,1,0.00039,88925,34.79804,255546
3211,alikhurram42000,1,0.00039,88926,34.79843,255546
3212,alirezaahmadibeni,1,0.00039,88927,34.79882,255546
3213,alka-roy,1,0.00039,88928,34.79921,255546
3214,Altair3,1,0.00039,88929,34.79961,255546
3215,Alvin4550,1,0.00039,88930,34.80000,255546
3216,alvisememo,1,0.00039,88931,34.80039,255546
3217,AlwaysLearningMore,1,0.00039,88932,34.80078,255546
3218,Amaan5624,1,0.00039,88933,34.80117,255546
3219,amclay,1,0.00039,88934,34.80156,255546
3220,amercier-twt,1,0.00039,88935,34.80195,255546
3221,amigniox,1,0.00039,88936,34.80234,255546
3222,AmineHosni,1,0.00039,88937,34.80274,255546
3223,amitk75,1,0.00039,88938,34.80313,255546
3224,amitnjha,1,0.00039,88939,34.80352,255546
3225,amitza,1,0.00039,88940,34.80391,255546
3226,amorenocb,1,0.00039,88941,34.80430,255546
3227,a-m-thomas,1,0.00039,88942,34.80469,255546
3228,analyticalmonk,1,0.00039,88943,34.80508,255546
3229,AndersonML,1,0.00039,88944,34.80548,255546
3230,andjedani,1,0.00039,88945,34.80587,255546
3231,andodet,1,0.00039,88946,34.80626,255546
3232,andrejlukic,1,0.00039,88947,34.80665,255546
3233,Andreluizfc,1,0.00039,88948,34.80704,255546
3234,AndrewAlscher,1,0.00039,88949,34.80743,255546
3235,andrewcheny,1,0.00039,88950,34.80782,255546
3236,andrewisplinghoff,1,0.00039,88951,34.80821,255546
3237,andrewmorrison-sky,1,0.00039,88952,34.80861,255546
3238,andrewrreed,1,0.00039,88953,34.80900,255546
3239,andrew-veriga,1,0.00039,88954,34.80939,255546
3240,Andy546,1,0.00039,88955,34.80978,255546
3241,andytwigg,1,0.00039,88956,34.81017,255546
3242,andyz168,1,0.00039,88957,34.81056,255546
3243,aneeshc-c,1,0.00039,88958,34.81095,255546
3244,Anh-BK,1,0.00039,88959,34.81135,255546
3245,anil-pandey-mpf,1,0.00039,88960,34.81174,255546
3246,anirbanlahiri2017,1,0.00039,88961,34.81213,255546
3247,anirudhkm,1,0.00039,88962,34.81252,255546
3248,anitaokoh,1,0.00039,88963,34.81291,255546
3249,AnixPasBesoin,1,0.00039,88964,34.81330,255546
3250,AnkilP,1,0.00039,88965,34.81369,255546
3251,ankita4AI,1,0.00039,88966,34.81408,255546
3252,ankitaggarwal011,1,0.00039,88967,34.81448,255546
3253,ankitsingi,1,0.00039,88968,34.81487,255546
3254,Ankk98,1,0.00039,88969,34.81526,255546
3255,ankur6ue,1,0.00039,88970,34.81565,255546
3256,Anshuljh,1,0.00039,88971,34.81604,255546
3257,anskanwe,1,0.00039,88972,34.81643,255546
3258,Ans-pro,1,0.00039,88973,34.81682,255546
3259,answer3y,1,0.00039,88974,34.81721,255546
3260,anthonydillon,1,0.00039,88975,34.81761,255546
3261,antnsi,1,0.00039,88976,34.81800,255546
3262,anton-wundeman,1,0.00039,88977,34.81839,255546
3263,anupamag,1,0.00039,88978,34.81878,255546
3264,anyname2,1,0.00039,88979,34.81917,255546
3265,aoen,1,0.00039,88980,34.81956,255546
3266,aoliu95,1,0.00039,88981,34.81995,255546
3267,apeccaud,1,0.00039,88982,34.82035,255546
3268,ApoorvaSuresh-Audi,1,0.00039,88983,34.82074,255546
3269,A-Pot,1,0.00039,88984,34.82113,255546
3270,AppleHolic,1,0.00039,88985,34.82152,255546
3271,Aqdashashmii,1,0.00039,88986,34.82191,255546
3272,Aravinviju,1,0.00039,88987,34.82230,255546
3273,archanainapudi,1,0.00039,88988,34.82269,255546
3274,areiner-novetta,1,0.00039,88989,34.82308,255546
3275,arpitsharma-hexad,1,0.00039,88990,34.82348,255546
3276,arshsidana98,1,0.00039,88991,34.82387,255546
3277,arturnn,1,0.00039,88992,34.82426,255546
3278,ArunRamakani,1,0.00039,88993,34.82465,255546
3279,arviCV,1,0.00039,88994,34.82504,255546
3280,arya-oss,1,0.00039,88995,34.82543,255546
3281,As20075,1,0.00039,88996,34.82582,255546
3282,asaff1,1,0.00039,88997,34.82622,255546
3283,ashishbhatnagar02,1,0.00039,88998,34.82661,255546
3284,ashishML,1,0.00039,88999,34.82700,255546
3285,AshutoshDongare,1,0.00039,89000,34.82739,255546
3286,ashvinmoro,1,0.00039,89001,34.82778,255546
3287,Ashwin-Ramesh2607,1,0.00039,89002,34.82817,255546
3288,asiricml,1,0.00039,89003,34.82856,255546
3289,askaupup,1,0.00039,89004,34.82895,255546
3290,astanzys-vinted,1,0.00039,89005,34.82935,255546
3291,atch841,1,0.00039,89006,34.82974,255546
3292,atharva-18,1,0.00039,89007,34.83013,255546
3293,atrakriv,1,0.00039,89008,34.83052,255546
3294,Atreus-Technologies,1,0.00039,89009,34.83091,255546
3295,atsuik,1,0.00039,89010,34.83130,255546
3296,attackordie,1,0.00039,89011,34.83169,255546
3297,AtulKhomane,1,0.00039,89012,34.83209,255546
3298,atulyadavtech,1,0.00039,89013,34.83248,255546
3299,augustogb,1,0.00039,89014,34.83287,255546
3300,authenticfake,1,0.00039,89015,34.83326,255546
3301,avanish-chaubey,1,0.00039,89016,34.83365,255546
3302,averagua,1,0.00039,89017,34.83404,255546
3303,a-vinod,1,0.00039,89018,34.83443,255546
3304,avishniakov,1,0.00039,89019,34.83482,255546
3305,avizmil,1,0.00039,89020,34.83522,255546
3306,avloss,1,0.00039,89021,34.83561,255546
3307,AVShukshin,1,0.00039,89022,34.83600,255546
3308,awakia,1,0.00039,89023,34.83639,255546
3309,AxeZhan,1,0.00039,89024,34.83678,255546
3310,Axxxlllll,1,0.00039,89025,34.83717,255546
3311,ayoubelmimouni,1,0.00039,89026,34.83756,255546
3312,aytuns,1,0.00039,89027,34.83795,255546
3313,AzdinKab,1,0.00039,89028,34.83835,255546
3314,azelezni,1,0.00039,89029,34.83874,255546
3315,AzevedoB,1,0.00039,89030,34.83913,255546
3316,azuredevopsguy,1,0.00039,89031,34.83952,255546
3317,azurelysium,1,0.00039,89032,34.83991,255546
3318,b02202050,1,0.00039,89033,34.84030,255546
3319,babu-selector,1,0.00039,89034,34.84069,255546
3320,BabycolaYang,1,0.00039,89035,34.84109,255546
3321,backyes,1,0.00039,89036,34.84148,255546
3322,BACtaki,1,0.00039,89037,34.84187,255546
3323,BaisKasep012,1,0.00039,89038,34.84226,255546
3324,bandi900811,1,0.00039,89039,34.84265,255546
3325,bandurin-strike,1,0.00039,89040,34.84304,255546
3326,bansal01yash,1,0.00039,89041,34.84343,255546
3327,Basirkhanofficial34,1,0.00039,89042,34.84382,255546
3328,bassel-z,1,0.00039,89043,34.84422,255546
3329,bassplay3r,1,0.00039,89044,34.84461,255546
3330,basti-j,1,0.00039,89045,34.84500,255546
3331,batigooal,1,0.00039,89046,34.84539,255546
3332,bauagonzo,1,0.00039,89047,34.84578,255546
3333,baxteran,1,0.00039,89048,34.84617,255546
3334,bd12,1,0.00039,89049,34.84656,255546
3335,Bear1110,1,0.00039,89050,34.84696,255546
3336,bellship24,1,0.00039,89051,34.84735,255546
3337,beltelml,1,0.00039,89052,34.84774,255546
3338,benbouillet,1,0.00039,89053,34.84813,255546
3339,benhamner,1,0.00039,89054,34.84852,255546
3340,benhyy,1,0.00039,89055,34.84891,255546
3341,benlaor38,1,0.00039,89056,34.84930,255546
3342,benmathes,1,0.00039,89057,34.84969,255546
3343,berglh,1,0.00039,89058,34.85009,255546
3344,bgossey,1,0.00039,89059,34.85048,255546
3345,bharathkkb,1,0.00039,89060,34.85087,255546
3346,bigdatamlai,1,0.00039,89061,34.85126,255546
3347,bigdimple,1,0.00039,89062,34.85165,255546
3348,bitcqs,1,0.00039,89063,34.85204,255546
3349,bix709,1,0.00039,89064,34.85243,255546
3350,bjones325,1,0.00039,89065,34.85282,255546
3351,blaisethom,1,0.00039,89066,34.85322,255546
3352,blancsw,1,0.00039,89067,34.85361,255546
3353,blazickjoe,1,0.00039,89068,34.85400,255546
3354,bligching512,1,0.00039,89069,34.85439,255546
3355,bmccord2,1,0.00039,89070,34.85478,255546
3356,bmorphism,1,0.00039,89071,34.85517,255546
3357,bmv3cg,1,0.00039,89072,34.85556,255546
3358,boczekbartek,1,0.00039,89073,34.85596,255546
3359,boersmamarcel,1,0.00039,89074,34.85635,255546
3360,BoHuang2018,1,0.00039,89075,34.85674,255546
3361,Boimkimi,1,0.00039,89076,34.85713,255546
3362,BonavincciAI2020,1,0.00039,89077,34.85752,255546
3363,Borda,1,0.00039,89078,34.85791,255546
3364,boriskovalev,1,0.00039,89079,34.85830,255546
3365,botasb,1,0.00039,89080,34.85869,255546
3366,botingw,1,0.00039,89081,34.85909,255546
3367,bottumjosh,1,0.00039,89082,34.85948,255546
3368,boufleur,1,0.00039,89083,34.85987,255546
3369,bpoti,1,0.00039,89084,34.86026,255546
3370,BrandonLiang,1,0.00039,89085,34.86065,255546
3371,brendangadd,1,0.00039,89086,34.86104,255546
3372,briandrutledge,1,0.00039,89087,34.86143,255546
3373,brightlee6,1,0.00039,89088,34.86183,255546
3374,brilhana,1,0.00039,89089,34.86222,255546
3375,brt-timseries,1,0.00039,89090,34.86261,255546
3376,bruceche11,1,0.00039,89091,34.86300,255546
3377,bruceding,1,0.00039,89092,34.86339,255546
3378,BrunoChauvet,1,0.00039,89093,34.86378,255546
3379,bryant-rh,1,0.00039,89094,34.86417,255546
3380,bsingarayan,1,0.00039,89095,34.86456,255546
3381,Bud-ds,1,0.00039,89096,34.86496,255546
3382,buildlackey,1,0.00039,89097,34.86535,255546
3383,bumberboy,1,0.00039,89098,34.86574,255546
3384,burtenshaw,1,0.00039,89099,34.86613,255546
3385,bybatkhuu,1,0.00039,89100,34.86652,255546
3386,caijimin,1,0.00039,89101,34.86691,255546
3387,calvin11ung,1,0.00039,89102,34.86730,255546
3388,calvin-is-seksy,1,0.00039,89103,34.86770,255546
3389,carlose2108,1,0.00039,89104,34.86809,255546
3390,carloVentrella,1,0.00039,89105,34.86848,255546
3391,caseware66,1,0.00039,89106,34.86887,255546
3392,casperyap,1,0.00039,89107,34.86926,255546
3393,Cass0n,1,0.00039,89108,34.86965,255546
3394,cateto,1,0.00039,89109,34.87004,255546
3395,cbbba18,1,0.00039,89110,34.87043,255546
3396,cbchouinard,1,0.00039,89111,34.87083,255546
3397,ccastro-pedro,1,0.00039,89112,34.87122,255546
3398,ccdefreitas,1,0.00039,89113,34.87161,255546
3399,cenkbircanoglu,1,0.00039,89114,34.87200,255546
3400,cestum,1,0.00039,89115,34.87239,255546
3401,cf-chiang,1,0.00039,89116,34.87278,255546
3402,cfloressuazo,1,0.00039,89117,34.87317,255546
3403,cgawron1,1,0.00039,89118,34.87356,255546
3404,chadg818,1,0.00039,89119,34.87396,255546
3405,chajath,1,0.00039,89120,34.87435,255546
3406,championjared,1,0.00039,89121,34.87474,255546
3407,chandukotagiri1992,1,0.00039,89122,34.87513,255546
3408,chandurreddy91,1,0.00039,89123,34.87552,255546
3409,changchuming,1,0.00039,89124,34.87591,255546
3410,changhoekim,1,0.00039,89125,34.87630,255546
3411,changqing,1,0.00039,89126,34.87670,255546
3412,chanhz,1,0.00039,89127,34.87709,255546
3413,charlesccychen,1,0.00039,89128,34.87748,255546
3414,charlieyang1557,1,0.00039,89129,34.87787,255546
3415,chboudry,1,0.00039,89130,34.87826,255546
3416,cheesev,1,0.00039,89131,34.87865,255546
3417,chelomontilla,1,0.00039,89132,34.87904,255546
3418,chengleqi,1,0.00039,89133,34.87943,255546
3419,chengsky-NTU,1,0.00039,89134,34.87983,255546
3420,chenjr0719,1,0.00039,89135,34.88022,255546
3421,chenwenyan,1,0.00039,89136,34.88061,255546
3422,cheny-alf,1,0.00039,89137,34.88100,255546
3423,chenyuzhi459,1,0.00039,89138,34.88139,255546
3424,chepkoyallan,1,0.00039,89139,34.88178,255546
3425,cheungringo,1,0.00039,89140,34.88217,255546
3426,chinaboy007,1,0.00039,89141,34.88257,255546
3427,chitravsnair,1,0.00039,89142,34.88296,255546
3428,chmielas,1,0.00039,89143,34.88335,255546
3429,chongkong,1,0.00039,89144,34.88374,255546
3430,chongwangcc,1,0.00039,89145,34.88413,255546
3431,chrisalbon,1,0.00039,89146,34.88452,255546
3432,chrishmorris,1,0.00039,89147,34.88491,255546
3433,chrisrana,1,0.00039,89148,34.88530,255546
3434,Christian-Jansen,1,0.00039,89149,34.88570,255546
3435,Christina-Young,1,0.00039,89150,34.88609,255546
3436,chris-zen,1,0.00039,89151,34.88648,255546
3437,chunfengzhao1,1,0.00039,89152,34.88687,255546
3438,chunjieChang,1,0.00039,89153,34.88726,255546
3439,ciderkim,1,0.00039,89154,34.88765,255546
3440,Ciro-Taranto,1,0.00039,89155,34.88804,255546
3441,ciscoai-prowbot,1,0.00039,89156,34.88843,255546
3442,cjjain813,1,0.00039,89157,34.88883,255546
3443,closerforever,1,0.00039,89158,34.88922,255546
3444,cmhkjuwan,1,0.00039,89159,34.88961,255546
3445,cnegron-nv,1,0.00039,89160,34.89000,255546
3446,coalindiax,1,0.00039,89161,34.89039,255546
3447,codebeard1,1,0.00039,89162,34.89078,255546
3448,codebreach,1,0.00039,89163,34.89117,255546
3449,CodeLingoTeam,1,0.00039,89164,34.89157,255546
3450,coldtomatojuice,1,0.00039,89165,34.89196,255546
3451,colinfindlay-nz,1,0.00039,89166,34.89235,255546
3452,Collinbrown95,1,0.00039,89167,34.89274,255546
3453,colmantse,1,0.00039,89168,34.89313,255546
3454,ColmBhandal,1,0.00039,89169,34.89352,255546
3455,conchitagoogle,1,0.00039,89170,34.89391,255546
3456,connor-swanson,1,0.00039,89171,34.89430,255546
3457,cottrell,1,0.00039,89172,34.89470,255546
3458,cpcgoogle,1,0.00039,89173,34.89509,255546
3459,Cplo,1,0.00039,89174,34.89548,255546
3460,cquptEthan,1,0.00039,89175,34.89587,255546
3461,CR1SceNT,1,0.00039,89176,34.89626,255546
3462,craigjmidwinter,1,0.00039,89177,34.89665,255546
3463,creddy123,1,0.00039,89178,34.89704,255546
3464,cromagnonninja,1,0.00039,89179,34.89744,255546
3465,crsawyer314,1,0.00039,89180,34.89783,255546
3466,CSberger,1,0.00039,89181,34.89822,255546
3467,cschieberle,1,0.00039,89182,34.89861,255546
3468,cslovell,1,0.00039,89183,34.89900,255546
3469,CSP197,1,0.00039,89184,34.89939,255546
3470,cutiechi,1,0.00039,89185,34.89978,255546
3471,cutlass90,1,0.00039,89186,34.90017,255546
3472,cwu24,1,0.00039,89187,34.90057,255546
3473,cy89,1,0.00039,89188,34.90096,255546
3474,CybervisionVolodymyrPogorelov,1,0.00039,89189,34.90135,255546
3475,cyliu0204,1,0.00039,89190,34.90174,255546
3476,cymarechal-devoteam,1,0.00039,89191,34.90213,255546
3477,cyniczhi,1,0.00039,89192,34.90252,255546
3478,cyprnose,1,0.00039,89193,34.90291,255546
3479,cyrano5614,1,0.00039,89194,34.90331,255546
3480,czz2018,1,0.00039,89195,34.90370,255546
3481,daanyalmalik,1,0.00039,89196,34.90409,255546
3482,daenuprobst,1,0.00039,89197,34.90448,255546
3483,daftping,1,0.00039,89198,34.90487,255546
3484,dagilgon,1,0.00039,89199,34.90526,255546
3485,dailong,1,0.00039,89200,34.90565,255546
3486,DaleSin,1,0.00039,89201,34.90604,255546
3487,dalvarezsmiet,1,0.00039,89202,34.90644,255546
3488,damien75,1,0.00039,89203,34.90683,255546
3489,damngamerz,1,0.00039,89204,34.90722,255546
3490,danasaur,1,0.00039,89205,34.90761,255546
3491,daniel985,1,0.00039,89206,34.90800,255546
3492,daniel-bejarano,1,0.00039,89207,34.90839,255546
3493,danielbraun89,1,0.00039,89208,34.90878,255546
3494,danielecordano,1,0.00039,89209,34.90917,255546
3495,danielmhair,1,0.00039,89210,34.90957,255546
3496,DanielSCon40,1,0.00039,89211,34.90996,255546
3497,danrzs,1,0.00039,89212,34.91035,255546
3498,danvaida,1,0.00039,89213,34.91074,255546
3499,darack1234,1,0.00039,89214,34.91113,255546
3500,darthkabelo,1,0.00039,89215,34.91152,255546
3501,datafuel,1,0.00039,89216,34.91191,255546
3502,data-infra,1,0.00039,89217,34.91231,255546
3503,datasciencedani,1,0.00039,89218,34.91270,255546
3504,davidawad,1,0.00039,89219,34.91309,255546
3505,davidbellemare,1,0.00039,89220,34.91348,255546
3506,David-Bess,1,0.00039,89221,34.91387,255546
3507,David-LiCause,1,0.00039,89222,34.91426,255546
3508,davidparks21,1,0.00039,89223,34.91465,255546
3509,dbuades,1,0.00039,89224,34.91504,255546
3510,debmalya4,1,0.00039,89225,34.91544,255546
3511,deeco,1,0.00039,89226,34.91583,255546
3512,deepakpate07,1,0.00039,89227,34.91622,255546
3513,DeepFlame-JR,1,0.00039,89228,34.91661,255546
3514,deepika-cpml,1,0.00039,89229,34.91700,255546
3515,DeepTalk19,1,0.00039,89230,34.91739,255546
3516,deinal,1,0.00039,89231,34.91778,255546
3517,dellelce,1,0.00039,89232,34.91818,255546
3518,denfromufa,1,0.00039,89233,34.91857,255546
3519,dengpanyin,1,0.00039,89234,34.91896,255546
3520,denispeyrusaubes,1,0.00039,89235,34.91935,255546
3521,denisvorotyntsevunity,1,0.00039,89236,34.91974,255546
3522,dennisTGC,1,0.00039,89237,34.92013,255546
3523,derenrich,1,0.00039,89238,34.92052,255546
3524,Deseram,1,0.00039,89239,34.92091,255546
3525,devilmetal,1,0.00039,89240,34.92131,255546
3526,devlp121,1,0.00039,89241,34.92170,255546
3527,devrivne,1,0.00039,89242,34.92209,255546
3528,dfeldell,1,0.00039,89243,34.92248,255546
3529,dfisk,1,0.00039,89244,34.92287,255546
3530,dg424,1,0.00039,89245,34.92326,255546
3531,dgrahn,1,0.00039,89246,34.92365,255546
3532,DhanunjayElluri,1,0.00039,89247,34.92404,255546
3533,dhfromkorea,1,0.00039,89248,34.92444,255546
3534,dhirschfeld,1,0.00039,89249,34.92483,255546
3535,dholmesreed,1,0.00039,89250,34.92522,255546
3536,dhruvilmehta,1,0.00039,89251,34.92561,255546
3537,dhruvpratapsingh,1,0.00039,89252,34.92600,255546
3538,Dhull442,1,0.00039,89253,34.92639,255546
3539,dianeo-mit,1,0.00039,89254,34.92678,255546
3540,Dibel,1,0.00039,89255,34.92718,255546
3541,diegolovison,1,0.00039,89256,34.92757,255546
3542,dirtyValera,1,0.00039,89257,34.92796,255546
3543,dithyrambe,1,0.00039,89258,34.92835,255546
3544,divjyotsinghanzx,1,0.00039,89259,34.92874,255546
3545,divyank000,1,0.00039,89260,34.92913,255546
3546,divyaprabha123,1,0.00039,89261,34.92952,255546
3547,divya-r-kamat,1,0.00039,89262,34.92991,255546
3548,Djmcflush,1,0.00039,89263,34.93031,255546
3549,djmcgreal,1,0.00039,89264,34.93070,255546
3550,djmcgreal-cc,1,0.00039,89265,34.93109,255546
3551,dkmiller,1,0.00039,89266,34.93148,255546
3552,dkowsley,1,0.00039,89267,34.93187,255546
3553,dlkaai,1,0.00039,89268,34.93226,255546
3554,dmerz75,1,0.00039,89269,34.93265,255546
3555,dmonson,1,0.00039,89270,34.93305,255546
3556,dmytro212,1,0.00039,89271,34.93344,255546
3557,dobrinsky,1,0.00039,89272,34.93383,255546
3558,dojoeisuke,1,0.00039,89273,34.93422,255546
3559,DomenicoCostantino,1,0.00039,89274,34.93461,255546
3560,dommgifer,1,0.00039,89275,34.93500,255546
3561,dongzaimatou,1,0.00039,89276,34.93539,255546
3562,donnyv12,1,0.00039,89277,34.93578,255546
3563,dontmint,1,0.00039,89278,34.93618,255546
3564,DontWorry33,1,0.00039,89279,34.93657,255546
3565,dotnetpiper,1,0.00039,89280,34.93696,255546
3566,dping1,1,0.00039,89281,34.93735,255546
3567,dragonofac,1,0.00039,89282,34.93774,255546
3568,dragonsongohan,1,0.00039,89283,34.93813,255546
3569,drsagitn,1,0.00039,89284,34.93852,255546
3570,drzl386,1,0.00039,89285,34.93892,255546
3571,dss77,1,0.00039,89286,34.93931,255546
3572,dt21e8,1,0.00039,89287,34.93970,255546
3573,dublincrow2020,1,0.00039,89288,34.94009,255546
3574,ducminhnguyen,1,0.00039,89289,34.94048,255546
3575,dumbjarvis,1,0.00039,89290,34.94087,255546
3576,Duske,1,0.00039,89291,34.94126,255546
3577,dvgopal,1,0.00039,89292,34.94165,255546
3578,dwhdai,1,0.00039,89293,34.94205,255546
3579,dwojcik92,1,0.00039,89294,34.94244,255546
3580,dwu926,1,0.00039,89295,34.94283,255546
3581,EALAAKH,1,0.00039,89296,34.94322,255546
3582,easadler,1,0.00039,89297,34.94361,255546
3583,easkerov,1,0.00039,89298,34.94400,255546
3584,echorocket,1,0.00039,89299,34.94439,255546
3585,edacostacambioupgrade,1,0.00039,89300,34.94478,255546
3586,edday1,1,0.00039,89301,34.94518,255546
3587,eddynelson,1,0.00039,89302,34.94557,255546
3588,edikmkoyan,1,0.00039,89303,34.94596,255546
3589,edmeister,1,0.00039,89304,34.94635,255546
3590,eduardchai,1,0.00039,89305,34.94674,255546
3591,EduardFazliev,1,0.00039,89306,34.94713,255546
3592,eduardovelludo,1,0.00039,89307,34.94752,255546
3593,edusporto,1,0.00039,89308,34.94792,255546
3594,edwardfung123,1,0.00039,89309,34.94831,255546
3595,edwardhuanghz,1,0.00039,89310,34.94870,255546
3596,edwardspc,1,0.00039,89311,34.94909,255546
3597,egkiastas,1,0.00039,89312,34.94948,255546
3598,ehudyonasi,1,0.00039,89313,34.94987,255546
3599,elamaran11,1,0.00039,89314,34.95026,255546
3600,elanv,1,0.00039,89315,34.95065,255546
3601,elegendre3,1,0.00039,89316,34.95105,255546
3602,ElijahMingLiu,1,0.00039,89317,34.95144,255546
3603,elilienstein,1,0.00039,89318,34.95183,255546
3604,elizgarcia5,1,0.00039,89319,34.95222,255546
3605,elsud,1,0.00039,89320,34.95261,255546
3606,elvinzhusiyu,1,0.00039,89321,34.95300,255546
3607,Ema93sh,1,0.00039,89322,34.95339,255546
3608,EMCP,1,0.00039,89323,34.95379,255546
3609,emilecaron,1,0.00039,89324,34.95418,255546
3610,emilyyujieli,1,0.00039,89325,34.95457,255546
3611,em-pe,1,0.00039,89326,34.95496,255546
3612,EnasBasset,1,0.00039,89327,34.95535,255546
3613,endurancetest20380119,1,0.00039,89328,34.95574,255546
3614,engineeryashsaxena,1,0.00039,89329,34.95613,255546
3615,entrpn,1,0.00039,89330,34.95652,255546
3616,erik78se,1,0.00039,89331,34.95692,255546
3617,eriklincoln,1,0.00039,89332,34.95731,255546
3618,Erikzzz,1,0.00039,89333,34.95770,255546
3619,Erin-Servian,1,0.00039,89334,34.95809,255546
3620,esantix,1,0.00039,89335,34.95848,255546
3621,eslerm,1,0.00039,89336,34.95887,255546
3622,estelleaf,1,0.00039,89337,34.95926,255546
3623,estrellafelipe,1,0.00039,89338,34.95966,255546
3624,ethanscho,1,0.00039,89339,34.96005,255546
3625,ethanyanjiali,1,0.00039,89340,34.96044,255546
3626,eugenebnd,1,0.00039,89341,34.96083,255546
3627,eumentis-pawan,1,0.00039,89342,34.96122,255546
3628,eunjilee,1,0.00039,89343,34.96161,255546
3629,evan9637,1,0.00039,89344,34.96200,255546
3630,evandekieft,1,0.00039,89345,34.96239,255546
3631,ever1022,1,0.00039,89346,34.96279,255546
3632,everettvody,1,0.00039,89347,34.96318,255546
3633,ewasserman,1,0.00039,89348,34.96357,255546
3634,Excelight,1,0.00039,89349,34.96396,255546
3635,F36,1,0.00039,89350,34.96435,255546
3636,fafa92,1,0.00039,89351,34.96474,255546
3637,fahdrazavi,1,0.00039,89352,34.96513,255546
3638,fajaryanw,1,0.00039,89353,34.96552,255546
3639,Fan-SJ,1,0.00039,89354,34.96592,255546
3640,fanzhe328,1,0.00039,89355,34.96631,255546
3641,FarshadMovahed-REISys,1,0.00039,89356,34.96670,255546
3642,FatalLin,1,0.00039,89357,34.96709,255546
3643,fatihkorhan,1,0.00039,89358,34.96748,255546
3644,fatkun,1,0.00039,89359,34.96787,255546
3645,fbraza,1,0.00039,89360,34.96826,255546
3646,fedeesku,1,0.00039,89361,34.96866,255546
3647,felix-exel,1,0.00039,89362,34.96905,255546
3648,FelixGruener,1,0.00039,89363,34.96944,255546
3649,FellowNico,1,0.00039,89364,34.96983,255546
3650,fenghejingchi,1,0.00039,89365,34.97022,255546
3651,fengpinghu,1,0.00039,89366,34.97061,255546
3652,ferenc-hechler,1,0.00039,89367,34.97100,255546
3653,fhirschmann,1,0.00039,89368,34.97139,255546
3654,filipe-cantarelli,1,0.00039,89369,34.97179,255546
3655,finallyRaunak,1,0.00039,89370,34.97218,255546
3656,fireproofsocks,1,0.00039,89371,34.97257,255546
3657,FishJoey,1,0.00039,89372,34.97296,255546
3658,flacombe,1,0.00039,89373,34.97335,255546
3659,fojtami1,1,0.00039,89374,34.97374,255546
3660,fooozhe,1,0.00039,89375,34.97413,255546
3661,francisfuzz,1,0.00039,89376,34.97453,255546
3662,francoisserra,1,0.00039,89377,34.97492,255546
3663,FranCorsini,1,0.00039,89378,34.97531,255546
3664,Franky12,1,0.00039,89379,34.97570,255546
3665,frederikfab,1,0.00039,89380,34.97609,255546
3666,Freezaa9,1,0.00039,89381,34.97648,255546
3667,fryzhykau,1,0.00039,89382,34.97687,255546
3668,FullDataAlchemist,1,0.00039,89383,34.97726,255546
3669,fullprocess,1,0.00039,89384,34.97766,255546
3670,futeng,1,0.00039,89385,34.97805,255546
3671,futurexskill,1,0.00039,89386,34.97844,255546
3672,Fvegini,1,0.00039,89387,34.97883,255546
3673,fzhurd,1,0.00039,89388,34.97922,255546
3674,gabrielgcbs,1,0.00039,89389,34.97961,255546
3675,gabriellemadden,1,0.00039,89390,34.98000,255546
3676,gabrielmbmb,1,0.00039,89391,34.98039,255546
3677,Gajendran27,1,0.00039,89392,34.98079,255546
3678,galebm1004,1,0.00039,89393,34.98118,255546
3679,GaneshHulyal,1,0.00039,89394,34.98157,255546
3680,GarethLewin,1,0.00039,89395,34.98196,255546
3681,gauravpawar13,1,0.00039,89396,34.98235,255546
3682,GayatriNair229,1,0.00039,89397,34.98274,255546
3683,gbark13,1,0.00039,89398,34.98313,255546
3684,GDegrove,1,0.00039,89399,34.98353,255546
3685,geier,1,0.00039,89400,34.98392,255546
3686,Gekho457,1,0.00039,89401,34.98431,255546
3687,geooff,1,0.00039,89402,34.98470,255546
3688,GeorgeGeng,1,0.00039,89403,34.98509,255546
3689,get2prab,1,0.00039,89404,34.98548,255546
3690,GezimSejdiu,1,0.00039,89405,34.98587,255546
3691,GG-yuki,1,0.00039,89406,34.98626,255546
3692,giladwa1,1,0.00039,89407,34.98666,255546
3693,GilGonong,1,0.00039,89408,34.98705,255546
3694,githubwua,1,0.00039,89409,34.98744,255546
3695,GiuliaMassimetti,1,0.00039,89410,34.98783,255546
3696,glotzerhotze,1,0.00039,89411,34.98822,255546
3697,gmatev,1,0.00039,89412,34.98861,255546
3698,gmjonker,1,0.00039,89413,34.98900,255546
3699,gniewus,1,0.00039,89414,34.98940,255546
3700,gnsantos,1,0.00039,89415,34.98979,255546
3701,goanto,1,0.00039,89416,34.99018,255546
3702,gokhancetinkaya,1,0.00039,89417,34.99057,255546
3703,goldenberg,1,0.00039,89418,34.99096,255546
3704,goloxxly,1,0.00039,89419,34.99135,255546
3705,gooddayforever,1,0.00039,89420,34.99174,255546
3706,gorinars,1,0.00039,89421,34.99213,255546
3707,gpfvic,1,0.00039,89422,34.99253,255546
3708,gpoulin-hopper,1,0.00039,89423,34.99292,255546
3709,greg-liner,1,0.00039,89424,34.99331,255546
3710,gringParis,1,0.00039,89425,34.99370,255546
3711,grmoktan,1,0.00039,89426,34.99409,255546
3712,Gross613,1,0.00039,89427,34.99448,255546
3713,gs-sam,1,0.00039,89428,34.99487,255546
3714,gstoner,1,0.00039,89429,34.99527,255546
3715,gtoullier,1,0.00039,89430,34.99566,255546
3716,guanghui0607,1,0.00039,89431,34.99605,255546
3717,guo897654050,1,0.00039,89432,34.99644,255546
3718,gyant,1,0.00039,89433,34.99683,255546
3719,gymaganis,1,0.00039,89434,34.99722,255546
3720,h4gen,1,0.00039,89435,34.99761,255546
3721,habmat,1,0.00039,89436,34.99800,255546
3722,hacktmz,1,0.00039,89437,34.99840,255546
3723,hade94,1,0.00039,89438,34.99879,255546
3724,haifeng-jin,1,0.00039,89439,34.99918,255546
3725,haim-co-moonactive,1,0.00039,89440,34.99957,255546
3726,hakimliang,1,0.00039,89441,34.99996,255546
3727,halegreen,1,0.00039,89442,35.00035,255546
3728,HaloKim,1,0.00039,89443,35.00074,255546
3729,Hamidmsa,1,0.00039,89444,35.00113,255546
3730,hamko,1,0.00039,89445,35.00153,255546
3731,hanakawamomo,1,0.00039,89446,35.00192,255546
3732,hancelpv,1,0.00039,89447,35.00231,255546
3733,hank6086,1,0.00039,89448,35.00270,255546
3734,haohao667788,1,0.00039,89449,35.00309,255546
3735,HaoWangDL,1,0.00039,89450,35.00348,255546
3736,HarborZeng,1,0.00039,89451,35.00387,255546
3737,harchali,1,0.00039,89452,35.00427,255546
3738,haresh-chudgar,1,0.00039,89453,35.00466,255546
3739,HarryCaveMan,1,0.00039,89454,35.00505,255546
3740,harryliu123,1,0.00039,89455,35.00544,255546
3741,harshalkwagh,1,0.00039,89456,35.00583,255546
3742,harshalmittal4,1,0.00039,89457,35.00622,255546
3743,HassaanAkbar,1,0.00039,89458,35.00661,255546
3744,hassanzia32,1,0.00039,89459,35.00700,255546
3745,hayato-maki,1,0.00039,89460,35.00740,255546
3746,Hayyk,1,0.00039,89461,35.00779,255546
3747,hbarrington,1,0.00039,89462,35.00818,255546
3748,Hedingber,1,0.00039,89463,35.00857,255546
3749,hejiahuan1412,1,0.00039,89464,35.00896,255546
3750,HelenCousins,1,0.00039,89465,35.00935,255546
3751,helkhalfi,1,0.00039,89466,35.00974,255546
3752,Hellekin87,1,0.00039,89467,35.01014,255546
3753,helloxjade,1,0.00039,89468,35.01053,255546
3754,heqinw,1,0.00039,89469,35.01092,255546
3755,hexerei,1,0.00039,89470,35.01131,255546
3756,heyawhite,1,0.00039,89471,35.01170,255546
3757,hfurkanvural,1,0.00039,89472,35.01209,255546
3758,hhhyunwoo,1,0.00039,89473,35.01248,255546
3759,hienqnguyen,1,0.00039,89474,35.01287,255546
3760,HilbertSpecs,1,0.00039,89475,35.01327,255546
3761,himanshu238,1,0.00039,89476,35.01366,255546
3762,Hirosora,1,0.00039,89477,35.01405,255546
3763,hjyoite,1,0.00039,89478,35.01444,255546
3764,hlld3344,1,0.00039,89479,35.01483,255546
3765,hmdsatoshi,1,0.00039,89480,35.01522,255546
3766,hnakagawa,1,0.00039,89481,35.01561,255546
3767,hollyhutson,1,0.00039,89482,35.01600,255546
3768,hongzhao-signifyd,1,0.00039,89483,35.01640,255546
3769,horatiu-negutoiu,1,0.00039,89484,35.01679,255546
3770,Houyon,1,0.00039,89485,35.01718,255546
3771,hpspringboy,1,0.00039,89486,35.01757,255546
3772,Hrishkesh,1,0.00039,89487,35.01796,255546
3773,huangjiasingle,1,0.00039,89488,35.01835,255546
3774,hubchub,1,0.00039,89489,35.01874,255546
3775,hubertg1122,1,0.00039,89490,35.01914,255546
3776,hubrix,1,0.00039,89491,35.01953,255546
3777,hughmiao,1,0.00039,89492,35.01992,255546
3778,hugovk,1,0.00039,89493,35.02031,255546
3779,huihuang2015,1,0.00039,89494,35.02070,255546
3780,humantargetjoe,1,0.00039,89495,35.02109,255546
3781,hungrysushi,1,0.00039,89496,35.02148,255546
3782,hydeta,1,0.00039,89497,35.02187,255546
3783,hylick,1,0.00039,89498,35.02227,255546
3784,hyoseon-agile,1,0.00039,89499,35.02266,255546
3785,hzy001,1,0.00039,89500,35.02305,255546
3786,iant04128591,1,0.00039,89501,35.02344,255546
3787,ianycxu,1,0.00039,89502,35.02383,255546
3788,iassenegal221,1,0.00039,89503,35.02422,255546
3789,ibnummuhammad,1,0.00039,89504,35.02461,255546
3790,ICDS-Offering,1,0.00039,89505,35.02501,255546
3791,ichbinjakes,1,0.00039,89506,35.02540,255546
3792,ido-trumer,1,0.00039,89507,35.02579,255546
3793,ifs-imaddjelaili,1,0.00039,89508,35.02618,255546
3794,igmik,1,0.00039,89509,35.02657,255546
3795,igorvalko,1,0.00039,89510,35.02696,255546
3796,IgorZan,1,0.00039,89511,35.02735,255546
3797,ilaria-speranza,1,0.00039,89512,35.02774,255546
3798,ilkelma,1,0.00039,89513,35.02814,255546
3799,ILLUM1N0X,1,0.00039,89514,35.02853,255546
3800,ilyinon,1,0.00039,89515,35.02892,255546
3801,imamika,1,0.00039,89516,35.02931,255546
3802,imantha-a,1,0.00039,89517,35.02970,255546
3803,imilos,1,0.00039,89518,35.03009,255546
3804,imnotaqtpie,1,0.00039,89519,35.03048,255546
3805,impravin22,1,0.00039,89520,35.03088,255546
3806,imrehg,1,0.00039,89521,35.03127,255546
3807,imsazzad,1,0.00039,89522,35.03166,255546
3808,Imsurajkr,1,0.00039,89523,35.03205,255546
3809,InsertCoolNameHere,1,0.00039,89524,35.03244,255546
3810,inspurasc,1,0.00039,89525,35.03283,255546
3811,ipal0,1,0.00039,89526,35.03322,255546
3812,is185089,1,0.00039,89527,35.03361,255546
3813,Isaacwhyuenac,1,0.00039,89528,35.03401,255546
3814,itmwiw,1,0.00039,89529,35.03440,255546
3815,itshevtsov,1,0.00039,89530,35.03479,255546
3816,itsymbol,1,0.00039,89531,35.03518,255546
3817,IvySong2016,1,0.00039,89532,35.03557,255546
3818,izhaomeng,1,0.00039,89533,35.03596,255546
3819,j0hnL,1,0.00039,89534,35.03635,255546
3820,jackhawa,1,0.00039,89535,35.03674,255546
3821,jackielyc,1,0.00039,89536,35.03714,255546
3822,jackychow,1,0.00039,89537,35.03753,255546
3823,jackyin68,1,0.00039,89538,35.03792,255546
3824,jacquev6,1,0.00039,89539,35.03831,255546
3825,jaejuning,1,0.00039,89540,35.03870,255546
3826,jagan120,1,0.00039,89541,35.03909,255546
3827,jagusztinl,1,0.00039,89542,35.03948,255546
3828,jaKjH101,1,0.00039,89543,35.03988,255546
3829,jamesdhope,1,0.00039,89544,35.04027,255546
3830,jamylak,1,0.00039,89545,35.04066,255546
3831,jarednielsen,1,0.00039,89546,35.04105,255546
3832,jariolehtonen,1,0.00039,89547,35.04144,255546
3833,JasonChen86899,1,0.00039,89548,35.04183,255546
3834,jasongrout,1,0.00039,89549,35.04222,255546
3835,JasonLee925,1,0.00039,89550,35.04261,255546
3836,JasonTam,1,0.00039,89551,35.04301,255546
3837,jay-manday,1,0.00039,89552,35.04340,255546
3838,jbx,1,0.00039,89553,35.04379,255546
3839,jchaudari,1,0.00039,89554,35.04418,255546
3840,jchavezar,1,0.00039,89555,35.04457,255546
3841,jckwon,1,0.00039,89556,35.04496,255546
3842,jdstrand,1,0.00039,89557,35.04535,255546
3843,jenoOvchi,1,0.00039,89558,35.04575,255546
3844,Jenya95,1,0.00039,89559,35.04614,255546
3845,jeremiahkellick,1,0.00039,89560,35.04653,255546
3846,JeremyKeusters,1,0.00039,89561,35.04692,255546
3847,jerriezhou,1,0.00039,89562,35.04731,255546
3848,jerrygb,1,0.00039,89563,35.04770,255546
3849,jetmuffin,1,0.00039,89564,35.04809,255546
3850,jfantell,1,0.00039,89565,35.04848,255546
3851,jgerardsimcock,1,0.00039,89566,35.04888,255546
3852,JGoo1,1,0.00039,89567,35.04927,255546
3853,jgoodman8,1,0.00039,89568,35.04966,255546
3854,jhdxr,1,0.00039,89569,35.05005,255546
3855,jhisse,1,0.00039,89570,35.05044,255546
3856,jhkcia,1,0.00039,89571,35.05083,255546
3857,jhs2jhs,1,0.00039,89572,35.05122,255546
3858,jhtobigs,1,0.00039,89573,35.05161,255546
3859,jianwu-github,1,0.00039,89574,35.05201,255546
3860,JiaxuanYang,1,0.00039,89575,35.05240,255546
3861,jie8357IOII,1,0.00039,89576,35.05279,255546
3862,JIElite,1,0.00039,89577,35.05318,255546
3863,jieunchoi1120,1,0.00039,89578,35.05357,255546
3864,jimmyguerrero,1,0.00039,89579,35.05396,255546
3865,jingong2105,1,0.00039,89580,35.05435,255546
3866,jinoobaek-qz,1,0.00039,89581,35.05475,255546
3867,jintojose72,1,0.00039,89582,35.05514,255546
3868,jiuchen1986,1,0.00039,89583,35.05553,255546
3869,jj-794,1,0.00039,89584,35.05592,255546
3870,jjhursey,1,0.00039,89585,35.05631,255546
3871,jkeen871,1,0.00039,89586,35.05670,255546
3872,jkl0898,1,0.00039,89587,35.05709,255546
3873,jkwak3,1,0.00039,89588,35.05748,255546
3874,jlu1202,1,0.00039,89589,35.05788,255546
3875,jlzhang93,1,0.00039,89590,35.05827,255546
3876,jmsmkn,1,0.00039,89591,35.05866,255546
3877,jmurphs14,1,0.00039,89592,35.05905,255546
3878,jocelynbaduria,1,0.00039,89593,35.05944,255546
3879,jocieA,1,0.00039,89594,35.05983,255546
3880,jodavis-suse,1,0.00039,89595,35.06022,255546
3881,Jodo-skywalker,1,0.00039,89596,35.06062,255546
3882,joeatlas007,1,0.00039,89597,35.06101,255546
3883,joemal1234,1,0.00039,89598,35.06140,255546
3884,joeyaza,1,0.00039,89599,35.06179,255546
3885,JohnMBrandt,1,0.00039,89600,35.06218,255546
3886,John-Tate,1,0.00039,89601,35.06257,255546
3887,johnzhou2011,1,0.00039,89602,35.06296,255546
3888,joinalahmed,1,0.00039,89603,35.06335,255546
3889,jojomomo88754,1,0.00039,89604,35.06375,255546
3890,jonashartwig,1,0.00039,89605,35.06414,255546
3891,JonasTischer,1,0.00039,89606,35.06453,255546
3892,jonathan1920,1,0.00039,89607,35.06492,255546
3893,jonathan-bendov,1,0.00039,89608,35.06531,255546
3894,jondoering,1,0.00039,89609,35.06570,255546
3895,joneepenk,1,0.00039,89610,35.06609,255546
3896,jonf78,1,0.00039,89611,35.06649,255546
3897,joostgp,1,0.00039,89612,35.06688,255546
3898,Joostrothweiler,1,0.00039,89613,35.06727,255546
3899,jordyantunes,1,0.00039,89614,35.06766,255546
3900,journey-wang,1,0.00039,89615,35.06805,255546
3901,jppgks,1,0.00039,89616,35.06844,255546
3902,jramos,1,0.00039,89617,35.06883,255546
3903,jrgirona,1,0.00039,89618,35.06922,255546
3904,jsga,1,0.00039,89619,35.06962,255546
3905,jtanios,1,0.00039,89620,35.07001,255546
3906,Juandavi1,1,0.00039,89621,35.07040,255546
3907,judyliou,1,0.00039,89622,35.07079,255546
3908,JulesBelveze,1,0.00039,89623,35.07118,255546
3909,julianmack,1,0.00039,89624,35.07157,255546
3910,Julian-Mata,1,0.00039,89625,35.07196,255546
3911,Juntai,1,0.00039,89626,35.07235,255546
3912,just-an-intern,1,0.00039,89627,35.07275,255546
3913,Justin-Blau,1,0.00039,89628,35.07314,255546
3914,jwkim912,1,0.00039,89629,35.07353,255546
3915,jynx10,1,0.00039,89630,35.07392,255546
3916,Jyonn,1,0.00039,89631,35.07431,255546
3917,Jyothipyxis,1,0.00039,89632,35.07470,255546
3918,jzf2101,1,0.00039,89633,35.07509,255546
3919,k1m743hyun,1,0.00039,89634,35.07549,255546
3920,k3aibot,1,0.00039,89635,35.07588,255546
3921,kaben,1,0.00039,89636,35.07627,255546
3922,kachris,1,0.00039,89637,35.07666,255546
3923,kai910120,1,0.00039,89638,35.07705,255546
3924,kaiwaehner,1,0.00039,89639,35.07744,255546
3925,Kaka1127,1,0.00039,89640,35.07783,255546
3926,KakarotSonGokuShenron,1,0.00039,89641,35.07822,255546
3927,KannanThiru,1,0.00039,89642,35.07862,255546
3928,kant,1,0.00039,89643,35.07901,255546
3929,kaoutar55,1,0.00039,89644,35.07940,255546
3930,Kapalov,1,0.00039,89645,35.07979,255546
3931,KaranKhirsariya,1,0.00039,89646,35.08018,255546
3932,karan-kumar-by,1,0.00039,89647,35.08057,255546
3933,KarolisKont,1,0.00039,89648,35.08096,255546
3934,Katherinechenlove,1,0.00039,89649,35.08136,255546
3935,katherinez22,1,0.00039,89650,35.08175,255546
3936,katsiapis,1,0.00039,89651,35.08214,255546
3937,katylava,1,0.00039,89652,35.08253,255546
3938,KaulitzGuimaraes,1,0.00039,89653,35.08292,255546
3939,kavanshukla,1,0.00039,89654,35.08331,255546
3940,Kavee30,1,0.00039,89655,35.08370,255546
3941,KaviyaPeriyasamy,1,0.00039,89656,35.08409,255546
3942,kawai-kobold,1,0.00039,89657,35.08449,255546
3943,kawo123,1,0.00039,89658,35.08488,255546
3944,ka-zo,1,0.00039,89659,35.08527,255546
3945,kbd2011,1,0.00039,89660,35.08566,255546
3946,kbegiedza,1,0.00039,89661,35.08605,255546
3947,kciy,1,0.00039,89662,35.08644,255546
3948,kdecyllene,1,0.00039,89663,35.08683,255546
3949,kdrivas,1,0.00039,89664,35.08723,255546
3950,kdunee,1,0.00039,89665,35.08762,255546
3951,kedarX,1,0.00039,89666,35.08801,255546
3952,keeyzar,1,0.00039,89667,35.08840,255546
3953,keiichiroy,1,0.00039,89668,35.08879,255546
3954,keisuke-umezawa,1,0.00039,89669,35.08918,255546
3955,keithpij,1,0.00039,89670,35.08957,255546
3956,kellen,1,0.00039,89671,35.08996,255546
3957,kenlmf,1,0.00039,89672,35.09036,255546
3958,keremgocen,1,0.00039,89673,35.09075,255546
3959,k-e-r-n-e-l-p-a-n-i-c,1,0.00039,89674,35.09114,255546
3960,kevin2107,1,0.00039,89675,35.09153,255546
3961,kevin-bates,1,0.00039,89676,35.09192,255546
3962,kevinleewy,1,0.00039,89677,35.09231,255546
3963,kfkelvinng,1,0.00039,89678,35.09270,255546
3964,khoward,1,0.00039,89679,35.09309,255546
3965,kiddie92,1,0.00039,89680,35.09349,255546
3966,kilmarnock,1,0.00039,89681,35.09388,255546
3967,KION-ThomasMay,1,0.00039,89682,35.09427,255546
3968,KIShaoKIS,1,0.00039,89683,35.09466,255546
3969,kitamura-tetsuo,1,0.00039,89684,35.09505,255546
3970,kjaugustin,1,0.00039,89685,35.09544,255546
3971,kkumar137,1,0.00039,89686,35.09583,255546
3972,klaimane,1,0.00039,89687,35.09623,255546
3973,klee989,1,0.00039,89688,35.09662,255546
3974,klentabistado,1,0.00039,89689,35.09701,255546
3975,klolos,1,0.00039,89690,35.09740,255546
3976,knjk04,1,0.00039,89691,35.09779,255546
3977,knlp,1,0.00039,89692,35.09818,255546
3978,kong62,1,0.00039,89693,35.09857,255546
3979,kozhukalov,1,0.00039,89694,35.09896,255546
3980,Kr0n0,1,0.00039,89695,35.09936,255546
3981,krish7919,1,0.00039,89696,35.09975,255546
3982,Krishanu2001,1,0.00039,89697,35.10014,255546
3983,krishnakarra,1,0.00039,89698,35.10053,255546
3984,ksheerasagar17,1,0.00039,89699,35.10092,255546
3985,kudla,1,0.00039,89700,35.10131,255546
3986,kujon,1,0.00039,89701,35.10170,255546
3987,kujyp,1,0.00039,89702,35.10210,255546
3988,kungfuchicken,1,0.00039,89703,35.10249,255546
3989,kuromt,1,0.00039,89704,35.10288,255546
3990,kusirajiv,1,0.00039,89705,35.10327,255546
3991,kylebeni,1,0.00039,89706,35.10366,255546
3992,kyzy540,1,0.00039,89707,35.10405,255546
3993,kzygmans,1,0.00039,89708,35.10444,255546
3994,laibruce,1,0.00039,89709,35.10483,255546
3995,lamberta,1,0.00039,89710,35.10523,255546
3996,LamoraHolmes,1,0.00039,89711,35.10562,255546
3997,LaoLiulaoliu,1,0.00039,89712,35.10601,255546
3998,laurenskz,1,0.00039,89713,35.10640,255546
3999,laurentgrangeau,1,0.00039,89714,35.10679,255546
4000,l-baker,1,0.00039,89715,35.10718,255546
4001,leafmulch,1,0.00039,89716,35.10757,255546
4002,LeBaronDean,1,0.00039,89717,35.10796,255546
4003,lebiathan,1,0.00039,89718,35.10836,255546
4004,lenaherrmann-dfki,1,0.00039,89719,35.10875,255546
4005,leoliang1988,1,0.00039,89720,35.10914,255546
4006,leomzhong,1,0.00039,89721,35.10953,255546
4007,LeonardoEssence,1,0.00039,89722,35.10992,255546
4008,LetaoCh,1,0.00039,89723,35.11031,255546
4009,levitomer,1,0.00039,89724,35.11070,255546
4010,Lewiky,1,0.00039,89725,35.11110,255546
4011,lgarithm,1,0.00039,89726,35.11149,255546
4012,lhkkk,1,0.00039,89727,35.11188,255546
4013,liangxibing,1,0.00039,89728,35.11227,255546
4014,liaosiyang,1,0.00039,89729,35.11266,255546
4015,libgy8zli,1,0.00039,89730,35.11305,255546
4016,lifeandrew80,1,0.00039,89731,35.11344,255546
4017,liguodongiot,1,0.00039,89732,35.11383,255546
4018,liguodongIOT,1,0.00039,89733,35.11423,255546
4019,lildonpancho,1,0.00039,89734,35.11462,255546
4020,limbuu,1,0.00039,89735,35.11501,255546
4021,lions1988,1,0.00039,89736,35.11540,255546
4022,liudongqing,1,0.00039,89737,35.11579,255546
4023,liujiashang,1,0.00039,89738,35.11618,255546
4024,liuyl,1,0.00039,89739,35.11657,255546
4025,livegenic-akyrychek,1,0.00039,89740,35.11697,255546
4026,ljstrnadiii,1,0.00039,89741,35.11736,255546
4027,lkr2des,1,0.00039,89742,35.11775,255546
4028,llhuii,1,0.00039,89743,35.11814,255546
4029,lokeshjain279,1,0.00039,89744,35.11853,255546
4030,lonnix,1,0.00039,89745,35.11892,255546
4031,lostangel556,1,0.00039,89746,35.11931,255546
4032,LoveQSYang,1,0.00039,89747,35.11970,255546
4033,loveunk,1,0.00039,89748,35.12010,255546
4034,lsh2366254,1,0.00039,89749,35.12049,255546
4035,ltdo111,1,0.00039,89750,35.12088,255546
4036,ltomes,1,0.00039,89751,35.12127,255546
4037,lucasc896,1,0.00039,89752,35.12166,255546
4038,lucastan5596,1,0.00039,89753,35.12205,255546
4039,lucastheis,1,0.00039,89754,35.12244,255546
4040,lucasvbalves,1,0.00039,89755,35.12284,255546
4041,luckyops,1,0.00039,89756,35.12323,255546
4042,luistrange,1,0.00039,89757,35.12362,255546
4043,lukepfister,1,0.00039,89758,35.12401,255546
4044,lukeyan2023,1,0.00039,89759,35.12440,255546
4045,lumi-docs,1,0.00039,89760,35.12479,255546
4046,luoxiaoxun,1,0.00039,89761,35.12518,255546
4047,m0hit-aggarwal,1,0.00039,89762,35.12557,255546
4048,m3at,1,0.00039,89763,35.12597,255546
4049,maartenpants,1,0.00039,89764,35.12636,255546
4050,Mack-y,1,0.00039,89765,35.12675,255546
4051,madfrog,1,0.00039,89766,35.12714,255546
4052,MadsAdrian,1,0.00039,89767,35.12753,255546
4053,mageru,1,0.00039,89768,35.12792,255546
4054,maggiemhanna,1,0.00039,89769,35.12831,255546
4055,magreenberg,1,0.00039,89770,35.12870,255546
4056,maiconmattos,1,0.00039,89771,35.12910,255546
4057,maitra100,1,0.00039,89772,35.12949,255546
4058,manishsingh003,1,0.00039,89773,35.12988,255546
4059,manojb7,1,0.00039,89774,35.13027,255546
4060,mapsacosta,1,0.00039,89775,35.13066,255546
4061,MarcandreBoulon,1,0.00039,89776,35.13105,255546
4062,marciojv,1,0.00039,89777,35.13144,255546
4063,marcossony,1,0.00039,89778,35.13184,255546
4064,markbluhm,1,0.00039,89779,35.13223,255546
4065,markcberman,1,0.00039,89780,35.13262,255546
4066,markellos-orfanos,1,0.00039,89781,35.13301,255546
4067,Markfelixm,1,0.00039,89782,35.13340,255546
4068,MarkusThill,1,0.00039,89783,35.13379,255546
4069,marlonmBoti,1,0.00039,89784,35.13418,255546
4070,martfl,1,0.00039,89785,35.13457,255546
4071,masapasa,1,0.00039,89786,35.13497,255546
4072,masoumi76,1,0.00039,89787,35.13536,255546
4073,massih10,1,0.00039,89788,35.13575,255546
4074,MasterofBisaster,1,0.00039,89789,35.13614,255546
4075,mat-ej,1,0.00039,89790,35.13653,255546
4076,mateusz-szczesny,1,0.00039,89791,35.13692,255546
4077,mathetes87,1,0.00039,89792,35.13731,255546
4078,matheusjerico,1,0.00039,89793,35.13771,255546
4079,MatheusPush,1,0.00039,89794,35.13810,255546
4080,mathis-marcotte,1,0.00039,89795,35.13849,255546
4081,matphilippe,1,0.00039,89796,35.13888,255546
4082,MatthewTafazoli,1,0.00039,89797,35.13927,255546
4083,Matthias-Winkeler-Fluke,1,0.00039,89798,35.13966,255546
4084,MauGeo,1,0.00039,89799,35.14005,255546
4085,maurogonzalez,1,0.00039,89800,35.14044,255546
4086,MaxBlanck,1,0.00039,89801,35.14084,255546
4087,MaxGdr,1,0.00039,89802,35.14123,255546
4088,maximmold,1,0.00039,89803,35.14162,255546
4089,MaximumQuasar,1,0.00039,89804,35.14201,255546
4090,maxisawesome,1,0.00039,89805,35.14240,255546
4091,maxjacu,1,0.00039,89806,35.14279,255546
4092,maxkaustav,1,0.00039,89807,35.14318,255546
4093,maxspanning,1,0.00039,89808,35.14357,255546
4094,maxtaq,1,0.00039,89809,35.14397,255546
4095,Mayuraggarwal1992,1,0.00039,89810,35.14436,255546
4096,Mayurji,1,0.00039,89811,35.14475,255546
4097,mbellphd,1,0.00039,89812,35.14514,255546
4098,mbittmann,1,0.00039,89813,35.14553,255546
4099,MBKraus,1,0.00039,89814,35.14592,255546
4100,mcberma,1,0.00039,89815,35.14631,255546
4101,MDARBAAJ,1,0.00039,89816,35.14671,255546
4102,mdemiy,1,0.00039,89817,35.14710,255546
4103,MedhaCS1010,1,0.00039,89818,35.14749,255546
4104,Meet-Vaishnav,1,0.00039,89819,35.14788,255546
4105,megawidget,1,0.00039,89820,35.14827,255546
4106,mehdiasefi,1,0.00039,89821,35.14866,255546
4107,mehul1811,1,0.00039,89822,35.14905,255546
4108,MeisterUrian,1,0.00039,89823,35.14944,255546
4109,meken,1,0.00039,89824,35.14984,255546
4110,melih-sqsp,1,0.00039,89825,35.15023,255546
4111,MEllis-github,1,0.00039,89826,35.15062,255546
4112,metafeather,1,0.00039,89827,35.15101,255546
4113,Metal-joker,1,0.00039,89828,35.15140,255546
4114,metanouvelle,1,0.00039,89829,35.15179,255546
4115,mFat7y,1,0.00039,89830,35.15218,255546
4116,mf-lit,1,0.00039,89831,35.15258,255546
4117,MGSousa,1,0.00039,89832,35.15297,255546
4118,mhh12121,1,0.00039,89833,35.15336,255546
4119,michael-EIP,1,0.00039,89834,35.15375,255546
4120,miguelalba96,1,0.00039,89835,35.15414,255546
4121,miguelvcsoares,1,0.00039,89836,35.15453,255546
4122,mihuross,1,0.00039,89837,35.15492,255546
4123,mikeaadd,1,0.00039,89838,35.15531,255546
4124,Mikedu1988,1,0.00039,89839,35.15571,255546
4125,mikeedjones,1,0.00039,89840,35.15610,255546
4126,Mike-no,1,0.00039,89841,35.15649,255546
4127,mikezuniga,1,0.00039,89842,35.15688,255546
4128,millstx,1,0.00039,89843,35.15727,255546
4129,minaadel,1,0.00039,89844,35.15766,255546
4130,minchang,1,0.00039,89845,35.15805,255546
4131,mingnet,1,0.00039,89846,35.15845,255546
4132,mingweiLIU,1,0.00039,89847,35.15884,255546
4133,mingyyy,1,0.00039,89848,35.15923,255546
4134,MingzhouZhou,1,0.00039,89849,35.15962,255546
4135,minhdang241,1,0.00039,89850,35.16001,255546
4136,MinhManPham,1,0.00039,89851,35.16040,255546
4137,missedone,1,0.00039,89852,35.16079,255546
4138,mistadrumma,1,0.00039,89853,35.16118,255546
4139,mitsuan,1,0.00039,89854,35.16158,255546
4140,miutamihai,1,0.00039,89855,35.16197,255546
4141,mjw2194,1,0.00039,89856,35.16236,255546
4142,mkrakow,1,0.00039,89857,35.16275,255546
4143,MLOpsWC,1,0.00039,89858,35.16314,255546
4144,mlu4679,1,0.00039,89859,35.16353,255546
4145,mlujan-strive,1,0.00039,89860,35.16392,255546
4146,mmlmahesh,1,0.00039,89861,35.16431,255546
4147,MoAmrYehia,1,0.00039,89862,35.16471,255546
4148,mobin102,1,0.00039,89863,35.16510,255546
4149,mohakamg,1,0.00039,89864,35.16549,255546
4150,mohamedakelportfolio,1,0.00039,89865,35.16588,255546
4151,mohamed-fazil-saleem,1,0.00039,89866,35.16627,255546
4152,mohamedniyaz1996,1,0.00039,89867,35.16666,255546
4153,mohandeepzumen,1,0.00039,89868,35.16705,255546
4154,mohdashifkhan,1,0.00039,89869,35.16745,255546
4155,momomobinx,1,0.00039,89870,35.16784,255546
4156,mongoose54,1,0.00039,89871,35.16823,255546
4157,monicatao,1,0.00039,89872,35.16862,255546
4158,MonikaVen,1,0.00039,89873,35.16901,255546
4159,moose007,1,0.00039,89874,35.16940,255546
4160,morelen17,1,0.00039,89875,35.16979,255546
4161,morningcloud,1,0.00039,89876,35.17018,255546
4162,mortezaalizadeh,1,0.00039,89877,35.17058,255546
4163,mostafabayat,1,0.00039,89878,35.17097,255546
4164,MotoRZR,1,0.00039,89879,35.17136,255546
4165,mpietrzy,1,0.00039,89880,35.17175,255546
4166,mpsapps,1,0.00039,89881,35.17214,255546
4167,MrMwalker2,1,0.00039,89882,35.17253,255546
4168,mro-aaskandani,1,0.00039,89883,35.17292,255546
4169,mrslnv,1,0.00039,89884,35.17332,255546
4170,msalehiNV,1,0.00039,89885,35.17371,255546
4171,msalvaris,1,0.00039,89886,35.17410,255546
4172,MSchauperl,1,0.00039,89887,35.17449,255546
4173,msiegler-google,1,0.00039,89888,35.17488,255546
4174,msinghg123,1,0.00039,89889,35.17527,255546
4175,msmendoza,1,0.00039,89890,35.17566,255546
4176,msteffen,1,0.00039,89891,35.17605,255546
4177,MStopa,1,0.00039,89892,35.17645,255546
4178,MTD-Telus,1,0.00039,89893,35.17684,255546
4179,mtoslalibu,1,0.00039,89894,35.17723,255546
4180,munro,1,0.00039,89895,35.17762,255546
4181,murilommen,1,0.00039,89896,35.17801,255546
4182,muyajil,1,0.00039,89897,35.17840,255546
4183,muzhi1991,1,0.00039,89898,35.17879,255546
4184,mygulamali,1,0.00039,89899,35.17918,255546
4185,myoshimu,1,0.00039,89900,35.17958,255546
4186,nadamakram,1,0.00039,89901,35.17997,255546
4187,nagautier,1,0.00039,89902,35.18036,255546
4188,naimadg,1,0.00039,89903,35.18075,255546
4189,nandita853,1,0.00039,89904,35.18114,255546
4190,naresh4u-gitrepo,1,0.00039,89905,35.18153,255546
4191,narfian,1,0.00039,89906,35.18192,255546
4192,narijeong,1,0.00039,89907,35.18232,255546
4193,natalian98,1,0.00039,89908,35.18271,255546
4194,Nateyo,1,0.00039,89909,35.18310,255546
4195,NathanDeMaria,1,0.00039,89910,35.18349,255546
4196,NathanNZ,1,0.00039,89911,35.18388,255546
4197,Nathicanaa,1,0.00039,89912,35.18427,255546
4198,navado,1,0.00039,89913,35.18466,255546
4199,Naveen-Jayaram,1,0.00039,89914,35.18505,255546
4200,Naveenkhasyap,1,0.00039,89915,35.18545,255546
4201,Naveenlbg,1,0.00039,89916,35.18584,255546
4202,navinger,1,0.00039,89917,35.18623,255546
4203,navneetkrc-aj,1,0.00039,89918,35.18662,255546
4204,naz19,1,0.00039,89919,35.18701,255546
4205,n-batalha,1,0.00039,89920,35.18740,255546
4206,neeharika4,1,0.00039,89921,35.18779,255546
4207,neelasha-09,1,0.00039,89922,35.18819,255546
4208,neerajkaushik,1,0.00039,89923,35.18858,255546
4209,nehakapila94,1,0.00039,89924,35.18897,255546
4210,nehal3731,1,0.00039,89925,35.18936,255546
4211,nelson2000,1,0.00039,89926,35.18975,255546
4212,Nenrikido,1,0.00039,89927,35.19014,255546
4213,nicbillen,1,0.00039,89928,35.19053,255546
4214,nichoio,1,0.00039,89929,35.19092,255546
4215,nicklausZJF,1,0.00039,89930,35.19132,255546
4216,niderhoff,1,0.00039,89931,35.19171,255546
4217,nieksand,1,0.00039,89932,35.19210,255546
4218,nielsdewulf,1,0.00039,89933,35.19249,255546
4219,nielsuit227,1,0.00039,89934,35.19288,255546
4220,NieRonghua,1,0.00039,89935,35.19327,255546
4221,nikhilbandi,1,0.00039,89936,35.19366,255546
4222,nikhil-das-katonic,1,0.00039,89937,35.19406,255546
4223,NikhilKanda,1,0.00039,89938,35.19445,255546
4224,nikitosl,1,0.00039,89939,35.19484,255546
4225,nilanjana2015,1,0.00039,89940,35.19523,255546
4226,ninja-tester,1,0.00039,89941,35.19562,255546
4227,Nintorac,1,0.00039,89942,35.19601,255546
4228,NiravSo,1,0.00039,89943,35.19640,255546
4229,nishi-t,1,0.00039,89944,35.19679,255546
4230,nithinkanil1,1,0.00039,89945,35.19719,255546
4231,nitishkrishna,1,0.00039,89946,35.19758,255546
4232,niuqg,1,0.00039,89947,35.19797,255546
4233,njriasan,1,0.00039,89948,35.19836,255546
4234,nlin-kobold,1,0.00039,89949,35.19875,255546
4235,nm2107,1,0.00039,89950,35.19914,255546
4236,NonStatic2014,1,0.00039,89951,35.19953,255546
4237,npepin-hub,1,0.00039,89952,35.19992,255546
4238,nsshah1288,1,0.00039,89953,35.20032,255546
4239,n-stout,1,0.00039,89954,35.20071,255546
4240,ntakouris,1,0.00039,89955,35.20110,255546
4241,ntenenz,1,0.00039,89956,35.20149,255546
4242,nturner-maritz,1,0.00039,89957,35.20188,255546
4243,Nuniemsis,1,0.00039,89958,35.20227,255546
4244,NurFaizin,1,0.00039,89959,35.20266,255546
4245,nurvenur12,1,0.00039,89960,35.20306,255546
4246,nyejon,1,0.00039,89961,35.20345,255546
4247,nzhang0430,1,0.00039,89962,35.20384,255546
4248,oak-tree,1,0.00039,89963,35.20423,255546
4249,odovad,1,0.00039,89964,35.20462,255546
4250,okeynikky,1,0.00039,89965,35.20501,255546
4251,okonmarcin,1,0.00039,89966,35.20540,255546
4252,olicantin,1,0.00039,89967,35.20579,255546
4253,oluies,1,0.00039,89968,35.20619,255546
4254,omar16100,1,0.00039,89969,35.20658,255546
4255,OmGraja,1,0.00039,89970,35.20697,255546
4256,ommmid,1,0.00039,89971,35.20736,255546
4257,OnTheRicky,1,0.00039,89972,35.20775,255546
4258,OonjuoO,1,0.00039,89973,35.20814,255546
4259,openrory,1,0.00039,89974,35.20853,255546
4260,opensrn,1,0.00039,89975,35.20893,255546
4261,openthings,1,0.00039,89976,35.20932,255546
4262,oquere,1,0.00039,89977,35.20971,255546
4263,Oranst,1,0.00039,89978,35.21010,255546
4264,OrrAvrech,1,0.00039,89979,35.21049,255546
4265,OscarLlorente,1,0.00039,89980,35.21088,255546
4266,oscarvilla,1,0.00039,89981,35.21127,255546
4267,oskar-j,1,0.00039,89982,35.21166,255546
4268,ottodolfo,1,0.00039,89983,35.21206,255546
4269,ovarene,1,0.00039,89984,35.21245,255546
4270,o-vexler,1,0.00039,89985,35.21284,255546
4271,ozen,1,0.00039,89986,35.21323,255546
4272,ozert,1,0.00039,89987,35.21362,255546
4273,ozturkosu,1,0.00039,89988,35.21401,255546
4274,pa8mm,1,0.00039,89989,35.21440,255546
4275,padrian,1,0.00039,89990,35.21479,255546
4276,pangiann,1,0.00039,89991,35.21519,255546
4277,pantelis,1,0.00039,89992,35.21558,255546
4278,parakhjain,1,0.00039,89993,35.21597,255546
4279,parallelo,1,0.00039,89994,35.21636,255546
4280,patel-om,1,0.00039,89995,35.21675,255546
4281,patsadow2,1,0.00039,89996,35.21714,255546
4282,paulbehrisch,1,0.00039,89997,35.21753,255546
4283,paulcrowley,1,0.00039,89998,35.21793,255546
4284,paulk8s,1,0.00039,89999,35.21832,255546
4285,paulkarayan,1,0.00039,90000,35.21871,255546
4286,paulomach,1,0.00039,90001,35.21910,255546
4287,PaulQbFeng,1,0.00039,90002,35.21949,255546
4288,pavelzhurov,1,0.00039,90003,35.21988,255546
4289,pcdas,1,0.00039,90004,35.22027,255546
4290,pencilerazzer,1,0.00039,90005,35.22066,255546
4291,peng09,1,0.00039,90006,35.22106,255546
4292,perdurabo93,1,0.00039,90007,35.22145,255546
4293,perseusyang1997,1,0.00039,90008,35.22184,255546
4294,peterbarty,1,0.00039,90009,35.22223,255546
4295,phatlast96,1,0.00039,90010,35.22262,255546
4296,Phelan164,1,0.00039,90011,35.22301,255546
4297,phiamazon,1,0.00039,90012,35.22340,255546
4298,PhilippeMarcotte,1,0.00039,90013,35.22380,255546
4299,philtremblay,1,0.00039,90014,35.22419,255546
4300,PhoenixLuo2,1,0.00039,90015,35.22458,255546
4301,piaobeizu,1,0.00039,90016,35.22497,255546
4302,pikadef,1,0.00039,90017,35.22536,255546
4303,piyongze,1,0.00039,90018,35.22575,255546
4304,pjh4993,1,0.00039,90019,35.22614,255546
4305,Planck0591,1,0.00039,90020,35.22653,255546
4306,plankthom,1,0.00039,90021,35.22693,255546
4307,Plataformaalgoritmica,1,0.00039,90022,35.22732,255546
4308,PLeusmann,1,0.00039,90023,35.22771,255546
4309,Poggecci,1,0.00039,90024,35.22810,255546
4310,porimol,1,0.00039,90025,35.22849,255546
4311,porimolchandro,1,0.00039,90026,35.22888,255546
4312,PouriaNikvand,1,0.00039,90027,35.22927,255546
4313,pourquoi42,1,0.00039,90028,35.22967,255546
4314,ppkube,1,0.00039,90029,35.23006,255546
4315,prabhat04011998,1,0.00039,90030,35.23045,255546
4316,prabhatsharma,1,0.00039,90031,35.23084,255546
4317,prabhu,1,0.00039,90032,35.23123,255546
4318,pradeepbhadani,1,0.00039,90033,35.23162,255546
4319,pradnyaborkar900,1,0.00039,90034,35.23201,255546
4320,prakashsingh21,1,0.00039,90035,35.23240,255546
4321,pranavaninadam,1,0.00039,90036,35.23280,255546
4322,pranay-ar,1,0.00039,90037,35.23319,255546
4323,pranaysawant,1,0.00039,90038,35.23358,255546
4324,prasannakumar-coupa,1,0.00039,90039,35.23397,255546
4325,prasannavj,1,0.00039,90040,35.23436,255546
4326,prashant2402,1,0.00039,90041,35.23475,255546
4327,pratikgujjar,1,0.00039,90042,35.23514,255546
4328,PratikStar,1,0.00039,90043,35.23553,255546
4329,pratyushpanda,1,0.00039,90044,35.23593,255546
4330,preska,1,0.00039,90045,35.23632,255546
4331,Priapos1004,1,0.00039,90046,35.23671,255546
4332,PrincewillIroka,1,0.00039,90047,35.23710,255546
4333,Priyanka4pc,1,0.00039,90048,35.23749,255546
4334,prutkin,1,0.00039,90049,35.23788,255546
4335,PsHughes,1,0.00039,90050,35.23827,255546
4336,pskindel,1,0.00039,90051,35.23867,255546
4337,psmoros,1,0.00039,90052,35.23906,255546
4338,psyhtest,1,0.00039,90053,35.23945,255546
4339,psykidellic,1,0.00039,90054,35.23984,255546
4340,ptartan21,1,0.00039,90055,35.24023,255546
4341,pulpo,1,0.00039,90056,35.24062,255546
4342,pushkarv,1,0.00039,90057,35.24101,255546
4343,pyalex,1,0.00039,90058,35.24140,255546
4344,Python35,1,0.00039,90059,35.24180,255546
4345,pyxelr,1,0.00039,90060,35.24219,255546
4346,Qasim-Aziz,1,0.00039,90061,35.24258,255546
4347,qiaqiatic,1,0.00039,90062,35.24297,255546
4348,qijia2045579,1,0.00039,90063,35.24336,255546
4349,Qingwt,1,0.00039,90064,35.24375,255546
4350,QinjieLin-NU,1,0.00039,90065,35.24414,255546
4351,QipengZhou,1,0.00039,90066,35.24454,255546
4352,qlniu,1,0.00039,90067,35.24493,255546
4353,qqsun8819,1,0.00039,90068,35.24532,255546
4354,quan-dang,1,0.00039,90069,35.24571,255546
4355,queguan,1,0.00039,90070,35.24610,255546
4356,QuesarVII,1,0.00039,90071,35.24649,255546
4357,r0mk1,1,0.00039,90072,35.24688,255546
4358,Radhika108,1,0.00039,90073,35.24727,255546
4359,rafaelalou,1,0.00039,90074,35.24767,255546
4360,rafaelalouka-bai,1,0.00039,90075,35.24806,255546
4361,rafaelgildin,1,0.00039,90076,35.24845,255546
4362,raghav20,1,0.00039,90077,35.24884,255546
4363,raghavendramanandi,1,0.00039,90078,35.24923,255546
4364,raghulkrishna,1,0.00039,90079,35.24962,255546
4365,rahcode7,1,0.00039,90080,35.25001,255546
4366,rahul99,1,0.00039,90081,35.25041,255546
4367,rahulkhatry4,1,0.00039,90082,35.25080,255546
4368,rahulunair,1,0.00039,90083,35.25119,255546
4369,Raiyan111,1,0.00039,90084,35.25158,255546
4370,rajanjitenpatel,1,0.00039,90085,35.25197,255546
4371,rajivsam,1,0.00039,90086,35.25236,255546
4372,rajsrujan77,1,0.00039,90087,35.25275,255546
4373,rakshithpai2108,1,0.00039,90088,35.25314,255546
4374,rakshithvsk,1,0.00039,90089,35.25354,255546
4375,ramjinokia,1,0.00039,90090,35.25393,255546
4376,ranajoy-dutta,1,0.00039,90091,35.25432,255546
4377,rand,1,0.00039,90092,35.25471,255546
4378,randomcoww,1,0.00039,90093,35.25510,255546
4379,ranjithmr,1,0.00039,90094,35.25549,255546
4380,RaphPfister,1,0.00039,90095,35.25588,255546
4381,rapuckett,1,0.00039,90096,35.25627,255546
4382,rayuron,1,0.00039,90097,35.25667,255546
4383,raztud,1,0.00039,90098,35.25706,255546
4384,rcarmstrong,1,0.00039,90099,35.25745,255546
4385,rculbertson,1,0.00039,90100,35.25784,255546
4386,rdoume,1,0.00039,90101,35.25823,255546
4387,reach4nk,1,0.00039,90102,35.25862,255546
4388,realsushi-official,1,0.00039,90103,35.25901,255546
4389,redcican,1,0.00039,90104,35.25941,255546
4390,reevelau,1,0.00039,90105,35.25980,255546
4391,reinhouthooft,1,0.00039,90106,35.26019,255546
4392,remde,1,0.00039,90107,35.26058,255546
4393,remoyson,1,0.00039,90108,35.26097,255546
4394,RemyLarroye-o,1,0.00039,90109,35.26136,255546
4395,renat-abbyazov,1,0.00039,90110,35.26175,255546
4396,renqiang2016,1,0.00039,90111,35.26214,255546
4397,RensDimmendaal,1,0.00039,90112,35.26254,255546
4398,renuraj18,1,0.00039,90113,35.26293,255546
4399,RE-Wolfe,1,0.00039,90114,35.26332,255546
4400,rexlow,1,0.00039,90115,35.26371,255546
4401,reyhane1998,1,0.00039,90116,35.26410,255546
4402,rfan-debug,1,0.00039,90117,35.26449,255546
4403,rgupta1234,1,0.00039,90118,35.26488,255546
4404,rguso,1,0.00039,90119,35.26528,255546
4405,rhatol,1,0.00039,90120,35.26567,255546
4406,rhugga,1,0.00039,90121,35.26606,255546
4407,richardburakowski,1,0.00039,90122,35.26645,255546
4408,riibeirogabriel,1,0.00039,90123,35.26684,255546
4409,riteshkarval,1,0.00039,90124,35.26723,255546
4410,riteshpallod,1,0.00039,90125,35.26762,255546
4411,rjEks,1,0.00039,90126,35.26801,255546
4412,rmbrad,1,0.00039,90127,35.26841,255546
4413,rnkhouse,1,0.00039,90128,35.26880,255546
4414,robbiedow,1,0.00039,90129,35.26919,255546
4415,robertofierimonte,1,0.00039,90130,35.26958,255546
4416,robertschweizer,1,0.00039,90131,35.26997,255546
4417,robinvanschaik,1,0.00039,90132,35.27036,255546
4418,robotaref,1,0.00039,90133,35.27075,255546
4419,rock-town-coder,1,0.00039,90134,35.27114,255546
4420,rohitgujral,1,0.00039,90135,35.27154,255546
4421,romanbilenko174,1,0.00039,90136,35.27193,255546
4422,ronsingler,1,0.00039,90137,35.27232,255546
4423,ronytesler,1,0.00039,90138,35.27271,255546
4424,Rory602,1,0.00039,90139,35.27310,255546
4425,rosawant,1,0.00039,90140,35.27349,255546
4426,Roshrini,1,0.00039,90141,35.27388,255546
4427,rovechkin,1,0.00039,90142,35.27428,255546
4428,roy-ht,1,0.00039,90143,35.27467,255546
4429,Roymprog,1,0.00039,90144,35.27506,255546
4430,RoyOsaki,1,0.00039,90145,35.27545,255546
4431,rp4fx12,1,0.00039,90146,35.27584,255546
4432,rsassPwC,1,0.00039,90147,35.27623,255546
4433,rscottwatson,1,0.00039,90148,35.27662,255546
4434,rsepassi,1,0.00039,90149,35.27701,255546
4435,rsinghtc,1,0.00039,90150,35.27741,255546
4436,rsr23,1,0.00039,90151,35.27780,255546
4437,ruanxingbaozi,1,0.00039,90152,35.27819,255546
4438,RubensZimbres,1,0.00039,90153,35.27858,255546
4439,ruodingt,1,0.00039,90154,35.27897,255546
4440,RUOK90,1,0.00039,90155,35.27936,255546
4441,RustamyF,1,0.00039,90156,35.27975,255546
4442,rwathena,1,0.00039,90157,35.28015,255546
4443,ryan-nervana,1,0.00039,90158,35.28054,255546
4444,ryanwcyin,1,0.00039,90159,35.28093,255546
4445,rystadedgaras,1,0.00039,90160,35.28132,255546
4446,RyuSA,1,0.00039,90161,35.28171,255546
4447,rzillerueloatgoogle,1,0.00039,90162,35.28210,255546
4448,sabarikannan-ai,1,0.00039,90163,35.28249,255546
4449,sabarnwal,1,0.00039,90164,35.28288,255546
4450,sabya39,1,0.00039,90165,35.28328,255546
4451,sachin-ac,1,0.00039,90166,35.28367,255546
4452,sadakeita,1,0.00039,90167,35.28406,255546
4453,sai196,1,0.00039,90168,35.28445,255546
4454,saiakhil2012,1,0.00039,90169,35.28484,255546
4455,saidsef,1,0.00039,90170,35.28523,255546
4456,saigirishgilly98,1,0.00039,90171,35.28562,255546
4457,SaiKiranBurle,1,0.00039,90172,35.28602,255546
4458,salexashenko,1,0.00039,90173,35.28641,255546
4459,sallamander,1,0.00039,90174,35.28680,255546
4460,saltazaur,1,0.00039,90175,35.28719,255546
4461,sam360digitmg,1,0.00039,90176,35.28758,255546
4462,samcaetano,1,0.00039,90177,35.28797,255546
4463,sam-h-bean,1,0.00039,90178,35.28836,255546
4464,samithaj,1,0.00039,90179,35.28875,255546
4465,SanderRednas,1,0.00039,90180,35.28915,255546
4466,sanjikasehgal,1,0.00039,90181,35.28954,255546
4467,sanjshres,1,0.00039,90182,35.28993,255546
4468,sanjshrestha,1,0.00039,90183,35.29032,255546
4469,santhosh261190,1,0.00039,90184,35.29071,255546
4470,Santosh1176,1,0.00039,90185,35.29110,255546
4471,SaraSaffari,1,0.00039,90186,35.29149,255546
4472,Sarrouna,1,0.00039,90187,35.29188,255546
4473,sashavcat,1,0.00039,90188,35.29228,255546
4474,sassyn,1,0.00039,90189,35.29267,255546
4475,satata-clgx,1,0.00039,90190,35.29306,255546
4476,satheeshbc,1,0.00039,90191,35.29345,255546
4477,Sathvik777,1,0.00039,90192,35.29384,255546
4478,satriawadhipurusa,1,0.00039,90193,35.29423,255546
4479,saurabh1043,1,0.00039,90194,35.29462,255546
4480,saurav2608,1,0.00039,90195,35.29502,255546
4481,savingoyal,1,0.00039,90196,35.29541,255546
4482,Sayed-Imran,1,0.00039,90197,35.29580,255546
4483,sbko,1,0.00039,90198,35.29619,255546
4484,Scagin,1,0.00039,90199,35.29658,255546
4485,scale-itx,1,0.00039,90200,35.29697,255546
4486,schmidt-jake,1,0.00039,90201,35.29736,255546
4487,scotttam,1,0.00039,90202,35.29775,255546
4488,scttl,1,0.00039,90203,35.29815,255546
4489,sdgs72,1,0.00039,90204,35.29854,255546
4490,seanlin1326,1,0.00039,90205,35.29893,255546
4491,seattleplus,1,0.00039,90206,35.29932,255546
4492,sebastianbarry-sms,1,0.00039,90207,35.29971,255546
4493,seboktamas,1,0.00039,90208,35.30010,255546
4494,SeibertronSSS,1,0.00039,90209,35.30049,255546
4495,seoyeonhwng,1,0.00039,90210,35.30089,255546
4496,SergeyCherman,1,0.00039,90211,35.30128,255546
4497,sethmcagit,1,0.00039,90212,35.30167,255546
4498,sevro,1,0.00039,90213,35.30206,255546
4499,Shabrinath,1,0.00039,90214,35.30245,255546
4500,shadowdsp,1,0.00039,90215,35.30284,255546
4501,shadowmodder,1,0.00039,90216,35.30323,255546
4502,shag123,1,0.00039,90217,35.30362,255546
4503,ShaneZhong,1,0.00039,90218,35.30402,255546
4504,shanisma,1,0.00039,90219,35.30441,255546
4505,shankarpm,1,0.00039,90220,35.30480,255546
4506,Sharat-Innodatatics,1,0.00039,90221,35.30519,255546
4507,sharm294,1,0.00039,90222,35.30558,255546
4508,ShashankBlr,1,0.00039,90223,35.30597,255546
4509,ShaswataJash,1,0.00039,90224,35.30636,255546
4510,shekhar0413,1,0.00039,90225,35.30675,255546
4511,shekhar-ms123,1,0.00039,90226,35.30715,255546
4512,shengkaixuan,1,0.00039,90227,35.30754,255546
4513,shengy90,1,0.00039,90228,35.30793,255546
4514,shengzhou1216,1,0.00039,90229,35.30832,255546
4515,shenkejie15,1,0.00039,90230,35.30871,255546
4516,shikhabitgrit,1,0.00039,90231,35.30910,255546
4517,shilf1,1,0.00039,90232,35.30949,255546
4518,shivam19991,1,0.00039,90233,35.30989,255546
4519,shiyu15,1,0.00039,90234,35.31028,255546
4520,shravspy,1,0.00039,90235,35.31067,255546
4521,ShreyPandit,1,0.00039,90236,35.31106,255546
4522,ShrikanthSingh,1,0.00039,90237,35.31145,255546
4523,shrinidhisuresha,1,0.00039,90238,35.31184,255546
4524,shrivs3,1,0.00039,90239,35.31223,255546
4525,shrutich91,1,0.00039,90240,35.31262,255546
4526,shurain,1,0.00039,90241,35.31302,255546
4527,sibleyd,1,0.00039,90242,35.31341,255546
4528,Siddarth-Pattnaik,1,0.00039,90243,35.31380,255546
4529,siddhant235,1,0.00039,90244,35.31419,255546
4530,Siddika1278,1,0.00039,90245,35.31458,255546
4531,siddsuresh97,1,0.00039,90246,35.31497,255546
4532,Sidebook,1,0.00039,90247,35.31536,255546
4533,sidiksoleman,1,0.00039,90248,35.31576,255546
4534,sidnaik1975,1,0.00039,90249,35.31615,255546
4535,SilDev-zz,1,0.00039,90250,35.31654,255546
4536,simanw304,1,0.00039,90251,35.31693,255546
4537,simanwangSC,1,0.00039,90252,35.31732,255546
4538,Simon-Harris-IBM,1,0.00039,90253,35.31771,255546
4539,Sinba7,1,0.00039,90254,35.31810,255546
4540,sitakantachaudhury,1,0.00039,90255,35.31849,255546
4541,sivachama,1,0.00039,90256,35.31889,255546
4542,sixinshuier,1,0.00039,90257,35.31928,255546
4543,sjaek,1,0.00039,90258,35.31967,255546
4544,sjmccorm1993,1,0.00039,90259,35.32006,255546
4545,sleep-404,1,0.00039,90260,35.32045,255546
4546,slowlove1995,1,0.00039,90261,35.32084,255546
4547,SmartInWhut,1,0.00039,90262,35.32123,255546
4548,smeyer12,1,0.00039,90263,35.32163,255546
4549,smijar,1,0.00039,90264,35.32202,255546
4550,sml0820,1,0.00039,90265,35.32241,255546
4551,smnama,1,0.00039,90266,35.32280,255546
4552,Smokrow,1,0.00039,90267,35.32319,255546
4553,smthpickboy,1,0.00039,90268,35.32358,255546
4554,sneharth37,1,0.00039,90269,35.32397,255546
4555,snowmanbamm,1,0.00039,90270,35.32436,255546
4556,snps-sagarrao,1,0.00039,90271,35.32476,255546
4557,sofam,1,0.00039,90272,35.32515,255546
4558,sofsms,1,0.00039,90273,35.32554,255546
4559,Softsapiens,1,0.00039,90274,35.32593,255546
4560,SoheilSalehian,1,0.00039,90275,35.32632,255546
4561,solomatov,1,0.00039,90276,35.32671,255546
4562,somnath1077,1,0.00039,90277,35.32710,255546
4563,sonfire86,1,0.00039,90278,35.32749,255546
4564,Soonmok,1,0.00039,90279,35.32789,255546
4565,sorowakers,1,0.00039,90280,35.32828,255546
4566,SoujanyaSan,1,0.00039,90281,35.32867,255546
4567,soumith,1,0.00039,90282,35.32906,255546
4568,soumyadipDe,1,0.00039,90283,35.32945,255546
4569,Space-Banana-42,1,0.00039,90284,35.32984,255546
4570,spatre,1,0.00039,90285,35.33023,255546
4571,SpeedCoder5,1,0.00039,90286,35.33063,255546
4572,speg03,1,0.00039,90287,35.33102,255546
4573,spinelsun,1,0.00039,90288,35.33141,255546
4574,sporterman,1,0.00039,90289,35.33180,255546
4575,springcoil,1,0.00039,90290,35.33219,255546
4576,SputnikTea,1,0.00039,90291,35.33258,255546
4577,squaricdot,1,0.00039,90292,35.33297,255546
4578,sramirez,1,0.00039,90293,35.33336,255546
4579,sravanikollipara,1,0.00039,90294,35.33376,255546
4580,sreddybr3,1,0.00039,90295,35.33415,255546
4581,sreenivasmrpivot,1,0.00039,90296,35.33454,255546
4582,sriharikarnam,1,0.00039,90297,35.33493,255546
4583,srikantt,1,0.00039,90298,35.33532,255546
4584,srinivascreddy,1,0.00039,90299,35.33571,255546
4585,srishti0190,1,0.00039,90300,35.33610,255546
4586,ssabat,1,0.00039,90301,35.33650,255546
4587,ssabnis,1,0.00039,90302,35.33689,255546
4588,ssbhat,1,0.00039,90303,35.33728,255546
4589,ssharpe42,1,0.00039,90304,35.33767,255546
4590,StarCoral,1,0.00039,90305,35.33806,255546
4591,staturecrane,1,0.00039,90306,35.33845,255546
4592,stdec,1,0.00039,90307,35.33884,255546
4593,Steboss89,1,0.00039,90308,35.33923,255546
4594,StefanFreshLand,1,0.00039,90309,35.33963,255546
4595,stepanhruda,1,0.00039,90310,35.34002,255546
4596,StephennFernandes,1,0.00039,90311,35.34041,255546
4597,SteveHoggNZ,1,0.00039,90312,35.34080,255546
4598,stevenzhang-support,1,0.00039,90313,35.34119,255546
4599,stevezkw1998,1,0.00039,90314,35.34158,255546
4600,steviecash,1,0.00039,90315,35.34197,255546
4601,stradigi-andres-de-castro,1,0.00039,90316,35.34236,255546
4602,strangemonad,1,0.00039,90317,35.34276,255546
4603,su0625,1,0.00039,90318,35.34315,255546
4604,subramankala,1,0.00039,90319,35.34354,255546
4605,sucanthudu,1,0.00039,90320,35.34393,255546
4606,sumanraja,1,0.00039,90321,35.34432,255546
4607,sumeet1989,1,0.00039,90322,35.34471,255546
4608,Sumenia,1,0.00039,90323,35.34510,255546
4609,sunandosamaddar,1,0.00039,90324,35.34550,255546
4610,SunFromEast,1,0.00039,90325,35.34589,255546
4611,sunshine-zyl,1,0.00039,90326,35.34628,255546
4612,SuperKogito,1,0.00039,90327,35.34667,255546
4613,surabhikannan,1,0.00039,90328,35.34706,255546
4614,suredream,1,0.00039,90329,35.34745,255546
4615,suzusuzu,1,0.00039,90330,35.34784,255546
4616,svilenvul,1,0.00039,90331,35.34823,255546
4617,swapdebarshi,1,0.00039,90332,35.34863,255546
4618,swarnaditya,1,0.00039,90333,35.34902,255546
4619,SwathiAunooru,1,0.00039,90334,35.34941,255546
4620,switchfootsid,1,0.00039,90335,35.34980,255546
4621,swjung94,1,0.00039,90336,35.35019,255546
4622,syeo,1,0.00039,90337,35.35058,255546
4623,Sygyzmundovych,1,0.00039,90338,35.35097,255546
4624,syvlabs,1,0.00039,90339,35.35137,255546
4625,szha,1,0.00039,90340,35.35176,255546
4626,szpnygo,1,0.00039,90341,35.35215,255546
4627,TabbieD,1,0.00039,90342,35.35254,255546
4628,Taehun,1,0.00039,90343,35.35293,255546
4629,taghoutigomycode,1,0.00039,90344,35.35332,255546
4630,talal-sen,1,0.00039,90345,35.35371,255546
4631,talaman,1,0.00039,90346,35.35410,255546
4632,talexander,1,0.00039,90347,35.35450,255546
4633,talgos1,1,0.00039,90348,35.35489,255546
4634,tam0201,1,0.00039,90349,35.35528,255546
4635,tama-biro,1,0.00039,90350,35.35567,255546
4636,tania-python-dev,1,0.00039,90351,35.35606,255546
4637,tanmayv25,1,0.00039,90352,35.35645,255546
4638,tanvithakur94,1,0.00039,90353,35.35684,255546
4639,tanzb33r,1,0.00039,90354,35.35724,255546
4640,tan-z-tan,1,0.00039,90355,35.35763,255546
4641,taoyonggang,1,0.00039,90356,35.35802,255546
4642,TaranSinghania,1,0.00039,90357,35.35841,255546
4643,tarekabouzeid,1,0.00039,90358,35.35880,255546
4644,tarun0,1,0.00039,90359,35.35919,255546
4645,tavinashb,1,0.00039,90360,35.35958,255546
4646,tayritenour,1,0.00039,90361,35.35997,255546
4647,tayyabmaqsood,1,0.00039,90362,35.36037,255546
4648,tbeatty,1,0.00039,90363,35.36076,255546
4649,tboquet,1,0.00039,90364,35.36115,255546
4650,tdevopsottawa,1,0.00039,90365,35.36154,255546
4651,techgnosis,1,0.00039,90366,35.36193,255546
4652,techgopal,1,0.00039,90367,35.36232,255546
4653,techjournalist,1,0.00039,90368,35.36271,255546
4654,Techn0logic,1,0.00039,90369,35.36310,255546
4655,TechR10n,1,0.00039,90370,35.36350,255546
4656,techwithshadab,1,0.00039,90371,35.36389,255546
4657,teetangh,1,0.00039,90372,35.36428,255546
4658,tejashpe,1,0.00039,90373,35.36467,255546
4659,tesla3,1,0.00039,90374,35.36506,255546
4660,testphys,1,0.00039,90375,35.36545,255546
4661,Te-YuanLiu,1,0.00039,90376,35.36584,255546
4662,the5solae,1,0.00039,90377,35.36624,255546
4663,thenovices,1,0.00039,90378,35.36663,255546
4664,Theocrat,1,0.00039,90379,35.36702,255546
4665,TheOtherOsama,1,0.00039,90380,35.36741,255546
4666,thethiny,1,0.00039,90381,35.36780,255546
4667,thetume,1,0.00039,90382,35.36819,255546
4668,thi-low,1,0.00039,90383,35.36858,255546
4669,thirdeye-jarvis,1,0.00039,90384,35.36897,255546
4670,ThisIsANiceName,1,0.00039,90385,35.36937,255546
4671,thkim0022,1,0.00039,90386,35.36976,255546
4672,thms-ngn,1,0.00039,90387,35.37015,255546
4673,tholor,1,0.00039,90388,35.37054,255546
4674,Thomasillo,1,0.00039,90389,35.37093,255546
4675,ThomasRot,1,0.00039,90390,35.37132,255546
4676,thomasSve,1,0.00039,90391,35.37171,255546
4677,thor3333,1,0.00039,90392,35.37211,255546
4678,thunderhill,1,0.00039,90393,35.37250,255546
4679,Tiddl1991,1,0.00039,90394,35.37289,255546
4680,TimCookny,1,0.00039,90395,35.37328,255546
4681,timothy-mugayi,1,0.00039,90396,35.37367,255546
4682,timothymugayi,1,0.00039,90397,35.37406,255546
4683,tinahbu,1,0.00039,90398,35.37445,255546
4684,tiopramayudi,1,0.00039,90399,35.37484,255546
4685,TiraO,1,0.00039,90400,35.37524,255546
4686,tjhgit,1,0.00039,90401,35.37563,255546
4687,tjingrant,1,0.00039,90402,35.37602,255546
4688,tmattio,1,0.00039,90403,35.37641,255546
4689,tmbluth,1,0.00039,90404,35.37680,255546
4690,tmnhat2001,1,0.00039,90405,35.37719,255546
4691,tmreic,1,0.00039,90406,35.37758,255546
4692,tobiasimbus,1,0.00039,90407,35.37798,255546
4693,toddlerds,1,0.00039,90408,35.37837,255546
4694,TomLaMantia,1,0.00039,90409,35.37876,255546
4695,TomReidNZ,1,0.00039,90410,35.37915,255546
4696,tomstockton,1,0.00039,90411,35.37954,255546
4697,Tomxin,1,0.00039,90412,35.37993,255546
4698,tongchao199,1,0.00039,90413,35.38032,255546
4699,tonyaw,1,0.00039,90414,35.38071,255546
4700,TPP2,1,0.00039,90415,35.38111,255546
4701,trackq,1,0.00039,90416,35.38150,255546
4702,traino82,1,0.00039,90417,35.38189,255546
4703,Trezorro,1,0.00039,90418,35.38228,255546
4704,TrieuLe0801,1,0.00039,90419,35.38267,255546
4705,trn84,1,0.00039,90420,35.38306,255546
4706,TrubadurOsman,1,0.00039,90421,35.38345,255546
4707,tsukky67,1,0.00039,90422,35.38384,255546
4708,TT310,1,0.00039,90423,35.38424,255546
4709,tu-infra-tests,1,0.00039,90424,35.38463,255546
4710,tuliodesouza,1,0.00039,90425,35.38502,255546
4711,tuukkasarvi,1,0.00039,90426,35.38541,255546
4712,TylerBrabham,1,0.00039,90427,35.38580,255546
4713,Udayaprasad,1,0.00039,90428,35.38619,255546
4714,Ulov888,1,0.00039,90429,35.38658,255546
4715,unijoy,1,0.00039,90430,35.38698,255546
4716,UnionGlobal,1,0.00039,90431,35.38737,255546
4717,utkrs,1,0.00039,90432,35.38776,255546
4718,Vafilor,1,0.00039,90433,35.38815,255546
4719,vakrat1,1,0.00039,90434,35.38854,255546
4720,valeneiko,1,0.00039,90435,35.38893,255546
4721,valentindbdg,1,0.00039,90436,35.38932,255546
4722,valko073,1,0.00039,90437,35.38971,255546
4723,vanaraj-az,1,0.00039,90438,35.39011,255546
4724,vancromy,1,0.00039,90439,35.39050,255546
4725,Vanithanow,1,0.00039,90440,35.39089,255546
4726,varun111111,1,0.00039,90441,35.39128,255546
4727,varunchandan2,1,0.00039,90442,35.39167,255546
4728,vasco989k,1,0.00039,90443,35.39206,255546
4729,vasireddyvkl,1,0.00039,90444,35.39245,255546
4730,V-Bhadauriya,1,0.00039,90445,35.39285,255546
4731,vbucaj,1,0.00039,90446,35.39324,255546
4732,vdiravka,1,0.00039,90447,35.39363,255546
4733,vecorro,1,0.00039,90448,35.39402,255546
4734,venkatagedda,1,0.00039,90449,35.39441,255546
4735,vfontama,1,0.00039,90450,35.39480,255546
4736,vgopal,1,0.00039,90451,35.39519,255546
4737,viethung1234q,1,0.00039,90452,35.39558,255546
4738,vijayb47,1,0.00039,90453,35.39598,255546
4739,vijaytrainer,1,0.00039,90454,35.39637,255546
4740,vikasmenon,1,0.00039,90455,35.39676,255546
4741,Vikram486,1,0.00039,90456,35.39715,255546
4742,viksharma1987,1,0.00039,90457,35.39754,255546
4743,vinaydel,1,0.00039,90458,35.39793,255546
4744,vinaykumargudi,1,0.00039,90459,35.39832,255546
4745,VindhyaSRajan,1,0.00039,90460,35.39871,255546
4746,vinhdiesal,1,0.00039,90461,35.39911,255546
4747,viraja1,1,0.00039,90462,35.39950,255546
4748,ViralParikh22,1,0.00039,90463,35.39989,255546
4749,vishalsmb,1,0.00039,90464,35.40028,255546
4750,vishal-wiai,1,0.00039,90465,35.40067,255546
4751,VithikShah,1,0.00039,90466,35.40106,255546
4752,vivekanandpoojari,1,0.00039,90467,35.40145,255546
4753,vivekbhadouria,1,0.00039,90468,35.40185,255546
4754,vivekkum94,1,0.00039,90469,35.40224,255546
4755,viyer7,1,0.00039,90470,35.40263,255546
4756,vochicong,1,0.00039,90471,35.40302,255546
4757,volkermauel,1,0.00039,90472,35.40341,255546
4758,Volkimd,1,0.00039,90473,35.40380,255546
4759,vovkanaz,1,0.00039,90474,35.40419,255546
4760,vsatpathy,1,0.00039,90475,35.40458,255546
4761,vsriniv-git,1,0.00039,90476,35.40498,255546
4762,vule24,1,0.00039,90477,35.40537,255546
4763,wafaaabdelhafez,1,0.00039,90478,35.40576,255546
4764,wallyworld,1,0.00039,90479,35.40615,255546
4765,WangCHX,1,0.00039,90480,35.40654,255546
4766,WangHexie,1,0.00039,90481,35.40693,255546
4767,Wansh619,1,0.00039,90482,35.40732,255546
4768,waynehsei,1,0.00039,90483,35.40772,255546
4769,wdma,1,0.00039,90484,35.40811,255546
4770,we10710aa,1,0.00039,90485,35.40850,255546
4771,weicheng8626,1,0.00039,90486,35.40889,255546
4772,welcomemandeep,1,0.00039,90487,35.40928,255546
4773,wenjing,1,0.00039,90488,35.40967,255546
4774,wenjinsitu,1,0.00039,90489,35.41006,255546
4775,wenxinax,1,0.00039,90490,35.41045,255546
4776,wfchair,1,0.00039,90491,35.41085,255546
4777,whappybara,1,0.00039,90492,35.41124,255546
4778,William8Work,1,0.00039,90493,35.41163,255546
4779,willturner-gs,1,0.00039,90494,35.41202,255546
4780,willypicard,1,0.00039,90495,35.41241,255546
4781,wing328,1,0.00039,90496,35.41280,255546
4782,wintwoo,1,0.00039,90497,35.41319,255546
4783,wiszniowski-t,1,0.00039,90498,35.41359,255546
4784,wlzzZ,1,0.00039,90499,35.41398,255546
4785,wmikolajczyk,1,0.00039,90500,35.41437,255546
4786,wnowak10,1,0.00039,90501,35.41476,255546
4787,woof,1,0.00039,90502,35.41515,255546
4788,worsecoder,1,0.00039,90503,35.41554,255546
4789,wskinner,1,0.00039,90504,35.41593,255546
4790,wtermini,1,0.00039,90505,35.41632,255546
4791,wufly,1,0.00039,90506,35.41672,255546
4792,wulikai1993,1,0.00039,90507,35.41711,255546
4793,wutianhao910,1,0.00039,90508,35.41750,255546
4794,wuxinglai,1,0.00039,90509,35.41789,255546
4795,wuyexixi,1,0.00039,90510,35.41828,255546
4796,wuzhiye7,1,0.00039,90511,35.41867,255546
4797,xalekx,1,0.00039,90512,35.41906,255546
4798,xcloud-carl,1,0.00039,90513,35.41945,255546
4799,xiangninglyu,1,0.00039,90514,35.41985,255546
4800,xiaoqiuh,1,0.00039,90515,35.42024,255546
4801,xiehaoina,1,0.00039,90516,35.42063,255546
4802,xiezhw3,1,0.00039,90517,35.42102,255546
4803,xinghalo,1,0.00039,90518,35.42141,255546
4804,Xingyuan-Chen,1,0.00039,90519,35.42180,255546
4805,xnoar747,1,0.00039,90520,35.42219,255546
4806,xsatishx,1,0.00039,90521,35.42259,255546
4807,xsqian,1,0.00039,90522,35.42298,255546
4808,xuchenCN,1,0.00039,90523,35.42337,255546
4809,xushaoxiao,1,0.00039,90524,35.42376,255546
4810,xwyangjshb,1,0.00039,90525,35.42415,255546
4811,xxf09th,1,0.00039,90526,35.42454,255546
4812,xxxxiehf,1,0.00039,90527,35.42493,255546
4813,xzy0223,1,0.00039,90528,35.42532,255546
4814,y2kenny,1,0.00039,90529,35.42572,255546
4815,yangaang,1,0.00039,90530,35.42611,255546
4816,yangjinlogic,1,0.00039,90531,35.42650,255546
4817,yangoos57,1,0.00039,90532,35.42689,255546
4818,yangpeng1994,1,0.00039,90533,35.42728,255546
4819,yangSignifyd,1,0.00039,90534,35.42767,255546
4820,yangyu2013,1,0.00039,90535,35.42806,255546
4821,yankunsam,1,0.00039,90536,35.42846,255546
4822,YannisPap,1,0.00039,90537,35.42885,255546
4823,yanyanwang1,1,0.00039,90538,35.42924,255546
4824,yaseenisolated,1,0.00039,90539,35.42963,255546
4825,yczheng0,1,0.00039,90540,35.43002,255546
4826,yecohn,1,0.00039,90541,35.43041,255546
4827,YGuyomar,1,0.00039,90542,35.43080,255546
4828,yike5460,1,0.00039,90543,35.43119,255546
4829,yisampi,1,0.00039,90544,35.43159,255546
4830,yizhexu,1,0.00039,90545,35.43198,255546
4831,ykacer,1,0.00039,90546,35.43237,255546
4832,ykale,1,0.00039,90547,35.43276,255546
4833,yliu989,1,0.00039,90548,35.43315,255546
4834,yonaroze,1,0.00039,90549,35.43354,255546
4835,YongtaoHuang1994,1,0.00039,90550,35.43393,255546
4836,yooki0328,1,0.00039,90551,35.43432,255546
4837,yostao,1,0.00039,90552,35.43472,255546
4838,young-957,1,0.00039,90553,35.43511,255546
4839,YoungjuWang,1,0.00039,90554,35.43550,255546
4840,YPCC,1,0.00039,90555,35.43589,255546
4841,yphanikumar1995,1,0.00039,90556,35.43628,255546
4842,yshimizu37,1,0.00039,90557,35.43667,255546
4843,yuanhunglo,1,0.00039,90558,35.43706,255546
4844,yuanzac,1,0.00039,90559,35.43746,255546
4845,yuc8939,1,0.00039,90560,35.43785,255546
4846,yudiprasetya24,1,0.00039,90561,35.43824,255546
4847,yueno06,1,0.00039,90562,35.43863,255546
4848,yuna878,1,0.00039,90563,35.43902,255546
4849,yurigilf,1,0.00039,90564,35.43941,255546
4850,Yuvraj2300,1,0.00039,90565,35.43980,255546
4851,yydzhou,1,0.00039,90566,35.44019,255546
4852,yzc1114,1,0.00039,90567,35.44059,255546
4853,zacharymostowsky,1,0.00039,90568,35.44098,255546
4854,zachgrayio,1,0.00039,90569,35.44137,255546
4855,ZahraEconomist,1,0.00039,90570,35.44176,255546
4856,zdzd123123,1,0.00039,90571,35.44215,255546
4857,ZeeshanAnwar15,1,0.00039,90572,35.44254,255546
4858,zhangnew,1,0.00039,90573,35.44293,255546
4859,zhangxueren9,1,0.00039,90574,35.44333,255546
4860,zhao1157,1,0.00039,90575,35.44372,255546
4861,zhaoxq,1,0.00039,90576,35.44411,255546
4862,zhch12121,1,0.00039,90577,35.44450,255546
4863,zhenlohuang,1,0.00039,90578,35.44489,255546
4864,zhenyulin,1,0.00039,90579,35.44528,255546
4865,Zhihan1996,1,0.00039,90580,35.44567,255546
4866,ZhiqiangWangICT,1,0.00039,90581,35.44606,255546
4867,ZhiqinYang,1,0.00039,90582,35.44646,255546
4868,zhou-harry,1,0.00039,90583,35.44685,255546
4869,zhreshold,1,0.00039,90584,35.44724,255546
4870,zhypku,1,0.00039,90585,35.44763,255546
4871,ziyou987,1,0.00039,90586,35.44802,255546
4872,zmoon111,1,0.00039,90587,35.44841,255546
4873,zoefyz12,1,0.00039,90588,35.44880,255546
4874,ZorkMaster,1,0.00039,90589,35.44920,255546
4875,zorrofox,1,0.00039,90590,35.44959,255546
4876,zqyi,1,0.00039,90591,35.44998,255546
4877,zsatterfield,1,0.00039,90592,35.45037,255546
4878,zuiurs,1,0.00039,90593,35.45076,255546
4879,Zveroloff,1,0.00039,90594,35.45115,255546
4880,zw39125432,1,0.00039,90595,35.45154,255546
4881,zyanichaimaa,1,0.00039,90596,35.45193,255546
4882,zyedManai,1,0.00039,90597,35.45233,255546
4883,zyfzjsc988,1,0.00039,90598,35.45272,255546
4884,zzaareer,1,0.00039,90599,35.45311,255546
4885,zzxvictor,1,0.00039,90600,35.45350,255546
